split,year,team_name,wins,losses,num_games,win_percentage
All Games,2009,Air Force,8,5,13,0.6153846153846154
at Home,2009,Air Force,5,1,6,0.8333333333333334
on Road/Neutral Site,2009,Air Force,3,4,7,0.42857142857142855
vs. Conference,2009,Air Force,5,3,8,0.625
vs. Non-Conference,2009,Air Force,3,2,5,0.6
vs. Ranked (AP),2009,Air Force,0,3,3,0.0
vs. Unranked (AP),2009,Air Force,8,2,10,0.8
vs. FBS (I-A),2009,Air Force,7,5,12,0.5833333333333334
vs. FCS (I-AA),2009,Air Force,1,0,1,1.0
vs. FBS Winning,2009,Air Force,2,4,6,0.3333333333333333
vs. FBS Non-Winning,2009,Air Force,5,1,6,0.8333333333333334
vs. BCS AQ,2009,Air Force,0,1,1,0.0
vs. BCS non-AQ,2009,Air Force,7,4,11,0.6363636363636364
vs. FBS Power 5,2009,Air Force,0,1,1,0.0
vs. FBS non-Power 5,2009,Air Force,7,4,11,0.6363636363636364
in August/September,2009,Air Force,3,1,4,0.75
in October,2009,Air Force,2,3,5,0.4
in November,2009,Air Force,2,1,3,0.6666666666666666
in December/January,2009,Air Force,1,0,1,1.0
All Games,2010,Air Force,9,4,13,0.6923076923076923
at Home,2010,Air Force,5,1,6,0.8333333333333334
on Road/Neutral Site,2010,Air Force,4,3,7,0.5714285714285714
vs. Conference,2010,Air Force,5,3,8,0.625
vs. Non-Conference,2010,Air Force,4,1,5,0.8
vs. Ranked (AP),2010,Air Force,0,2,2,0.0
vs. Unranked (AP),2010,Air Force,9,2,11,0.8181818181818182
vs. FBS (I-A),2010,Air Force,8,4,12,0.6666666666666666
vs. FCS (I-AA),2010,Air Force,1,0,1,1.0
vs. FBS Winning,2010,Air Force,3,4,7,0.42857142857142855
vs. FBS Non-Winning,2010,Air Force,5,0,5,1.0
vs. BCS AQ,2010,Air Force,1,1,2,0.5
vs. BCS non-AQ,2010,Air Force,7,3,10,0.7
vs. FBS Power 5,2010,Air Force,1,1,2,0.5
vs. FBS non-Power 5,2010,Air Force,7,3,10,0.7
in August/September,2010,Air Force,3,1,4,0.75
in October,2010,Air Force,2,3,5,0.4
in November,2010,Air Force,3,0,3,1.0
in December/January,2010,Air Force,1,0,1,1.0
All Games,2011,Air Force,7,6,13,0.5384615384615384
at Home,2011,Air Force,4,3,7,0.5714285714285714
on Road/Neutral Site,2011,Air Force,3,3,6,0.5
vs. Conference,2011,Air Force,3,4,7,0.42857142857142855
vs. Non-Conference,2011,Air Force,4,2,6,0.6666666666666666
vs. Ranked (AP),2011,Air Force,0,2,2,0.0
vs. Unranked (AP),2011,Air Force,7,4,11,0.6363636363636364
vs. FBS (I-A),2011,Air Force,5,6,11,0.45454545454545453
vs. FCS (I-AA),2011,Air Force,2,0,2,1.0
vs. FBS Winning,2011,Air Force,0,6,6,0.0
vs. FBS Non-Winning,2011,Air Force,5,0,5,1.0
vs. BCS AQ,2011,Air Force,0,1,1,0.0
vs. BCS non-AQ,2011,Air Force,5,5,10,0.5
vs. FBS Power 5,2011,Air Force,0,0,0,
vs. FBS non-Power 5,2011,Air Force,5,6,11,0.45454545454545453
in August/September,2011,Air Force,2,1,3,0.6666666666666666
in October,2011,Air Force,2,3,5,0.4
in November,2011,Air Force,3,1,4,0.75
in December/January,2011,Air Force,0,1,1,0.0
All Games,2012,Air Force,6,7,13,0.46153846153846156
at Home,2012,Air Force,5,1,6,0.8333333333333334
on Road/Neutral Site,2012,Air Force,1,6,7,0.14285714285714285
vs. Conference,2012,Air Force,5,3,8,0.625
vs. Non-Conference,2012,Air Force,1,4,5,0.2
vs. Ranked (AP),2012,Air Force,0,1,1,0.0
vs. Unranked (AP),2012,Air Force,6,6,12,0.5
vs. FBS (I-A),2012,Air Force,5,7,12,0.4166666666666667
vs. FCS (I-AA),2012,Air Force,1,0,1,1.0
vs. FBS Winning,2012,Air Force,1,5,6,0.16666666666666666
vs. FBS Non-Winning,2012,Air Force,4,2,6,0.6666666666666666
vs. BCS AQ,2012,Air Force,0,1,1,0.0
vs. BCS non-AQ,2012,Air Force,5,6,11,0.45454545454545453
vs. FBS Power 5,2012,Air Force,0,1,1,0.0
vs. FBS non-Power 5,2012,Air Force,5,6,11,0.45454545454545453
in August/September,2012,Air Force,2,2,4,0.5
in October,2012,Air Force,3,1,4,0.75
in November,2012,Air Force,1,3,4,0.25
in December/January,2012,Air Force,0,1,1,0.0
All Games,2013,Air Force,2,10,12,0.16666666666666666
at Home,2013,Air Force,2,5,7,0.2857142857142857
on Road/Neutral Site,2013,Air Force,0,5,5,0.0
vs. Conference,2013,Air Force,0,8,8,0.0
vs. Non-Conference,2013,Air Force,2,2,4,0.5
vs. Ranked (AP),2013,Air Force,0,1,1,0.0
vs. Unranked (AP),2013,Air Force,2,9,11,0.18181818181818182
vs. FBS (I-A),2013,Air Force,1,10,11,0.09090909090909091
vs. FCS (I-AA),2013,Air Force,1,0,1,1.0
vs. FBS Winning,2013,Air Force,0,7,7,0.0
vs. FBS Non-Winning,2013,Air Force,1,3,4,0.25
vs. BCS AQ,2013,Air Force,0,1,1,0.0
vs. BCS non-AQ,2013,Air Force,1,9,10,0.1
vs. FBS Power 5,2013,Air Force,0,0,0,
vs. FBS non-Power 5,2013,Air Force,1,10,11,0.09090909090909091
in August/September,2013,Air Force,1,4,5,0.2
in October,2013,Air Force,0,3,3,0.0
in November,2013,Air Force,1,3,4,0.25
in December/January,2013,Air Force,0,0,0,
All Games,2014,Air Force,10,3,13,0.7692307692307693
at Home,2014,Air Force,6,0,6,1.0
on Road/Neutral Site,2014,Air Force,4,3,7,0.5714285714285714
vs. Conference,2014,Air Force,5,3,8,0.625
vs. Non-Conference,2014,Air Force,5,0,5,1.0
vs. Ranked (AP),2014,Air Force,1,0,1,1.0
vs. Unranked (AP),2014,Air Force,9,3,12,0.75
vs. FBS (I-A),2014,Air Force,9,3,12,0.75
vs. FCS (I-AA),2014,Air Force,1,0,1,1.0
vs. FBS Winning,2014,Air Force,5,2,7,0.7142857142857143
vs. FBS Non-Winning,2014,Air Force,4,1,5,0.8
vs. BCS AQ,2014,Air Force,0,0,0,
vs. BCS non-AQ,2014,Air Force,9,3,12,0.75
vs. FBS Power 5,2014,Air Force,0,0,0,
vs. FBS non-Power 5,2014,Air Force,9,3,12,0.75
in August/September,2014,Air Force,3,1,4,0.75
in October,2014,Air Force,2,1,3,0.6666666666666666
in November,2014,Air Force,4,1,5,0.8
in December/January,2014,Air Force,1,0,1,1.0
All Games,2015,Air Force,8,6,14,0.5714285714285714
at Home,2015,Air Force,6,0,6,1.0
on Road/Neutral Site,2015,Air Force,2,6,8,0.25
vs. Conference,2015,Air Force,6,3,9,0.6666666666666666
vs. Non-Conference,2015,Air Force,2,3,5,0.4
vs. Ranked (AP),2015,Air Force,0,2,2,0.0
vs. Unranked (AP),2015,Air Force,8,4,12,0.6666666666666666
vs. FBS (I-A),2015,Air Force,7,6,13,0.5384615384615384
vs. FCS (I-AA),2015,Air Force,1,0,1,1.0
vs. FBS Winning,2015,Air Force,1,6,7,0.14285714285714285
vs. FBS Non-Winning,2015,Air Force,6,0,6,1.0
vs. BCS AQ,2015,Air Force,0,3,3,0.0
vs. BCS non-AQ,2015,Air Force,7,3,10,0.7
vs. FBS Power 5,2015,Air Force,0,2,2,0.0
vs. FBS non-Power 5,2015,Air Force,7,4,11,0.6363636363636364
in August/September,2015,Air Force,2,1,3,0.6666666666666666
in October,2015,Air Force,3,2,5,0.6
in November,2015,Air Force,3,1,4,0.75
in December/January,2015,Air Force,0,2,2,0.0
All Games,2016,Air Force,10,3,13,0.7692307692307693
at Home,2016,Air Force,5,1,6,0.8333333333333334
on Road/Neutral Site,2016,Air Force,5,2,7,0.7142857142857143
vs. Conference,2016,Air Force,5,3,8,0.625
vs. Non-Conference,2016,Air Force,5,0,5,1.0
vs. Ranked (AP),2016,Air Force,0,0,0,
vs. Unranked (AP),2016,Air Force,10,3,13,0.7692307692307693
vs. FBS (I-A),2016,Air Force,9,3,12,0.75
vs. FCS (I-AA),2016,Air Force,1,0,1,1.0
vs. FBS Winning,2016,Air Force,4,2,6,0.6666666666666666
vs. FBS Non-Winning,2016,Air Force,5,1,6,0.8333333333333334
vs. BCS AQ,2016,Air Force,1,0,1,1.0
vs. BCS non-AQ,2016,Air Force,8,3,11,0.7272727272727273
vs. FBS Power 5,2016,Air Force,0,0,0,
vs. FBS non-Power 5,2016,Air Force,9,3,12,0.75
in August/September,2016,Air Force,3,0,3,1.0
in October,2016,Air Force,2,3,5,0.4
in November,2016,Air Force,4,0,4,1.0
in December/January,2016,Air Force,1,0,1,1.0
All Games,2017,Air Force,5,7,12,0.4166666666666667
at Home,2017,Air Force,3,3,6,0.5
on Road/Neutral Site,2017,Air Force,2,4,6,0.3333333333333333
vs. Conference,2017,Air Force,4,4,8,0.5
vs. Non-Conference,2017,Air Force,1,3,4,0.25
vs. Ranked (AP),2017,Air Force,0,1,1,0.0
vs. Unranked (AP),2017,Air Force,5,6,11,0.45454545454545453
vs. FBS (I-A),2017,Air Force,4,7,11,0.36363636363636365
vs. FCS (I-AA),2017,Air Force,1,0,1,1.0
vs. FBS Winning,2017,Air Force,1,6,7,0.14285714285714285
vs. FBS Non-Winning,2017,Air Force,3,1,4,0.75
vs. BCS AQ,2017,Air Force,0,2,2,0.0
vs. BCS non-AQ,2017,Air Force,4,5,9,0.4444444444444444
vs. FBS Power 5,2017,Air Force,0,1,1,0.0
vs. FBS non-Power 5,2017,Air Force,4,6,10,0.4
in August/September,2017,Air Force,1,3,4,0.25
in October,2017,Air Force,3,1,4,0.75
in November,2017,Air Force,1,3,4,0.25
in December/January,2017,Air Force,0,0,0,
All Games,2018,Air Force,5,7,12,0.4166666666666667
at Home,2018,Air Force,4,2,6,0.6666666666666666
on Road/Neutral Site,2018,Air Force,1,5,6,0.16666666666666666
vs. Conference,2018,Air Force,3,5,8,0.375
vs. Non-Conference,2018,Air Force,2,2,4,0.5
vs. Ranked (AP),2018,Air Force,0,3,3,0.0
vs. Unranked (AP),2018,Air Force,5,4,9,0.5555555555555556
vs. FBS (I-A),2018,Air Force,4,7,11,0.36363636363636365
vs. FCS (I-AA),2018,Air Force,1,0,1,1.0
vs. FBS Winning,2018,Air Force,0,5,5,0.0
vs. FBS Non-Winning,2018,Air Force,4,2,6,0.6666666666666666
vs. BCS AQ,2018,Air Force,1,0,1,1.0
vs. BCS non-AQ,2018,Air Force,3,7,10,0.3
vs. FBS Power 5,2018,Air Force,0,0,0,
vs. FBS non-Power 5,2018,Air Force,4,7,11,0.36363636363636365
in August/September,2018,Air Force,1,3,4,0.25
in October,2018,Air Force,2,2,4,0.5
in November,2018,Air Force,2,2,4,0.5
in December/January,2018,Air Force,0,0,0,
All Games,2019,Air Force,11,2,13,0.8461538461538461
at Home,2019,Air Force,6,0,6,1.0
on Road/Neutral Site,2019,Air Force,5,2,7,0.7142857142857143
vs. Conference,2019,Air Force,7,1,8,0.875
vs. Non-Conference,2019,Air Force,4,1,5,0.8
vs. Ranked (AP),2019,Air Force,0,2,2,0.0
vs. Unranked (AP),2019,Air Force,11,0,11,1.0
vs. FBS (I-A),2019,Air Force,10,2,12,0.8333333333333334
vs. FCS (I-AA),2019,Air Force,1,0,1,1.0
vs. FBS Winning,2019,Air Force,3,2,5,0.6
vs. FBS Non-Winning,2019,Air Force,7,0,7,1.0
vs. BCS AQ,2019,Air Force,2,1,3,0.6666666666666666
vs. BCS non-AQ,2019,Air Force,8,1,9,0.8888888888888888
vs. FBS Power 5,2019,Air Force,2,0,2,1.0
vs. FBS non-Power 5,2019,Air Force,8,2,10,0.8
in August/September,2019,Air Force,3,1,4,0.75
in October,2019,Air Force,3,1,4,0.75
in November,2019,Air Force,4,0,4,1.0
in December/January,2019,Air Force,1,0,1,1.0
All Games,2020,Air Force,3,3,6,0.5
at Home,2020,Air Force,2,1,3,0.6666666666666666
on Road/Neutral Site,2020,Air Force,1,2,3,0.3333333333333333
vs. Conference,2020,Air Force,2,2,4,0.5
vs. Non-Conference,2020,Air Force,1,1,2,0.5
vs. Ranked (AP),2020,Air Force,0,1,1,0.0
vs. Unranked (AP),2020,Air Force,3,2,5,0.6
vs. FBS (I-A),2020,Air Force,3,3,6,0.5
vs. FCS (I-AA),2020,Air Force,0,0,0,
vs. FBS Winning,2020,Air Force,0,3,3,0.0
vs. FBS Non-Winning,2020,Air Force,3,0,3,1.0
vs. BCS AQ,2020,Air Force,1,0,1,1.0
vs. BCS non-AQ,2020,Air Force,2,3,5,0.4
vs. FBS Power 5,2020,Air Force,0,0,0,
vs. FBS non-Power 5,2020,Air Force,3,3,6,0.5
in August/September,2020,Air Force,0,0,0,
in October,2020,Air Force,1,2,3,0.3333333333333333
in November,2020,Air Force,1,0,1,1.0
in December/January,2020,Air Force,1,1,2,0.5
All Games,2021,Air Force,10,3,13,0.7692307692307693
at Home,2021,Air Force,4,2,6,0.6666666666666666
on Road/Neutral Site,2021,Air Force,6,1,7,0.8571428571428571
vs. Conference,2021,Air Force,6,2,8,0.75
vs. Non-Conference,2021,Air Force,4,1,5,0.8
vs. Ranked (AP),2021,Air Force,0,2,2,0.0
vs. Unranked (AP),2021,Air Force,10,1,11,0.9090909090909091
vs. FBS (I-A),2021,Air Force,9,3,12,0.75
vs. FCS (I-AA),2021,Air Force,1,0,1,1.0
vs. FBS Winning,2021,Air Force,3,3,6,0.5
vs. FBS Non-Winning,2021,Air Force,6,0,6,1.0
vs. BCS AQ,2021,Air Force,2,0,2,1.0
vs. BCS non-AQ,2021,Air Force,7,3,10,0.7
vs. FBS Power 5,2021,Air Force,1,0,1,1.0
vs. FBS non-Power 5,2021,Air Force,8,3,11,0.7272727272727273
in August/September,2021,Air Force,3,1,4,0.75
in October,2021,Air Force,3,1,4,0.75
in November,2021,Air Force,3,1,4,0.75
in December/January,2021,Air Force,1,0,1,1.0
All Games,2022,Air Force,10,3,13,0.7692307692307693
at Home,2022,Air Force,6,1,7,0.8571428571428571
on Road/Neutral Site,2022,Air Force,4,2,6,0.6666666666666666
vs. Conference,2022,Air Force,5,3,8,0.625
vs. Non-Conference,2022,Air Force,5,0,5,1.0
vs. Ranked (AP),2022,Air Force,0,0,0,
vs. Unranked (AP),2022,Air Force,10,3,13,0.7692307692307693
vs. FBS (I-A),2022,Air Force,9,3,12,0.75
vs. FCS (I-AA),2022,Air Force,1,0,1,1.0
vs. FBS Winning,2022,Air Force,1,2,3,0.3333333333333333
vs. FBS Non-Winning,2022,Air Force,8,1,9,0.8888888888888888
vs. BCS AQ,2022,Air Force,3,0,3,1.0
vs. BCS non-AQ,2022,Air Force,6,3,9,0.6666666666666666
vs. FBS Power 5,2022,Air Force,2,0,2,1.0
vs. FBS non-Power 5,2022,Air Force,7,3,10,0.7
in August/September,2022,Air Force,3,1,4,0.75
in October,2022,Air Force,2,2,4,0.5
in November,2022,Air Force,4,0,4,1.0
in December/January,2022,Air Force,1,0,1,1.0
All Games,2009,Akron,3,9,12,0.25
at Home,2009,Akron,3,3,6,0.5
on Road/Neutral Site,2009,Akron,0,6,6,0.0
vs. Conference,2009,Akron,2,6,8,0.25
vs. Non-Conference,2009,Akron,1,3,4,0.25
vs. Ranked (AP),2009,Akron,0,2,2,0.0
vs. Unranked (AP),2009,Akron,3,7,10,0.3
vs. FBS (I-A),2009,Akron,2,9,11,0.18181818181818182
vs. FCS (I-AA),2009,Akron,1,0,1,1.0
vs. FBS Winning,2009,Akron,0,6,6,0.0
vs. FBS Non-Winning,2009,Akron,2,3,5,0.4
vs. BCS AQ,2009,Akron,0,3,3,0.0
vs. BCS non-AQ,2009,Akron,2,6,8,0.25
vs. FBS Power 5,2009,Akron,0,2,2,0.0
vs. FBS non-Power 5,2009,Akron,2,7,9,0.2222222222222222
in August/September,2009,Akron,1,3,4,0.25
in October,2009,Akron,0,4,4,0.0
in November,2009,Akron,2,2,4,0.5
in December/January,2009,Akron,0,0,0,
All Games,2010,Akron,1,11,12,0.08333333333333333
at Home,2010,Akron,1,5,6,0.16666666666666666
on Road/Neutral Site,2010,Akron,0,6,6,0.0
vs. Conference,2010,Akron,1,7,8,0.125
vs. Non-Conference,2010,Akron,0,4,4,0.0
vs. Ranked (AP),2010,Akron,0,0,0,
vs. Unranked (AP),2010,Akron,1,11,12,0.08333333333333333
vs. FBS (I-A),2010,Akron,1,10,11,0.09090909090909091
vs. FCS (I-AA),2010,Akron,0,1,1,0.0
vs. FBS Winning,2010,Akron,0,5,5,0.0
vs. FBS Non-Winning,2010,Akron,1,5,6,0.16666666666666666
vs. BCS AQ,2010,Akron,0,3,3,0.0
vs. BCS non-AQ,2010,Akron,1,7,8,0.125
vs. FBS Power 5,2010,Akron,0,2,2,0.0
vs. FBS non-Power 5,2010,Akron,1,8,9,0.1111111111111111
in August/September,2010,Akron,0,4,4,0.0
in October,2010,Akron,0,5,5,0.0
in November,2010,Akron,1,2,3,0.3333333333333333
in December/January,2010,Akron,0,0,0,
All Games,2011,Akron,1,11,12,0.08333333333333333
at Home,2011,Akron,1,5,6,0.16666666666666666
on Road/Neutral Site,2011,Akron,0,6,6,0.0
vs. Conference,2011,Akron,0,8,8,0.0
vs. Non-Conference,2011,Akron,1,3,4,0.25
vs. Ranked (AP),2011,Akron,0,1,1,0.0
vs. Unranked (AP),2011,Akron,1,10,11,0.09090909090909091
vs. FBS (I-A),2011,Akron,0,11,11,0.0
vs. FCS (I-AA),2011,Akron,1,0,1,1.0
vs. FBS Winning,2011,Akron,0,5,5,0.0
vs. FBS Non-Winning,2011,Akron,0,6,6,0.0
vs. BCS AQ,2011,Akron,0,2,2,0.0
vs. BCS non-AQ,2011,Akron,0,9,9,0.0
vs. FBS Power 5,2011,Akron,0,1,1,0.0
vs. FBS non-Power 5,2011,Akron,0,10,10,0.0
in August/September,2011,Akron,1,3,4,0.25
in October,2011,Akron,0,4,4,0.0
in November,2011,Akron,0,4,4,0.0
in December/January,2011,Akron,0,0,0,
All Games,2012,Akron,1,11,12,0.08333333333333333
at Home,2012,Akron,1,5,6,0.16666666666666666
on Road/Neutral Site,2012,Akron,0,6,6,0.0
vs. Conference,2012,Akron,0,8,8,0.0
vs. Non-Conference,2012,Akron,1,3,4,0.25
vs. Ranked (AP),2012,Akron,0,1,1,0.0
vs. Unranked (AP),2012,Akron,1,10,11,0.09090909090909091
vs. FBS (I-A),2012,Akron,0,11,11,0.0
vs. FCS (I-AA),2012,Akron,1,0,1,1.0
vs. FBS Winning,2012,Akron,0,7,7,0.0
vs. FBS Non-Winning,2012,Akron,0,4,4,0.0
vs. BCS AQ,2012,Akron,0,1,1,0.0
vs. BCS non-AQ,2012,Akron,0,10,10,0.0
vs. FBS Power 5,2012,Akron,0,1,1,0.0
vs. FBS non-Power 5,2012,Akron,0,10,10,0.0
in August/September,2012,Akron,1,4,5,0.2
in October,2012,Akron,0,4,4,0.0
in November,2012,Akron,0,3,3,0.0
in December/January,2012,Akron,0,0,0,
All Games,2013,Akron,5,7,12,0.4166666666666667
at Home,2013,Akron,3,3,6,0.5
on Road/Neutral Site,2013,Akron,2,4,6,0.3333333333333333
vs. Conference,2013,Akron,4,4,8,0.5
vs. Non-Conference,2013,Akron,1,3,4,0.25
vs. Ranked (AP),2013,Akron,0,1,1,0.0
vs. Unranked (AP),2013,Akron,5,6,11,0.45454545454545453
vs. FBS (I-A),2013,Akron,4,7,11,0.36363636363636365
vs. FCS (I-AA),2013,Akron,1,0,1,1.0
vs. FBS Winning,2013,Akron,1,7,8,0.125
vs. FBS Non-Winning,2013,Akron,3,0,3,1.0
vs. BCS AQ,2013,Akron,0,2,2,0.0
vs. BCS non-AQ,2013,Akron,4,5,9,0.4444444444444444
vs. FBS Power 5,2013,Akron,0,1,1,0.0
vs. FBS non-Power 5,2013,Akron,4,6,10,0.4
in August/September,2013,Akron,1,4,5,0.2
in October,2013,Akron,1,3,4,0.25
in November,2013,Akron,3,0,3,1.0
in December/January,2013,Akron,0,0,0,
All Games,2014,Akron,5,7,12,0.4166666666666667
at Home,2014,Akron,4,2,6,0.6666666666666666
on Road/Neutral Site,2014,Akron,1,5,6,0.16666666666666666
vs. Conference,2014,Akron,3,5,8,0.375
vs. Non-Conference,2014,Akron,2,2,4,0.5
vs. Ranked (AP),2014,Akron,0,1,1,0.0
vs. Unranked (AP),2014,Akron,5,6,11,0.45454545454545453
vs. FBS (I-A),2014,Akron,4,7,11,0.36363636363636365
vs. FCS (I-AA),2014,Akron,1,0,1,1.0
vs. FBS Winning,2014,Akron,0,3,3,0.0
vs. FBS Non-Winning,2014,Akron,4,4,8,0.5
vs. BCS AQ,2014,Akron,1,1,2,0.5
vs. BCS non-AQ,2014,Akron,3,6,9,0.3333333333333333
vs. FBS Power 5,2014,Akron,1,1,2,0.5
vs. FBS non-Power 5,2014,Akron,3,6,9,0.3333333333333333
in August/September,2014,Akron,2,2,4,0.5
in October,2014,Akron,2,2,4,0.5
in November,2014,Akron,1,3,4,0.25
in December/January,2014,Akron,0,0,0,
All Games,2015,Akron,8,5,13,0.6153846153846154
at Home,2015,Akron,3,3,6,0.5
on Road/Neutral Site,2015,Akron,5,2,7,0.7142857142857143
vs. Conference,2015,Akron,5,3,8,0.625
vs. Non-Conference,2015,Akron,3,2,5,0.6
vs. Ranked (AP),2015,Akron,0,1,1,0.0
vs. Unranked (AP),2015,Akron,8,4,12,0.6666666666666666
vs. FBS (I-A),2015,Akron,7,5,12,0.5833333333333334
vs. FCS (I-AA),2015,Akron,1,0,1,1.0
vs. FBS Winning,2015,Akron,0,5,5,0.0
vs. FBS Non-Winning,2015,Akron,7,0,7,1.0
vs. BCS AQ,2015,Akron,0,2,2,0.0
vs. BCS non-AQ,2015,Akron,7,3,10,0.7
vs. FBS Power 5,2015,Akron,0,2,2,0.0
vs. FBS non-Power 5,2015,Akron,7,3,10,0.7
in August/September,2015,Akron,2,2,4,0.5
in October,2015,Akron,1,3,4,0.25
in November,2015,Akron,4,0,4,1.0
in December/January,2015,Akron,1,0,1,1.0
All Games,2016,Akron,5,7,12,0.4166666666666667
at Home,2016,Akron,2,4,6,0.3333333333333333
on Road/Neutral Site,2016,Akron,3,3,6,0.5
vs. Conference,2016,Akron,3,5,8,0.375
vs. Non-Conference,2016,Akron,2,2,4,0.5
vs. Ranked (AP),2016,Akron,0,2,2,0.0
vs. Unranked (AP),2016,Akron,5,5,10,0.5
vs. FBS (I-A),2016,Akron,4,7,11,0.36363636363636365
vs. FCS (I-AA),2016,Akron,1,0,1,1.0
vs. FBS Winning,2016,Akron,0,5,5,0.0
vs. FBS Non-Winning,2016,Akron,4,2,6,0.6666666666666666
vs. BCS AQ,2016,Akron,0,1,1,0.0
vs. BCS non-AQ,2016,Akron,4,6,10,0.4
vs. FBS Power 5,2016,Akron,0,1,1,0.0
vs. FBS non-Power 5,2016,Akron,4,6,10,0.4
in August/September,2016,Akron,2,2,4,0.5
in October,2016,Akron,3,2,5,0.6
in November,2016,Akron,0,3,3,0.0
in December/January,2016,Akron,0,0,0,
All Games,2017,Akron,7,7,14,0.5
at Home,2017,Akron,5,1,6,0.8333333333333334
on Road/Neutral Site,2017,Akron,2,6,8,0.25
vs. Conference,2017,Akron,6,3,9,0.6666666666666666
vs. Non-Conference,2017,Akron,1,4,5,0.2
vs. Ranked (AP),2017,Akron,0,1,1,0.0
vs. Unranked (AP),2017,Akron,7,6,13,0.5384615384615384
vs. FBS (I-A),2017,Akron,6,7,13,0.46153846153846156
vs. FCS (I-AA),2017,Akron,1,0,1,1.0
vs. FBS Winning,2017,Akron,1,6,7,0.14285714285714285
vs. FBS Non-Winning,2017,Akron,5,1,6,0.8333333333333334
vs. BCS AQ,2017,Akron,0,2,2,0.0
vs. BCS non-AQ,2017,Akron,6,5,11,0.5454545454545454
vs. FBS Power 5,2017,Akron,0,2,2,0.0
vs. FBS non-Power 5,2017,Akron,6,5,11,0.5454545454545454
in August/September,2017,Akron,2,3,5,0.4
in October,2017,Akron,3,1,4,0.75
in November,2017,Akron,2,1,3,0.6666666666666666
in December/January,2017,Akron,0,2,2,0.0
All Games,2018,Akron,4,8,12,0.3333333333333333
at Home,2018,Akron,2,3,5,0.4
on Road/Neutral Site,2018,Akron,2,5,7,0.2857142857142857
vs. Conference,2018,Akron,2,6,8,0.25
vs. Non-Conference,2018,Akron,2,2,4,0.5
vs. Ranked (AP),2018,Akron,1,0,1,1.0
vs. Unranked (AP),2018,Akron,3,8,11,0.2727272727272727
vs. FBS (I-A),2018,Akron,3,8,11,0.2727272727272727
vs. FCS (I-AA),2018,Akron,1,0,1,1.0
vs. FBS Winning,2018,Akron,1,6,7,0.14285714285714285
vs. FBS Non-Winning,2018,Akron,2,2,4,0.5
vs. BCS AQ,2018,Akron,1,2,3,0.3333333333333333
vs. BCS non-AQ,2018,Akron,2,6,8,0.25
vs. FBS Power 5,2018,Akron,1,2,3,0.3333333333333333
vs. FBS non-Power 5,2018,Akron,2,6,8,0.25
in August/September,2018,Akron,2,1,3,0.6666666666666666
in October,2018,Akron,2,2,4,0.5
in November,2018,Akron,0,4,4,0.0
in December/January,2018,Akron,0,1,1,0.0
All Games,2019,Akron,0,12,12,0.0
at Home,2019,Akron,0,6,6,0.0
on Road/Neutral Site,2019,Akron,0,6,6,0.0
vs. Conference,2019,Akron,0,8,8,0.0
vs. Non-Conference,2019,Akron,0,4,4,0.0
vs. Ranked (AP),2019,Akron,0,0,0,
vs. Unranked (AP),2019,Akron,0,12,12,0.0
vs. FBS (I-A),2019,Akron,0,12,12,0.0
vs. FCS (I-AA),2019,Akron,0,0,0,
vs. FBS Winning,2019,Akron,0,6,6,0.0
vs. FBS Non-Winning,2019,Akron,0,6,6,0.0
vs. BCS AQ,2019,Akron,0,1,1,0.0
vs. BCS non-AQ,2019,Akron,0,11,11,0.0
vs. FBS Power 5,2019,Akron,0,1,1,0.0
vs. FBS non-Power 5,2019,Akron,0,11,11,0.0
in August/September,2019,Akron,0,5,5,0.0
in October,2019,Akron,0,3,3,0.0
in November,2019,Akron,0,4,4,0.0
in December/January,2019,Akron,0,0,0,
All Games,2020,Akron,1,5,6,0.16666666666666666
at Home,2020,Akron,1,2,3,0.3333333333333333
on Road/Neutral Site,2020,Akron,0,3,3,0.0
vs. Conference,2020,Akron,1,5,6,0.16666666666666666
vs. Non-Conference,2020,Akron,0,0,0,
vs. Ranked (AP),2020,Akron,0,0,0,
vs. Unranked (AP),2020,Akron,1,5,6,0.16666666666666666
vs. FBS (I-A),2020,Akron,1,5,6,0.16666666666666666
vs. FCS (I-AA),2020,Akron,0,0,0,
vs. FBS Winning,2020,Akron,0,5,5,0.0
vs. FBS Non-Winning,2020,Akron,1,0,1,1.0
vs. BCS AQ,2020,Akron,0,0,0,
vs. BCS non-AQ,2020,Akron,1,5,6,0.16666666666666666
vs. FBS Power 5,2020,Akron,0,0,0,
vs. FBS non-Power 5,2020,Akron,1,5,6,0.16666666666666666
in August/September,2020,Akron,0,0,0,
in October,2020,Akron,0,0,0,
in November,2020,Akron,0,4,4,0.0
in December/January,2020,Akron,1,1,2,0.5
All Games,2021,Akron,2,10,12,0.16666666666666666
at Home,2021,Akron,1,5,6,0.16666666666666666
on Road/Neutral Site,2021,Akron,1,5,6,0.16666666666666666
vs. Conference,2021,Akron,1,7,8,0.125
vs. Non-Conference,2021,Akron,1,3,4,0.25
vs. Ranked (AP),2021,Akron,0,1,1,0.0
vs. Unranked (AP),2021,Akron,2,9,11,0.18181818181818182
vs. FBS (I-A),2021,Akron,1,10,11,0.09090909090909091
vs. FCS (I-AA),2021,Akron,1,0,1,1.0
vs. FBS Winning,2021,Akron,0,4,4,0.0
vs. FBS Non-Winning,2021,Akron,1,6,7,0.14285714285714285
vs. BCS AQ,2021,Akron,0,3,3,0.0
vs. BCS non-AQ,2021,Akron,1,7,8,0.125
vs. FBS Power 5,2021,Akron,0,2,2,0.0
vs. FBS non-Power 5,2021,Akron,1,8,9,0.1111111111111111
in August/September,2021,Akron,1,3,4,0.25
in October,2021,Akron,1,3,4,0.25
in November,2021,Akron,0,4,4,0.0
in December/January,2021,Akron,0,0,0,
All Games,2022,Akron,2,10,12,0.16666666666666666
at Home,2022,Akron,1,4,5,0.2
on Road/Neutral Site,2022,Akron,1,6,7,0.14285714285714285
vs. Conference,2022,Akron,1,7,8,0.125
vs. Non-Conference,2022,Akron,1,3,4,0.25
vs. Ranked (AP),2022,Akron,0,1,1,0.0
vs. Unranked (AP),2022,Akron,2,9,11,0.18181818181818182
vs. FBS (I-A),2022,Akron,1,10,11,0.09090909090909091
vs. FCS (I-AA),2022,Akron,1,0,1,1.0
vs. FBS Winning,2022,Akron,0,5,5,0.0
vs. FBS Non-Winning,2022,Akron,1,5,6,0.16666666666666666
vs. BCS AQ,2022,Akron,0,2,2,0.0
vs. BCS non-AQ,2022,Akron,1,8,9,0.1111111111111111
vs. FBS Power 5,2022,Akron,0,2,2,0.0
vs. FBS non-Power 5,2022,Akron,1,8,9,0.1111111111111111
in August/September,2022,Akron,1,3,4,0.25
in October,2022,Akron,0,5,5,0.0
in November,2022,Akron,1,1,2,0.5
in December/January,2022,Akron,0,1,1,0.0
All Games,2009,Alabama,14,0,14,1.0
at Home,2009,Alabama,7,0,7,1.0
on Road/Neutral Site,2009,Alabama,7,0,7,1.0
vs. Conference,2009,Alabama,9,0,9,1.0
vs. Non-Conference,2009,Alabama,5,0,5,1.0
vs. Ranked (AP),2009,Alabama,5,0,5,1.0
vs. Unranked (AP),2009,Alabama,9,0,9,1.0
vs. FBS (I-A),2009,Alabama,13,0,13,1.0
vs. FCS (I-AA),2009,Alabama,1,0,1,1.0
vs. FBS Winning,2009,Alabama,10,0,10,1.0
vs. FBS Non-Winning,2009,Alabama,3,0,3,1.0
vs. BCS AQ,2009,Alabama,11,0,11,1.0
vs. BCS non-AQ,2009,Alabama,2,0,2,1.0
vs. FBS Power 5,2009,Alabama,11,0,11,1.0
vs. FBS non-Power 5,2009,Alabama,2,0,2,1.0
in August/September,2009,Alabama,4,0,4,1.0
in October,2009,Alabama,4,0,4,1.0
in November,2009,Alabama,4,0,4,1.0
in December/January,2009,Alabama,2,0,2,1.0
All Games,2010,Alabama,10,3,13,0.7692307692307693
at Home,2010,Alabama,6,1,7,0.8571428571428571
on Road/Neutral Site,2010,Alabama,4,2,6,0.6666666666666666
vs. Conference,2010,Alabama,5,3,8,0.625
vs. Non-Conference,2010,Alabama,5,0,5,1.0
vs. Ranked (AP),2010,Alabama,3,3,6,0.5
vs. Unranked (AP),2010,Alabama,7,0,7,1.0
vs. FBS (I-A),2010,Alabama,9,3,12,0.75
vs. FCS (I-AA),2010,Alabama,1,0,1,1.0
vs. FBS Winning,2010,Alabama,5,3,8,0.625
vs. FBS Non-Winning,2010,Alabama,4,0,4,1.0
vs. BCS AQ,2010,Alabama,8,3,11,0.7272727272727273
vs. BCS non-AQ,2010,Alabama,1,0,1,1.0
vs. FBS Power 5,2010,Alabama,8,3,11,0.7272727272727273
vs. FBS non-Power 5,2010,Alabama,1,0,1,1.0
in August/September,2010,Alabama,4,0,4,1.0
in October,2010,Alabama,3,1,4,0.75
in November,2010,Alabama,2,2,4,0.5
in December/January,2010,Alabama,1,0,1,1.0
All Games,2011,Alabama,12,1,13,0.9230769230769231
at Home,2011,Alabama,6,1,7,0.8571428571428571
on Road/Neutral Site,2011,Alabama,6,0,6,1.0
vs. Conference,2011,Alabama,8,1,9,0.8888888888888888
vs. Non-Conference,2011,Alabama,4,0,4,1.0
vs. Ranked (AP),2011,Alabama,2,1,3,0.6666666666666666
vs. Unranked (AP),2011,Alabama,10,0,10,1.0
vs. FBS (I-A),2011,Alabama,11,1,12,0.9166666666666666
vs. FCS (I-AA),2011,Alabama,1,0,1,1.0
vs. FBS Winning,2011,Alabama,6,1,7,0.8571428571428571
vs. FBS Non-Winning,2011,Alabama,5,0,5,1.0
vs. BCS AQ,2011,Alabama,9,1,10,0.9
vs. BCS non-AQ,2011,Alabama,2,0,2,1.0
vs. FBS Power 5,2011,Alabama,9,1,10,0.9
vs. FBS non-Power 5,2011,Alabama,2,0,2,1.0
in August/September,2011,Alabama,4,0,4,1.0
in October,2011,Alabama,4,0,4,1.0
in November,2011,Alabama,3,1,4,0.75
in December/January,2011,Alabama,1,0,1,1.0
All Games,2012,Alabama,13,1,14,0.9285714285714286
at Home,2012,Alabama,6,1,7,0.8571428571428571
on Road/Neutral Site,2012,Alabama,7,0,7,1.0
vs. Conference,2012,Alabama,8,1,9,0.8888888888888888
vs. Non-Conference,2012,Alabama,5,0,5,1.0
vs. Ranked (AP),2012,Alabama,4,1,5,0.8
vs. Unranked (AP),2012,Alabama,9,0,9,1.0
vs. FBS (I-A),2012,Alabama,12,1,13,0.9230769230769231
vs. FCS (I-AA),2012,Alabama,1,0,1,1.0
vs. FBS Winning,2012,Alabama,7,1,8,0.875
vs. FBS Non-Winning,2012,Alabama,5,0,5,1.0
vs. BCS AQ,2012,Alabama,10,1,11,0.9090909090909091
vs. BCS non-AQ,2012,Alabama,2,0,2,1.0
vs. FBS Power 5,2012,Alabama,9,1,10,0.9
vs. FBS non-Power 5,2012,Alabama,3,0,3,1.0
in August/September,2012,Alabama,5,0,5,1.0
in October,2012,Alabama,3,0,3,1.0
in November,2012,Alabama,3,1,4,0.75
in December/January,2012,Alabama,2,0,2,1.0
All Games,2013,Alabama,11,2,13,0.8461538461538461
at Home,2013,Alabama,7,0,7,1.0
on Road/Neutral Site,2013,Alabama,4,2,6,0.6666666666666666
vs. Conference,2013,Alabama,7,1,8,0.875
vs. Non-Conference,2013,Alabama,4,1,5,0.8
vs. Ranked (AP),2013,Alabama,2,2,4,0.5
vs. Unranked (AP),2013,Alabama,9,0,9,1.0
vs. FBS (I-A),2013,Alabama,10,2,12,0.8333333333333334
vs. FCS (I-AA),2013,Alabama,1,0,1,1.0
vs. FBS Winning,2013,Alabama,6,2,8,0.75
vs. FBS Non-Winning,2013,Alabama,4,0,4,1.0
vs. BCS AQ,2013,Alabama,8,2,10,0.8
vs. BCS non-AQ,2013,Alabama,2,0,2,1.0
vs. FBS Power 5,2013,Alabama,8,2,10,0.8
vs. FBS non-Power 5,2013,Alabama,2,0,2,1.0
in August/September,2013,Alabama,4,0,4,1.0
in October,2013,Alabama,4,0,4,1.0
in November,2013,Alabama,3,1,4,0.75
in December/January,2013,Alabama,0,1,1,0.0
All Games,2014,Alabama,12,2,14,0.8571428571428571
at Home,2014,Alabama,7,0,7,1.0
on Road/Neutral Site,2014,Alabama,5,2,7,0.7142857142857143
vs. Conference,2014,Alabama,8,1,9,0.8888888888888888
vs. Non-Conference,2014,Alabama,4,1,5,0.8
vs. Ranked (AP),2014,Alabama,3,2,5,0.6
vs. Unranked (AP),2014,Alabama,9,0,9,1.0
vs. FBS (I-A),2014,Alabama,11,2,13,0.8461538461538461
vs. FCS (I-AA),2014,Alabama,1,0,1,1.0
vs. FBS Winning,2014,Alabama,9,2,11,0.8181818181818182
vs. FBS Non-Winning,2014,Alabama,2,0,2,1.0
vs. BCS AQ,2014,Alabama,9,2,11,0.8181818181818182
vs. BCS non-AQ,2014,Alabama,2,0,2,1.0
vs. FBS Power 5,2014,Alabama,9,2,11,0.8181818181818182
vs. FBS non-Power 5,2014,Alabama,2,0,2,1.0
in August/September,2014,Alabama,4,0,4,1.0
in October,2014,Alabama,3,1,4,0.75
in November,2014,Alabama,4,0,4,1.0
in December/January,2014,Alabama,1,1,2,0.5
All Games,2015,Alabama,14,1,15,0.9333333333333333
at Home,2015,Alabama,6,1,7,0.8571428571428571
on Road/Neutral Site,2015,Alabama,8,0,8,1.0
vs. Conference,2015,Alabama,8,1,9,0.8888888888888888
vs. Non-Conference,2015,Alabama,6,0,6,1.0
vs. Ranked (AP),2015,Alabama,6,1,7,0.8571428571428571
vs. Unranked (AP),2015,Alabama,8,0,8,1.0
vs. FBS (I-A),2015,Alabama,13,1,14,0.9285714285714286
vs. FCS (I-AA),2015,Alabama,1,0,1,1.0
vs. FBS Winning,2015,Alabama,12,1,13,0.9230769230769231
vs. FBS Non-Winning,2015,Alabama,1,0,1,1.0
vs. BCS AQ,2015,Alabama,11,1,12,0.9166666666666666
vs. BCS non-AQ,2015,Alabama,2,0,2,1.0
vs. FBS Power 5,2015,Alabama,11,1,12,0.9166666666666666
vs. FBS non-Power 5,2015,Alabama,2,0,2,1.0
in August/September,2015,Alabama,3,1,4,0.75
in October,2015,Alabama,4,0,4,1.0
in November,2015,Alabama,4,0,4,1.0
in December/January,2015,Alabama,3,0,3,1.0
All Games,2016,Alabama,14,1,15,0.9333333333333333
at Home,2016,Alabama,7,0,7,1.0
on Road/Neutral Site,2016,Alabama,7,1,8,0.875
vs. Conference,2016,Alabama,9,0,9,1.0
vs. Non-Conference,2016,Alabama,5,1,6,0.8333333333333334
vs. Ranked (AP),2016,Alabama,5,1,6,0.8333333333333334
vs. Unranked (AP),2016,Alabama,9,0,9,1.0
vs. FBS (I-A),2016,Alabama,13,1,14,0.9285714285714286
vs. FCS (I-AA),2016,Alabama,1,0,1,1.0
vs. FBS Winning,2016,Alabama,10,1,11,0.9090909090909091
vs. FBS Non-Winning,2016,Alabama,3,0,3,1.0
vs. BCS AQ,2016,Alabama,11,1,12,0.9166666666666666
vs. BCS non-AQ,2016,Alabama,2,0,2,1.0
vs. FBS Power 5,2016,Alabama,11,1,12,0.9166666666666666
vs. FBS non-Power 5,2016,Alabama,2,0,2,1.0
in August/September,2016,Alabama,4,0,4,1.0
in October,2016,Alabama,4,0,4,1.0
in November,2016,Alabama,4,0,4,1.0
in December/January,2016,Alabama,2,1,3,0.6666666666666666
All Games,2017,Alabama,13,1,14,0.9285714285714286
at Home,2017,Alabama,7,0,7,1.0
on Road/Neutral Site,2017,Alabama,6,1,7,0.8571428571428571
vs. Conference,2017,Alabama,8,1,9,0.8888888888888888
vs. Non-Conference,2017,Alabama,5,0,5,1.0
vs. Ranked (AP),2017,Alabama,4,1,5,0.8
vs. Unranked (AP),2017,Alabama,9,0,9,1.0
vs. FBS (I-A),2017,Alabama,12,1,13,0.9230769230769231
vs. FCS (I-AA),2017,Alabama,1,0,1,1.0
vs. FBS Winning,2017,Alabama,8,1,9,0.8888888888888888
vs. FBS Non-Winning,2017,Alabama,4,0,4,1.0
vs. BCS AQ,2017,Alabama,10,1,11,0.9090909090909091
vs. BCS non-AQ,2017,Alabama,2,0,2,1.0
vs. FBS Power 5,2017,Alabama,10,1,11,0.9090909090909091
vs. FBS non-Power 5,2017,Alabama,2,0,2,1.0
in August/September,2017,Alabama,5,0,5,1.0
in October,2017,Alabama,3,0,3,1.0
in November,2017,Alabama,3,1,4,0.75
in December/January,2017,Alabama,2,0,2,1.0
All Games,2018,Alabama,14,1,15,0.9333333333333333
at Home,2018,Alabama,7,0,7,1.0
on Road/Neutral Site,2018,Alabama,7,1,8,0.875
vs. Conference,2018,Alabama,9,0,9,1.0
vs. Non-Conference,2018,Alabama,5,1,6,0.8333333333333334
vs. Ranked (AP),2018,Alabama,4,1,5,0.8
vs. Unranked (AP),2018,Alabama,10,0,10,1.0
vs. FBS (I-A),2018,Alabama,13,1,14,0.9285714285714286
vs. FCS (I-AA),2018,Alabama,1,0,1,1.0
vs. FBS Winning,2018,Alabama,8,1,9,0.8888888888888888
vs. FBS Non-Winning,2018,Alabama,5,0,5,1.0
vs. BCS AQ,2018,Alabama,11,1,12,0.9166666666666666
vs. BCS non-AQ,2018,Alabama,2,0,2,1.0
vs. FBS Power 5,2018,Alabama,11,1,12,0.9166666666666666
vs. FBS non-Power 5,2018,Alabama,2,0,2,1.0
in August/September,2018,Alabama,5,0,5,1.0
in October,2018,Alabama,3,0,3,1.0
in November,2018,Alabama,4,0,4,1.0
in December/January,2018,Alabama,2,1,3,0.6666666666666666
All Games,2019,Alabama,11,2,13,0.8461538461538461
at Home,2019,Alabama,6,1,7,0.8571428571428571
on Road/Neutral Site,2019,Alabama,5,1,6,0.8333333333333334
vs. Conference,2019,Alabama,6,2,8,0.75
vs. Non-Conference,2019,Alabama,5,0,5,1.0
vs. Ranked (AP),2019,Alabama,1,2,3,0.3333333333333333
vs. Unranked (AP),2019,Alabama,10,0,10,1.0
vs. FBS (I-A),2019,Alabama,10,2,12,0.8333333333333334
vs. FCS (I-AA),2019,Alabama,1,0,1,1.0
vs. FBS Winning,2019,Alabama,4,2,6,0.6666666666666666
vs. FBS Non-Winning,2019,Alabama,6,0,6,1.0
vs. BCS AQ,2019,Alabama,8,2,10,0.8
vs. BCS non-AQ,2019,Alabama,2,0,2,1.0
vs. FBS Power 5,2019,Alabama,8,2,10,0.8
vs. FBS non-Power 5,2019,Alabama,2,0,2,1.0
in August/September,2019,Alabama,5,0,5,1.0
in October,2019,Alabama,3,0,3,1.0
in November,2019,Alabama,2,2,4,0.5
in December/January,2019,Alabama,1,0,1,1.0
All Games,2020,Alabama,13,0,13,1.0
at Home,2020,Alabama,5,0,5,1.0
on Road/Neutral Site,2020,Alabama,8,0,8,1.0
vs. Conference,2020,Alabama,11,0,11,1.0
vs. Non-Conference,2020,Alabama,2,0,2,1.0
vs. Ranked (AP),2020,Alabama,5,0,5,1.0
vs. Unranked (AP),2020,Alabama,8,0,8,1.0
vs. FBS (I-A),2020,Alabama,13,0,13,1.0
vs. FCS (I-AA),2020,Alabama,0,0,0,
vs. FBS Winning,2020,Alabama,6,0,6,1.0
vs. FBS Non-Winning,2020,Alabama,7,0,7,1.0
vs. BCS AQ,2020,Alabama,13,0,13,1.0
vs. BCS non-AQ,2020,Alabama,0,0,0,
vs. FBS Power 5,2020,Alabama,13,0,13,1.0
vs. FBS non-Power 5,2020,Alabama,0,0,0,
in August/September,2020,Alabama,1,0,1,1.0
in October,2020,Alabama,5,0,5,1.0
in November,2020,Alabama,2,0,2,1.0
in December/January,2020,Alabama,5,0,5,1.0
All Games,2021,Alabama,13,2,15,0.8666666666666667
at Home,2021,Alabama,7,0,7,1.0
on Road/Neutral Site,2021,Alabama,6,2,8,0.75
vs. Conference,2021,Alabama,8,2,10,0.8
vs. Non-Conference,2021,Alabama,5,0,5,1.0
vs. Ranked (AP),2021,Alabama,4,1,5,0.8
vs. Unranked (AP),2021,Alabama,9,1,10,0.9
vs. FBS (I-A),2021,Alabama,12,2,14,0.8571428571428571
vs. FCS (I-AA),2021,Alabama,1,0,1,1.0
vs. FBS Winning,2021,Alabama,7,2,9,0.7777777777777778
vs. FBS Non-Winning,2021,Alabama,5,0,5,1.0
vs. BCS AQ,2021,Alabama,10,2,12,0.8333333333333334
vs. BCS non-AQ,2021,Alabama,2,0,2,1.0
vs. FBS Power 5,2021,Alabama,9,2,11,0.8181818181818182
vs. FBS non-Power 5,2021,Alabama,3,0,3,1.0
in August/September,2021,Alabama,4,0,4,1.0
in October,2021,Alabama,3,1,4,0.75
in November,2021,Alabama,4,0,4,1.0
in December/January,2021,Alabama,2,1,3,0.6666666666666666
All Games,2022,Alabama,11,2,13,0.8461538461538461
at Home,2022,Alabama,7,0,7,1.0
on Road/Neutral Site,2022,Alabama,4,2,6,0.6666666666666666
vs. Conference,2022,Alabama,6,2,8,0.75
vs. Non-Conference,2022,Alabama,5,0,5,1.0
vs. Ranked (AP),2022,Alabama,3,2,5,0.6
vs. Unranked (AP),2022,Alabama,8,0,8,1.0
vs. FBS (I-A),2022,Alabama,10,2,12,0.8333333333333334
vs. FCS (I-AA),2022,Alabama,1,0,1,1.0
vs. FBS Winning,2022,Alabama,5,2,7,0.7142857142857143
vs. FBS Non-Winning,2022,Alabama,5,0,5,1.0
vs. BCS AQ,2022,Alabama,8,2,10,0.8
vs. BCS non-AQ,2022,Alabama,2,0,2,1.0
vs. FBS Power 5,2022,Alabama,8,2,10,0.8
vs. FBS non-Power 5,2022,Alabama,2,0,2,1.0
in August/September,2022,Alabama,4,0,4,1.0
in October,2022,Alabama,3,1,4,0.75
in November,2022,Alabama,3,1,4,0.75
in December/January,2022,Alabama,1,0,1,1.0
All Games,2014,Appalachian State,7,5,12,0.5833333333333334
at Home,2014,Appalachian State,4,2,6,0.6666666666666666
on Road/Neutral Site,2014,Appalachian State,3,3,6,0.5
vs. Conference,2014,Appalachian State,6,2,8,0.75
vs. Non-Conference,2014,Appalachian State,1,3,4,0.25
vs. Ranked (AP),2014,Appalachian State,0,0,0,
vs. Unranked (AP),2014,Appalachian State,7,5,12,0.5833333333333334
vs. FBS (I-A),2014,Appalachian State,6,4,10,0.6
vs. FCS (I-AA),2014,Appalachian State,1,1,2,0.5
vs. FBS Winning,2014,Appalachian State,2,1,3,0.6666666666666666
vs. FBS Non-Winning,2014,Appalachian State,4,3,7,0.5714285714285714
vs. BCS AQ,2014,Appalachian State,0,1,1,0.0
vs. BCS non-AQ,2014,Appalachian State,6,3,9,0.6666666666666666
vs. FBS Power 5,2014,Appalachian State,0,1,1,0.0
vs. FBS non-Power 5,2014,Appalachian State,6,3,9,0.6666666666666666
in August/September,2014,Appalachian State,1,3,4,0.25
in October,2014,Appalachian State,1,2,3,0.3333333333333333
in November,2014,Appalachian State,5,0,5,1.0
in December/January,2014,Appalachian State,0,0,0,
All Games,2015,Appalachian State,11,2,13,0.8461538461538461
at Home,2015,Appalachian State,5,1,6,0.8333333333333334
on Road/Neutral Site,2015,Appalachian State,6,1,7,0.8571428571428571
vs. Conference,2015,Appalachian State,7,1,8,0.875
vs. Non-Conference,2015,Appalachian State,4,1,5,0.8
vs. Ranked (AP),2015,Appalachian State,0,1,1,0.0
vs. Unranked (AP),2015,Appalachian State,11,1,12,0.9166666666666666
vs. FBS (I-A),2015,Appalachian State,10,2,12,0.8333333333333334
vs. FCS (I-AA),2015,Appalachian State,1,0,1,1.0
vs. FBS Winning,2015,Appalachian State,2,2,4,0.5
vs. FBS Non-Winning,2015,Appalachian State,8,0,8,1.0
vs. BCS AQ,2015,Appalachian State,0,1,1,0.0
vs. BCS non-AQ,2015,Appalachian State,10,1,11,0.9090909090909091
vs. FBS Power 5,2015,Appalachian State,0,1,1,0.0
vs. FBS non-Power 5,2015,Appalachian State,10,1,11,0.9090909090909091
in August/September,2015,Appalachian State,2,1,3,0.6666666666666666
in October,2015,Appalachian State,5,0,5,1.0
in November,2015,Appalachian State,2,1,3,0.6666666666666666
in December/January,2015,Appalachian State,2,0,2,1.0
All Games,2016,Appalachian State,10,3,13,0.7692307692307693
at Home,2016,Appalachian State,5,1,6,0.8333333333333334
on Road/Neutral Site,2016,Appalachian State,5,2,7,0.7142857142857143
vs. Conference,2016,Appalachian State,7,1,8,0.875
vs. Non-Conference,2016,Appalachian State,3,2,5,0.6
vs. Ranked (AP),2016,Appalachian State,0,0,0,
vs. Unranked (AP),2016,Appalachian State,10,3,13,0.7692307692307693
vs. FBS (I-A),2016,Appalachian State,10,3,13,0.7692307692307693
vs. FCS (I-AA),2016,Appalachian State,0,0,0,
vs. FBS Winning,2016,Appalachian State,3,3,6,0.5
vs. FBS Non-Winning,2016,Appalachian State,7,0,7,1.0
vs. BCS AQ,2016,Appalachian State,0,2,2,0.0
vs. BCS non-AQ,2016,Appalachian State,10,1,11,0.9090909090909091
vs. FBS Power 5,2016,Appalachian State,0,2,2,0.0
vs. FBS non-Power 5,2016,Appalachian State,10,1,11,0.9090909090909091
in August/September,2016,Appalachian State,2,2,4,0.5
in October,2016,Appalachian State,4,0,4,1.0
in November,2016,Appalachian State,3,1,4,0.75
in December/January,2016,Appalachian State,1,0,1,1.0
All Games,2017,Appalachian State,9,4,13,0.6923076923076923
at Home,2017,Appalachian State,5,1,6,0.8333333333333334
on Road/Neutral Site,2017,Appalachian State,4,3,7,0.5714285714285714
vs. Conference,2017,Appalachian State,7,1,8,0.875
vs. Non-Conference,2017,Appalachian State,2,3,5,0.4
vs. Ranked (AP),2017,Appalachian State,0,1,1,0.0
vs. Unranked (AP),2017,Appalachian State,9,3,12,0.75
vs. FBS (I-A),2017,Appalachian State,8,4,12,0.6666666666666666
vs. FCS (I-AA),2017,Appalachian State,1,0,1,1.0
vs. FBS Winning,2017,Appalachian State,3,2,5,0.6
vs. FBS Non-Winning,2017,Appalachian State,5,2,7,0.7142857142857143
vs. BCS AQ,2017,Appalachian State,0,2,2,0.0
vs. BCS non-AQ,2017,Appalachian State,8,2,10,0.8
vs. FBS Power 5,2017,Appalachian State,0,2,2,0.0
vs. FBS non-Power 5,2017,Appalachian State,8,2,10,0.8
in August/September,2017,Appalachian State,2,2,4,0.5
in October,2017,Appalachian State,3,1,4,0.75
in November,2017,Appalachian State,2,1,3,0.6666666666666666
in December/January,2017,Appalachian State,2,0,2,1.0
All Games,2018,Appalachian State,11,2,13,0.8461538461538461
at Home,2018,Appalachian State,6,0,6,1.0
on Road/Neutral Site,2018,Appalachian State,5,2,7,0.7142857142857143
vs. Conference,2018,Appalachian State,8,1,9,0.8888888888888888
vs. Non-Conference,2018,Appalachian State,3,1,4,0.75
vs. Ranked (AP),2018,Appalachian State,0,1,1,0.0
vs. Unranked (AP),2018,Appalachian State,11,1,12,0.9166666666666666
vs. FBS (I-A),2018,Appalachian State,10,2,12,0.8333333333333334
vs. FCS (I-AA),2018,Appalachian State,1,0,1,1.0
vs. FBS Winning,2018,Appalachian State,3,2,5,0.6
vs. FBS Non-Winning,2018,Appalachian State,7,0,7,1.0
vs. BCS AQ,2018,Appalachian State,0,1,1,0.0
vs. BCS non-AQ,2018,Appalachian State,10,1,11,0.9090909090909091
vs. FBS Power 5,2018,Appalachian State,0,1,1,0.0
vs. FBS non-Power 5,2018,Appalachian State,10,1,11,0.9090909090909091
in August/September,2018,Appalachian State,3,1,4,0.75
in October,2018,Appalachian State,2,1,3,0.6666666666666666
in November,2018,Appalachian State,4,0,4,1.0
in December/January,2018,Appalachian State,2,0,2,1.0
All Games,2019,Appalachian State,13,1,14,0.9285714285714286
at Home,2019,Appalachian State,6,1,7,0.8571428571428571
on Road/Neutral Site,2019,Appalachian State,7,0,7,1.0
vs. Conference,2019,Appalachian State,8,1,9,0.8888888888888888
vs. Non-Conference,2019,Appalachian State,5,0,5,1.0
vs. Ranked (AP),2019,Appalachian State,0,0,0,
vs. Unranked (AP),2019,Appalachian State,13,1,14,0.9285714285714286
vs. FBS (I-A),2019,Appalachian State,12,1,13,0.9230769230769231
vs. FCS (I-AA),2019,Appalachian State,1,0,1,1.0
vs. FBS Winning,2019,Appalachian State,6,1,7,0.8571428571428571
vs. FBS Non-Winning,2019,Appalachian State,6,0,6,1.0
vs. BCS AQ,2019,Appalachian State,2,0,2,1.0
vs. BCS non-AQ,2019,Appalachian State,10,1,11,0.9090909090909091
vs. FBS Power 5,2019,Appalachian State,2,0,2,1.0
vs. FBS non-Power 5,2019,Appalachian State,10,1,11,0.9090909090909091
in August/September,2019,Appalachian State,4,0,4,1.0
in October,2019,Appalachian State,3,1,4,0.75
in November,2019,Appalachian State,4,0,4,1.0
in December/January,2019,Appalachian State,2,0,2,1.0
All Games,2020,Appalachian State,9,3,12,0.75
at Home,2020,Appalachian State,5,1,6,0.8333333333333334
on Road/Neutral Site,2020,Appalachian State,4,2,6,0.6666666666666666
vs. Conference,2020,Appalachian State,6,2,8,0.75
vs. Non-Conference,2020,Appalachian State,3,1,4,0.75
vs. Ranked (AP),2020,Appalachian State,0,2,2,0.0
vs. Unranked (AP),2020,Appalachian State,9,1,10,0.9
vs. FBS (I-A),2020,Appalachian State,8,3,11,0.7272727272727273
vs. FCS (I-AA),2020,Appalachian State,1,0,1,1.0
vs. FBS Winning,2020,Appalachian State,2,3,5,0.4
vs. FBS Non-Winning,2020,Appalachian State,6,0,6,1.0
vs. BCS AQ,2020,Appalachian State,0,0,0,
vs. BCS non-AQ,2020,Appalachian State,8,3,11,0.7272727272727273
vs. FBS Power 5,2020,Appalachian State,0,0,0,
vs. FBS non-Power 5,2020,Appalachian State,8,3,11,0.7272727272727273
in August/September,2020,Appalachian State,2,1,3,0.6666666666666666
in October,2020,Appalachian State,2,0,2,1.0
in November,2020,Appalachian State,3,1,4,0.75
in December/January,2020,Appalachian State,2,1,3,0.6666666666666666
All Games,2021,Appalachian State,10,4,14,0.7142857142857143
at Home,2021,Appalachian State,6,0,6,1.0
on Road/Neutral Site,2021,Appalachian State,4,4,8,0.5
vs. Conference,2021,Appalachian State,7,2,9,0.7777777777777778
vs. Non-Conference,2021,Appalachian State,3,2,5,0.6
vs. Ranked (AP),2021,Appalachian State,0,2,2,0.0
vs. Unranked (AP),2021,Appalachian State,10,2,12,0.8333333333333334
vs. FBS (I-A),2021,Appalachian State,9,4,13,0.6923076923076923
vs. FCS (I-AA),2021,Appalachian State,1,0,1,1.0
vs. FBS Winning,2021,Appalachian State,4,4,8,0.5
vs. FBS Non-Winning,2021,Appalachian State,5,0,5,1.0
vs. BCS AQ,2021,Appalachian State,1,1,2,0.5
vs. BCS non-AQ,2021,Appalachian State,8,3,11,0.7272727272727273
vs. FBS Power 5,2021,Appalachian State,0,1,1,0.0
vs. FBS non-Power 5,2021,Appalachian State,9,3,12,0.75
in August/September,2021,Appalachian State,3,1,4,0.75
in October,2021,Appalachian State,3,1,4,0.75
in November,2021,Appalachian State,4,0,4,1.0
in December/January,2021,Appalachian State,0,2,2,0.0
All Games,2022,Appalachian State,6,6,12,0.5
at Home,2022,Appalachian State,5,2,7,0.7142857142857143
on Road/Neutral Site,2022,Appalachian State,1,4,5,0.2
vs. Conference,2022,Appalachian State,3,5,8,0.375
vs. Non-Conference,2022,Appalachian State,3,1,4,0.75
vs. Ranked (AP),2022,Appalachian State,1,0,1,1.0
vs. Unranked (AP),2022,Appalachian State,5,6,11,0.45454545454545453
vs. FBS (I-A),2022,Appalachian State,4,6,10,0.4
vs. FCS (I-AA),2022,Appalachian State,2,0,2,1.0
vs. FBS Winning,2022,Appalachian State,1,4,5,0.2
vs. FBS Non-Winning,2022,Appalachian State,3,2,5,0.6
vs. BCS AQ,2022,Appalachian State,1,1,2,0.5
vs. BCS non-AQ,2022,Appalachian State,3,5,8,0.375
vs. FBS Power 5,2022,Appalachian State,1,1,2,0.5
vs. FBS non-Power 5,2022,Appalachian State,3,5,8,0.375
in August/September,2022,Appalachian State,2,2,4,0.5
in October,2022,Appalachian State,3,1,4,0.75
in November,2022,Appalachian State,1,3,4,0.25
in December/January,2022,Appalachian State,0,0,0,
All Games,2009,Arizona,8,5,13,0.6153846153846154
at Home,2009,Arizona,5,1,6,0.8333333333333334
on Road/Neutral Site,2009,Arizona,3,4,7,0.42857142857142855
vs. Conference,2009,Arizona,6,3,9,0.6666666666666666
vs. Non-Conference,2009,Arizona,2,2,4,0.5
vs. Ranked (AP),2009,Arizona,2,3,5,0.4
vs. Unranked (AP),2009,Arizona,6,2,8,0.75
vs. FBS (I-A),2009,Arizona,7,5,12,0.5833333333333334
vs. FCS (I-AA),2009,Arizona,1,0,1,1.0
vs. FBS Winning,2009,Arizona,5,4,9,0.5555555555555556
vs. FBS Non-Winning,2009,Arizona,2,1,3,0.6666666666666666
vs. BCS AQ,2009,Arizona,6,5,11,0.5454545454545454
vs. BCS non-AQ,2009,Arizona,1,0,1,1.0
vs. FBS Power 5,2009,Arizona,6,5,11,0.5454545454545454
vs. FBS non-Power 5,2009,Arizona,1,0,1,1.0
in August/September,2009,Arizona,3,1,4,0.75
in October,2009,Arizona,2,1,3,0.6666666666666666
in November,2009,Arizona,2,2,4,0.5
in December/January,2009,Arizona,1,1,2,0.5
All Games,2010,Arizona,7,6,13,0.5384615384615384
at Home,2010,Arizona,4,3,7,0.5714285714285714
on Road/Neutral Site,2010,Arizona,3,3,6,0.5
vs. Conference,2010,Arizona,4,5,9,0.4444444444444444
vs. Non-Conference,2010,Arizona,3,1,4,0.75
vs. Ranked (AP),2010,Arizona,0,3,3,0.0
vs. Unranked (AP),2010,Arizona,7,3,10,0.7
vs. FBS (I-A),2010,Arizona,6,6,12,0.5
vs. FCS (I-AA),2010,Arizona,1,0,1,1.0
vs. FBS Winning,2010,Arizona,3,4,7,0.42857142857142855
vs. FBS Non-Winning,2010,Arizona,3,2,5,0.6
vs. BCS AQ,2010,Arizona,5,6,11,0.45454545454545453
vs. BCS non-AQ,2010,Arizona,1,0,1,1.0
vs. FBS Power 5,2010,Arizona,5,6,11,0.45454545454545453
vs. FBS non-Power 5,2010,Arizona,1,0,1,1.0
in August/September,2010,Arizona,4,0,4,1.0
in October,2010,Arizona,3,1,4,0.75
in November,2010,Arizona,0,3,3,0.0
in December/January,2010,Arizona,0,2,2,0.0
All Games,2011,Arizona,4,8,12,0.3333333333333333
at Home,2011,Arizona,3,3,6,0.5
on Road/Neutral Site,2011,Arizona,1,5,6,0.16666666666666666
vs. Conference,2011,Arizona,2,7,9,0.2222222222222222
vs. Non-Conference,2011,Arizona,2,1,3,0.6666666666666666
vs. Ranked (AP),2011,Arizona,0,4,4,0.0
vs. Unranked (AP),2011,Arizona,4,4,8,0.5
vs. FBS (I-A),2011,Arizona,3,8,11,0.2727272727272727
vs. FCS (I-AA),2011,Arizona,1,0,1,1.0
vs. FBS Winning,2011,Arizona,1,6,7,0.14285714285714285
vs. FBS Non-Winning,2011,Arizona,2,2,4,0.5
vs. BCS AQ,2011,Arizona,2,8,10,0.2
vs. BCS non-AQ,2011,Arizona,1,0,1,1.0
vs. FBS Power 5,2011,Arizona,2,8,10,0.2
vs. FBS non-Power 5,2011,Arizona,1,0,1,1.0
in August/September,2011,Arizona,1,3,4,0.25
in October,2011,Arizona,1,3,4,0.25
in November,2011,Arizona,2,2,4,0.5
in December/January,2011,Arizona,0,0,0,
All Games,2012,Arizona,8,5,13,0.6153846153846154
at Home,2012,Arizona,6,2,8,0.75
on Road/Neutral Site,2012,Arizona,2,3,5,0.4
vs. Conference,2012,Arizona,4,5,9,0.4444444444444444
vs. Non-Conference,2012,Arizona,4,0,4,1.0
vs. Ranked (AP),2012,Arizona,0,3,3,0.0
vs. Unranked (AP),2012,Arizona,8,2,10,0.8
vs. FBS (I-A),2012,Arizona,7,5,12,0.5833333333333334
vs. FCS (I-AA),2012,Arizona,1,0,1,1.0
vs. FBS Winning,2012,Arizona,5,5,10,0.5
vs. FBS Non-Winning,2012,Arizona,2,0,2,1.0
vs. BCS AQ,2012,Arizona,5,5,10,0.5
vs. BCS non-AQ,2012,Arizona,2,0,2,1.0
vs. FBS Power 5,2012,Arizona,5,5,10,0.5
vs. FBS non-Power 5,2012,Arizona,2,0,2,1.0
in August/September,2012,Arizona,3,2,5,0.6
in October,2012,Arizona,2,1,3,0.6666666666666666
in November,2012,Arizona,2,2,4,0.5
in December/January,2012,Arizona,1,0,1,1.0
All Games,2013,Arizona,8,5,13,0.6153846153846154
at Home,2013,Arizona,4,2,6,0.6666666666666666
on Road/Neutral Site,2013,Arizona,4,3,7,0.5714285714285714
vs. Conference,2013,Arizona,4,5,9,0.4444444444444444
vs. Non-Conference,2013,Arizona,4,0,4,1.0
vs. Ranked (AP),2013,Arizona,1,4,5,0.2
vs. Unranked (AP),2013,Arizona,7,1,8,0.875
vs. FBS (I-A),2013,Arizona,7,5,12,0.5833333333333334
vs. FCS (I-AA),2013,Arizona,1,0,1,1.0
vs. FBS Winning,2013,Arizona,4,4,8,0.5
vs. FBS Non-Winning,2013,Arizona,3,1,4,0.75
vs. BCS AQ,2013,Arizona,5,5,10,0.5
vs. BCS non-AQ,2013,Arizona,2,0,2,1.0
vs. FBS Power 5,2013,Arizona,5,5,10,0.5
vs. FBS non-Power 5,2013,Arizona,2,0,2,1.0
in August/September,2013,Arizona,3,1,4,0.75
in October,2013,Arizona,2,1,3,0.6666666666666666
in November,2013,Arizona,2,3,5,0.4
in December/January,2013,Arizona,1,0,1,1.0
All Games,2014,Arizona,10,4,14,0.7142857142857143
at Home,2014,Arizona,6,1,7,0.8571428571428571
on Road/Neutral Site,2014,Arizona,4,3,7,0.5714285714285714
vs. Conference,2014,Arizona,7,3,10,0.7
vs. Non-Conference,2014,Arizona,3,1,4,0.75
vs. Ranked (AP),2014,Arizona,3,4,7,0.42857142857142855
vs. Unranked (AP),2014,Arizona,7,0,7,1.0
vs. FBS (I-A),2014,Arizona,10,4,14,0.7142857142857143
vs. FCS (I-AA),2014,Arizona,0,0,0,
vs. FBS Winning,2014,Arizona,5,4,9,0.5555555555555556
vs. FBS Non-Winning,2014,Arizona,5,0,5,1.0
vs. BCS AQ,2014,Arizona,7,3,10,0.7
vs. BCS non-AQ,2014,Arizona,3,1,4,0.75
vs. FBS Power 5,2014,Arizona,7,3,10,0.7
vs. FBS non-Power 5,2014,Arizona,3,1,4,0.75
in August/September,2014,Arizona,4,0,4,1.0
in October,2014,Arizona,2,1,3,0.6666666666666666
in November,2014,Arizona,4,1,5,0.8
in December/January,2014,Arizona,0,2,2,0.0
All Games,2015,Arizona,7,6,13,0.5384615384615384
at Home,2015,Arizona,4,2,6,0.6666666666666666
on Road/Neutral Site,2015,Arizona,3,4,7,0.42857142857142855
vs. Conference,2015,Arizona,3,6,9,0.3333333333333333
vs. Non-Conference,2015,Arizona,4,0,4,1.0
vs. Ranked (AP),2015,Arizona,1,1,2,0.5
vs. Unranked (AP),2015,Arizona,6,5,11,0.5454545454545454
vs. FBS (I-A),2015,Arizona,6,6,12,0.5
vs. FCS (I-AA),2015,Arizona,1,0,1,1.0
vs. FBS Winning,2015,Arizona,3,5,8,0.375
vs. FBS Non-Winning,2015,Arizona,3,1,4,0.75
vs. BCS AQ,2015,Arizona,3,6,9,0.3333333333333333
vs. BCS non-AQ,2015,Arizona,3,0,3,1.0
vs. FBS Power 5,2015,Arizona,3,6,9,0.3333333333333333
vs. FBS non-Power 5,2015,Arizona,3,0,3,1.0
in August/September,2015,Arizona,3,1,4,0.75
in October,2015,Arizona,2,3,5,0.4
in November,2015,Arizona,1,2,3,0.3333333333333333
in December/January,2015,Arizona,1,0,1,1.0
All Games,2016,Arizona,3,9,12,0.25
at Home,2016,Arizona,3,4,7,0.42857142857142855
on Road/Neutral Site,2016,Arizona,0,5,5,0.0
vs. Conference,2016,Arizona,1,8,9,0.1111111111111111
vs. Non-Conference,2016,Arizona,2,1,3,0.6666666666666666
vs. Ranked (AP),2016,Arizona,0,4,4,0.0
vs. Unranked (AP),2016,Arizona,3,5,8,0.375
vs. FBS (I-A),2016,Arizona,2,9,11,0.18181818181818182
vs. FCS (I-AA),2016,Arizona,1,0,1,1.0
vs. FBS Winning,2016,Arizona,0,7,7,0.0
vs. FBS Non-Winning,2016,Arizona,2,2,4,0.5
vs. BCS AQ,2016,Arizona,1,8,9,0.1111111111111111
vs. BCS non-AQ,2016,Arizona,1,1,2,0.5
vs. FBS Power 5,2016,Arizona,1,8,9,0.1111111111111111
vs. FBS non-Power 5,2016,Arizona,1,1,2,0.5
in August/September,2016,Arizona,2,2,4,0.5
in October,2016,Arizona,0,4,4,0.0
in November,2016,Arizona,1,3,4,0.25
in December/January,2016,Arizona,0,0,0,
All Games,2017,Arizona,7,6,13,0.5384615384615384
at Home,2017,Arizona,4,2,6,0.6666666666666666
on Road/Neutral Site,2017,Arizona,3,4,7,0.42857142857142855
vs. Conference,2017,Arizona,5,4,9,0.5555555555555556
vs. Non-Conference,2017,Arizona,2,2,4,0.5
vs. Ranked (AP),2017,Arizona,0,1,1,0.0
vs. Unranked (AP),2017,Arizona,7,5,12,0.5833333333333334
vs. FBS (I-A),2017,Arizona,6,6,12,0.5
vs. FCS (I-AA),2017,Arizona,1,0,1,1.0
vs. FBS Winning,2017,Arizona,1,6,7,0.14285714285714285
vs. FBS Non-Winning,2017,Arizona,5,0,5,1.0
vs. BCS AQ,2017,Arizona,5,6,11,0.45454545454545453
vs. BCS non-AQ,2017,Arizona,1,0,1,1.0
vs. FBS Power 5,2017,Arizona,5,5,10,0.5
vs. FBS non-Power 5,2017,Arizona,1,1,2,0.5
in August/September,2017,Arizona,2,2,4,0.5
in October,2017,Arizona,4,0,4,1.0
in November,2017,Arizona,1,3,4,0.25
in December/January,2017,Arizona,0,1,1,0.0
All Games,2018,Arizona,5,7,12,0.4166666666666667
at Home,2018,Arizona,4,3,7,0.5714285714285714
on Road/Neutral Site,2018,Arizona,1,4,5,0.2
vs. Conference,2018,Arizona,4,5,9,0.4444444444444444
vs. Non-Conference,2018,Arizona,1,2,3,0.3333333333333333
vs. Ranked (AP),2018,Arizona,0,1,1,0.0
vs. Unranked (AP),2018,Arizona,5,6,11,0.45454545454545453
vs. FBS (I-A),2018,Arizona,4,7,11,0.36363636363636365
vs. FCS (I-AA),2018,Arizona,1,0,1,1.0
vs. FBS Winning,2018,Arizona,2,5,7,0.2857142857142857
vs. FBS Non-Winning,2018,Arizona,2,2,4,0.5
vs. BCS AQ,2018,Arizona,4,6,10,0.4
vs. BCS non-AQ,2018,Arizona,0,1,1,0.0
vs. FBS Power 5,2018,Arizona,4,5,9,0.4444444444444444
vs. FBS non-Power 5,2018,Arizona,0,2,2,0.0
in August/September,2018,Arizona,2,3,5,0.4
in October,2018,Arizona,2,2,4,0.5
in November,2018,Arizona,1,2,3,0.3333333333333333
in December/January,2018,Arizona,0,0,0,
All Games,2019,Arizona,4,8,12,0.3333333333333333
at Home,2019,Arizona,3,3,6,0.5
on Road/Neutral Site,2019,Arizona,1,5,6,0.16666666666666666
vs. Conference,2019,Arizona,2,7,9,0.2222222222222222
vs. Non-Conference,2019,Arizona,2,1,3,0.6666666666666666
vs. Ranked (AP),2019,Arizona,0,2,2,0.0
vs. Unranked (AP),2019,Arizona,4,6,10,0.4
vs. FBS (I-A),2019,Arizona,3,8,11,0.2727272727272727
vs. FCS (I-AA),2019,Arizona,1,0,1,1.0
vs. FBS Winning,2019,Arizona,0,6,6,0.0
vs. FBS Non-Winning,2019,Arizona,3,2,5,0.6
vs. BCS AQ,2019,Arizona,3,7,10,0.3
vs. BCS non-AQ,2019,Arizona,0,1,1,0.0
vs. FBS Power 5,2019,Arizona,3,7,10,0.3
vs. FBS non-Power 5,2019,Arizona,0,1,1,0.0
in August/September,2019,Arizona,3,1,4,0.75
in October,2019,Arizona,1,3,4,0.25
in November,2019,Arizona,0,4,4,0.0
in December/January,2019,Arizona,0,0,0,
All Games,2020,Arizona,0,5,5,0.0
at Home,2020,Arizona,0,3,3,0.0
on Road/Neutral Site,2020,Arizona,0,2,2,0.0
vs. Conference,2020,Arizona,0,5,5,0.0
vs. Non-Conference,2020,Arizona,0,0,0,
vs. Ranked (AP),2020,Arizona,0,1,1,0.0
vs. Unranked (AP),2020,Arizona,0,4,4,0.0
vs. FBS (I-A),2020,Arizona,0,5,5,0.0
vs. FCS (I-AA),2020,Arizona,0,0,0,
vs. FBS Winning,2020,Arizona,0,3,3,0.0
vs. FBS Non-Winning,2020,Arizona,0,2,2,0.0
vs. BCS AQ,2020,Arizona,0,5,5,0.0
vs. BCS non-AQ,2020,Arizona,0,0,0,
vs. FBS Power 5,2020,Arizona,0,5,5,0.0
vs. FBS non-Power 5,2020,Arizona,0,0,0,
in August/September,2020,Arizona,0,0,0,
in October,2020,Arizona,0,0,0,
in November,2020,Arizona,0,3,3,0.0
in December/January,2020,Arizona,0,2,2,0.0
All Games,2021,Arizona,1,11,12,0.08333333333333333
at Home,2021,Arizona,1,5,6,0.16666666666666666
on Road/Neutral Site,2021,Arizona,0,6,6,0.0
vs. Conference,2021,Arizona,1,8,9,0.1111111111111111
vs. Non-Conference,2021,Arizona,0,3,3,0.0
vs. Ranked (AP),2021,Arizona,0,4,4,0.0
vs. Unranked (AP),2021,Arizona,1,7,8,0.125
vs. FBS (I-A),2021,Arizona,1,10,11,0.09090909090909091
vs. FCS (I-AA),2021,Arizona,0,1,1,0.0
vs. FBS Winning,2021,Arizona,0,7,7,0.0
vs. FBS Non-Winning,2021,Arizona,1,3,4,0.25
vs. BCS AQ,2021,Arizona,1,8,9,0.1111111111111111
vs. BCS non-AQ,2021,Arizona,0,2,2,0.0
vs. FBS Power 5,2021,Arizona,1,8,9,0.1111111111111111
vs. FBS non-Power 5,2021,Arizona,0,2,2,0.0
in August/September,2021,Arizona,0,4,4,0.0
in October,2021,Arizona,0,4,4,0.0
in November,2021,Arizona,1,3,4,0.25
in December/January,2021,Arizona,0,0,0,
All Games,2022,Arizona,5,7,12,0.4166666666666667
at Home,2022,Arizona,3,4,7,0.42857142857142855
on Road/Neutral Site,2022,Arizona,2,3,5,0.4
vs. Conference,2022,Arizona,3,6,9,0.3333333333333333
vs. Non-Conference,2022,Arizona,2,1,3,0.6666666666666666
vs. Ranked (AP),2022,Arizona,1,5,6,0.16666666666666666
vs. Unranked (AP),2022,Arizona,4,2,6,0.6666666666666666
vs. FBS (I-A),2022,Arizona,4,7,11,0.36363636363636365
vs. FCS (I-AA),2022,Arizona,1,0,1,1.0
vs. FBS Winning,2022,Arizona,2,6,8,0.25
vs. FBS Non-Winning,2022,Arizona,2,1,3,0.6666666666666666
vs. BCS AQ,2022,Arizona,3,7,10,0.3
vs. BCS non-AQ,2022,Arizona,1,0,1,1.0
vs. FBS Power 5,2022,Arizona,3,7,10,0.3
vs. FBS non-Power 5,2022,Arizona,1,0,1,1.0
in August/September,2022,Arizona,2,2,4,0.5
in October,2022,Arizona,1,3,4,0.25
in November,2022,Arizona,2,2,4,0.5
in December/January,2022,Arizona,0,0,0,
All Games,2009,Arizona State,4,8,12,0.3333333333333333
at Home,2009,Arizona State,3,4,7,0.42857142857142855
on Road/Neutral Site,2009,Arizona State,1,4,5,0.2
vs. Conference,2009,Arizona State,2,7,9,0.2222222222222222
vs. Non-Conference,2009,Arizona State,2,1,3,0.6666666666666666
vs. Ranked (AP),2009,Arizona State,0,2,2,0.0
vs. Unranked (AP),2009,Arizona State,4,6,10,0.4
vs. FBS (I-A),2009,Arizona State,3,8,11,0.2727272727272727
vs. FCS (I-AA),2009,Arizona State,1,0,1,1.0
vs. FBS Winning,2009,Arizona State,0,8,8,0.0
vs. FBS Non-Winning,2009,Arizona State,3,0,3,1.0
vs. BCS AQ,2009,Arizona State,2,8,10,0.2
vs. BCS non-AQ,2009,Arizona State,1,0,1,1.0
vs. FBS Power 5,2009,Arizona State,2,8,10,0.2
vs. FBS non-Power 5,2009,Arizona State,1,0,1,1.0
in August/September,2009,Arizona State,2,1,3,0.6666666666666666
in October,2009,Arizona State,2,3,5,0.4
in November,2009,Arizona State,0,4,4,0.0
in December/January,2009,Arizona State,0,0,0,
All Games,2010,Arizona State,6,6,12,0.5
at Home,2010,Arizona State,4,2,6,0.6666666666666666
on Road/Neutral Site,2010,Arizona State,2,4,6,0.3333333333333333
vs. Conference,2010,Arizona State,4,5,9,0.4444444444444444
vs. Non-Conference,2010,Arizona State,2,1,3,0.6666666666666666
vs. Ranked (AP),2010,Arizona State,0,3,3,0.0
vs. Unranked (AP),2010,Arizona State,6,3,9,0.6666666666666666
vs. FBS (I-A),2010,Arizona State,4,6,10,0.4
vs. FCS (I-AA),2010,Arizona State,2,0,2,1.0
vs. FBS Winning,2010,Arizona State,2,4,6,0.3333333333333333
vs. FBS Non-Winning,2010,Arizona State,2,2,4,0.5
vs. BCS AQ,2010,Arizona State,4,6,10,0.4
vs. BCS non-AQ,2010,Arizona State,0,0,0,
vs. FBS Power 5,2010,Arizona State,4,6,10,0.4
vs. FBS non-Power 5,2010,Arizona State,0,0,0,
in August/September,2010,Arizona State,2,2,4,0.5
in October,2010,Arizona State,2,2,4,0.5
in November,2010,Arizona State,1,2,3,0.3333333333333333
in December/January,2010,Arizona State,1,0,1,1.0
All Games,2011,Arizona State,6,7,13,0.46153846153846156
at Home,2011,Arizona State,5,2,7,0.7142857142857143
on Road/Neutral Site,2011,Arizona State,1,5,6,0.16666666666666666
vs. Conference,2011,Arizona State,4,5,9,0.4444444444444444
vs. Non-Conference,2011,Arizona State,2,2,4,0.5
vs. Ranked (AP),2011,Arizona State,1,2,3,0.3333333333333333
vs. Unranked (AP),2011,Arizona State,5,5,10,0.5
vs. FBS (I-A),2011,Arizona State,5,7,12,0.4166666666666667
vs. FCS (I-AA),2011,Arizona State,1,0,1,1.0
vs. FBS Winning,2011,Arizona State,3,4,7,0.42857142857142855
vs. FBS Non-Winning,2011,Arizona State,2,3,5,0.4
vs. BCS AQ,2011,Arizona State,5,6,11,0.45454545454545453
vs. BCS non-AQ,2011,Arizona State,0,1,1,0.0
vs. FBS Power 5,2011,Arizona State,5,6,11,0.45454545454545453
vs. FBS non-Power 5,2011,Arizona State,0,1,1,0.0
in August/September,2011,Arizona State,3,1,4,0.75
in October,2011,Arizona State,3,1,4,0.75
in November,2011,Arizona State,0,4,4,0.0
in December/January,2011,Arizona State,0,1,1,0.0
All Games,2012,Arizona State,8,5,13,0.6153846153846154
at Home,2012,Arizona State,4,2,6,0.6666666666666666
on Road/Neutral Site,2012,Arizona State,4,3,7,0.5714285714285714
vs. Conference,2012,Arizona State,5,4,9,0.5555555555555556
vs. Non-Conference,2012,Arizona State,3,1,4,0.75
vs. Ranked (AP),2012,Arizona State,0,2,2,0.0
vs. Unranked (AP),2012,Arizona State,8,3,11,0.7272727272727273
vs. FBS (I-A),2012,Arizona State,7,5,12,0.5833333333333334
vs. FCS (I-AA),2012,Arizona State,1,0,1,1.0
vs. FBS Winning,2012,Arizona State,2,4,6,0.3333333333333333
vs. FBS Non-Winning,2012,Arizona State,5,1,6,0.8333333333333334
vs. BCS AQ,2012,Arizona State,6,5,11,0.5454545454545454
vs. BCS non-AQ,2012,Arizona State,1,0,1,1.0
vs. FBS Power 5,2012,Arizona State,6,5,11,0.5454545454545454
vs. FBS non-Power 5,2012,Arizona State,1,0,1,1.0
in August/September,2012,Arizona State,4,1,5,0.8
in October,2012,Arizona State,1,2,3,0.3333333333333333
in November,2012,Arizona State,2,2,4,0.5
in December/January,2012,Arizona State,1,0,1,1.0
All Games,2013,Arizona State,10,4,14,0.7142857142857143
at Home,2013,Arizona State,7,1,8,0.875
on Road/Neutral Site,2013,Arizona State,3,3,6,0.5
vs. Conference,2013,Arizona State,8,2,10,0.8
vs. Non-Conference,2013,Arizona State,2,2,4,0.5
vs. Ranked (AP),2013,Arizona State,4,3,7,0.5714285714285714
vs. Unranked (AP),2013,Arizona State,6,1,7,0.8571428571428571
vs. FBS (I-A),2013,Arizona State,9,4,13,0.6923076923076923
vs. FCS (I-AA),2013,Arizona State,1,0,1,1.0
vs. FBS Winning,2013,Arizona State,6,4,10,0.6
vs. FBS Non-Winning,2013,Arizona State,3,0,3,1.0
vs. BCS AQ,2013,Arizona State,9,4,13,0.6923076923076923
vs. BCS non-AQ,2013,Arizona State,0,0,0,
vs. FBS Power 5,2013,Arizona State,9,3,12,0.75
vs. FBS non-Power 5,2013,Arizona State,0,1,1,0.0
in August/September,2013,Arizona State,3,1,4,0.75
in October,2013,Arizona State,3,1,4,0.75
in November,2013,Arizona State,4,0,4,1.0
in December/January,2013,Arizona State,0,2,2,0.0
All Games,2014,Arizona State,10,3,13,0.7692307692307693
at Home,2014,Arizona State,5,1,6,0.8333333333333334
on Road/Neutral Site,2014,Arizona State,5,2,7,0.7142857142857143
vs. Conference,2014,Arizona State,6,3,9,0.6666666666666666
vs. Non-Conference,2014,Arizona State,4,0,4,1.0
vs. Ranked (AP),2014,Arizona State,2,2,4,0.5
vs. Unranked (AP),2014,Arizona State,8,1,9,0.8888888888888888
vs. FBS (I-A),2014,Arizona State,9,3,12,0.75
vs. FCS (I-AA),2014,Arizona State,1,0,1,1.0
vs. FBS Winning,2014,Arizona State,6,2,8,0.75
vs. FBS Non-Winning,2014,Arizona State,3,1,4,0.75
vs. BCS AQ,2014,Arizona State,8,3,11,0.7272727272727273
vs. BCS non-AQ,2014,Arizona State,1,0,1,1.0
vs. FBS Power 5,2014,Arizona State,7,3,10,0.7
vs. FBS non-Power 5,2014,Arizona State,2,0,2,1.0
in August/September,2014,Arizona State,3,1,4,0.75
in October,2014,Arizona State,3,0,3,1.0
in November,2014,Arizona State,3,2,5,0.6
in December/January,2014,Arizona State,1,0,1,1.0
All Games,2015,Arizona State,6,7,13,0.46153846153846156
at Home,2015,Arizona State,5,2,7,0.7142857142857143
on Road/Neutral Site,2015,Arizona State,1,5,6,0.16666666666666666
vs. Conference,2015,Arizona State,4,5,9,0.4444444444444444
vs. Non-Conference,2015,Arizona State,2,2,4,0.5
vs. Ranked (AP),2015,Arizona State,0,2,2,0.0
vs. Unranked (AP),2015,Arizona State,6,5,11,0.5454545454545454
vs. FBS (I-A),2015,Arizona State,5,7,12,0.4166666666666667
vs. FCS (I-AA),2015,Arizona State,1,0,1,1.0
vs. FBS Winning,2015,Arizona State,4,7,11,0.36363636363636365
vs. FBS Non-Winning,2015,Arizona State,1,0,1,1.0
vs. BCS AQ,2015,Arizona State,4,7,11,0.36363636363636365
vs. BCS non-AQ,2015,Arizona State,1,0,1,1.0
vs. FBS Power 5,2015,Arizona State,4,7,11,0.36363636363636365
vs. FBS non-Power 5,2015,Arizona State,1,0,1,1.0
in August/September,2015,Arizona State,2,2,4,0.5
in October,2015,Arizona State,2,2,4,0.5
in November,2015,Arizona State,2,2,4,0.5
in December/January,2015,Arizona State,0,1,1,0.0
All Games,2016,Arizona State,5,7,12,0.4166666666666667
at Home,2016,Arizona State,4,2,6,0.6666666666666666
on Road/Neutral Site,2016,Arizona State,1,5,6,0.16666666666666666
vs. Conference,2016,Arizona State,2,7,9,0.2222222222222222
vs. Non-Conference,2016,Arizona State,3,0,3,1.0
vs. Ranked (AP),2016,Arizona State,0,3,3,0.0
vs. Unranked (AP),2016,Arizona State,5,4,9,0.5555555555555556
vs. FBS (I-A),2016,Arizona State,4,7,11,0.36363636363636365
vs. FCS (I-AA),2016,Arizona State,1,0,1,1.0
vs. FBS Winning,2016,Arizona State,0,5,5,0.0
vs. FBS Non-Winning,2016,Arizona State,4,2,6,0.6666666666666666
vs. BCS AQ,2016,Arizona State,3,7,10,0.3
vs. BCS non-AQ,2016,Arizona State,1,0,1,1.0
vs. FBS Power 5,2016,Arizona State,3,7,10,0.3
vs. FBS non-Power 5,2016,Arizona State,1,0,1,1.0
in August/September,2016,Arizona State,4,0,4,1.0
in October,2016,Arizona State,1,4,5,0.2
in November,2016,Arizona State,0,3,3,0.0
in December/January,2016,Arizona State,0,0,0,
All Games,2017,Arizona State,7,6,13,0.5384615384615384
at Home,2017,Arizona State,5,2,7,0.7142857142857143
on Road/Neutral Site,2017,Arizona State,2,4,6,0.3333333333333333
vs. Conference,2017,Arizona State,6,3,9,0.6666666666666666
vs. Non-Conference,2017,Arizona State,1,3,4,0.25
vs. Ranked (AP),2017,Arizona State,1,3,4,0.25
vs. Unranked (AP),2017,Arizona State,6,3,9,0.6666666666666666
vs. FBS (I-A),2017,Arizona State,7,6,13,0.5384615384615384
vs. FCS (I-AA),2017,Arizona State,0,0,0,
vs. FBS Winning,2017,Arizona State,5,4,9,0.5555555555555556
vs. FBS Non-Winning,2017,Arizona State,2,2,4,0.5
vs. BCS AQ,2017,Arizona State,6,5,11,0.5454545454545454
vs. BCS non-AQ,2017,Arizona State,1,1,2,0.5
vs. FBS Power 5,2017,Arizona State,6,5,11,0.5454545454545454
vs. FBS non-Power 5,2017,Arizona State,1,1,2,0.5
in August/September,2017,Arizona State,2,3,5,0.4
in October,2017,Arizona State,2,1,3,0.6666666666666666
in November,2017,Arizona State,3,1,4,0.75
in December/January,2017,Arizona State,0,1,1,0.0
All Games,2018,Arizona State,7,6,13,0.5384615384615384
at Home,2018,Arizona State,5,1,6,0.8333333333333334
on Road/Neutral Site,2018,Arizona State,2,5,7,0.2857142857142857
vs. Conference,2018,Arizona State,5,4,9,0.5555555555555556
vs. Non-Conference,2018,Arizona State,2,2,4,0.5
vs. Ranked (AP),2018,Arizona State,0,2,2,0.0
vs. Unranked (AP),2018,Arizona State,7,4,11,0.6363636363636364
vs. FBS (I-A),2018,Arizona State,7,6,13,0.5384615384615384
vs. FCS (I-AA),2018,Arizona State,0,0,0,
vs. FBS Winning,2018,Arizona State,2,5,7,0.2857142857142857
vs. FBS Non-Winning,2018,Arizona State,5,1,6,0.8333333333333334
vs. BCS AQ,2018,Arizona State,6,4,10,0.6
vs. BCS non-AQ,2018,Arizona State,1,2,3,0.3333333333333333
vs. FBS Power 5,2018,Arizona State,6,4,10,0.6
vs. FBS non-Power 5,2018,Arizona State,1,2,3,0.3333333333333333
in August/September,2018,Arizona State,3,2,5,0.6
in October,2018,Arizona State,1,2,3,0.3333333333333333
in November,2018,Arizona State,3,1,4,0.75
in December/January,2018,Arizona State,0,1,1,0.0
All Games,2019,Arizona State,8,5,13,0.6153846153846154
at Home,2019,Arizona State,5,2,7,0.7142857142857143
on Road/Neutral Site,2019,Arizona State,3,3,6,0.5
vs. Conference,2019,Arizona State,4,5,9,0.4444444444444444
vs. Non-Conference,2019,Arizona State,4,0,4,1.0
vs. Ranked (AP),2019,Arizona State,1,1,2,0.5
vs. Unranked (AP),2019,Arizona State,7,4,11,0.6363636363636364
vs. FBS (I-A),2019,Arizona State,7,5,12,0.5833333333333334
vs. FCS (I-AA),2019,Arizona State,1,0,1,1.0
vs. FBS Winning,2019,Arizona State,4,2,6,0.6666666666666666
vs. FBS Non-Winning,2019,Arizona State,3,3,6,0.5
vs. BCS AQ,2019,Arizona State,6,5,11,0.5454545454545454
vs. BCS non-AQ,2019,Arizona State,1,0,1,1.0
vs. FBS Power 5,2019,Arizona State,6,5,11,0.5454545454545454
vs. FBS non-Power 5,2019,Arizona State,1,0,1,1.0
in August/September,2019,Arizona State,4,1,5,0.8
in October,2019,Arizona State,1,2,3,0.3333333333333333
in November,2019,Arizona State,2,2,4,0.5
in December/January,2019,Arizona State,1,0,1,1.0
All Games,2020,Arizona State,2,2,4,0.5
at Home,2020,Arizona State,0,1,1,0.0
on Road/Neutral Site,2020,Arizona State,2,1,3,0.6666666666666666
vs. Conference,2020,Arizona State,2,2,4,0.5
vs. Non-Conference,2020,Arizona State,0,0,0,
vs. Ranked (AP),2020,Arizona State,0,1,1,0.0
vs. Unranked (AP),2020,Arizona State,2,1,3,0.6666666666666666
vs. FBS (I-A),2020,Arizona State,2,2,4,0.5
vs. FCS (I-AA),2020,Arizona State,0,0,0,
vs. FBS Winning,2020,Arizona State,0,1,1,0.0
vs. FBS Non-Winning,2020,Arizona State,2,1,3,0.6666666666666666
vs. BCS AQ,2020,Arizona State,2,2,4,0.5
vs. BCS non-AQ,2020,Arizona State,0,0,0,
vs. FBS Power 5,2020,Arizona State,2,2,4,0.5
vs. FBS non-Power 5,2020,Arizona State,0,0,0,
in August/September,2020,Arizona State,0,0,0,
in October,2020,Arizona State,0,0,0,
in November,2020,Arizona State,0,1,1,0.0
in December/January,2020,Arizona State,2,1,3,0.6666666666666666
All Games,2021,Arizona State,8,5,13,0.6153846153846154
at Home,2021,Arizona State,6,1,7,0.8571428571428571
on Road/Neutral Site,2021,Arizona State,2,4,6,0.3333333333333333
vs. Conference,2021,Arizona State,6,3,9,0.6666666666666666
vs. Non-Conference,2021,Arizona State,2,2,4,0.5
vs. Ranked (AP),2021,Arizona State,0,2,2,0.0
vs. Unranked (AP),2021,Arizona State,8,3,11,0.7272727272727273
vs. FBS (I-A),2021,Arizona State,7,5,12,0.5833333333333334
vs. FCS (I-AA),2021,Arizona State,1,0,1,1.0
vs. FBS Winning,2021,Arizona State,1,5,6,0.16666666666666666
vs. FBS Non-Winning,2021,Arizona State,6,0,6,1.0
vs. BCS AQ,2021,Arizona State,6,4,10,0.6
vs. BCS non-AQ,2021,Arizona State,1,1,2,0.5
vs. FBS Power 5,2021,Arizona State,6,4,10,0.6
vs. FBS non-Power 5,2021,Arizona State,1,1,2,0.5
in August/September,2021,Arizona State,3,1,4,0.75
in October,2021,Arizona State,2,2,4,0.5
in November,2021,Arizona State,3,1,4,0.75
in December/January,2021,Arizona State,0,1,1,0.0
All Games,2022,Arizona State,3,9,12,0.25
at Home,2022,Arizona State,2,4,6,0.3333333333333333
on Road/Neutral Site,2022,Arizona State,1,5,6,0.16666666666666666
vs. Conference,2022,Arizona State,2,7,9,0.2222222222222222
vs. Non-Conference,2022,Arizona State,1,2,3,0.3333333333333333
vs. Ranked (AP),2022,Arizona State,1,4,5,0.2
vs. Unranked (AP),2022,Arizona State,2,5,7,0.2857142857142857
vs. FBS (I-A),2022,Arizona State,2,9,11,0.18181818181818182
vs. FCS (I-AA),2022,Arizona State,1,0,1,1.0
vs. FBS Winning,2022,Arizona State,1,7,8,0.125
vs. FBS Non-Winning,2022,Arizona State,1,2,3,0.3333333333333333
vs. BCS AQ,2022,Arizona State,2,8,10,0.2
vs. BCS non-AQ,2022,Arizona State,0,1,1,0.0
vs. FBS Power 5,2022,Arizona State,2,8,10,0.2
vs. FBS non-Power 5,2022,Arizona State,0,1,1,0.0
in August/September,2022,Arizona State,1,3,4,0.25
in October,2022,Arizona State,2,2,4,0.5
in November,2022,Arizona State,0,4,4,0.0
in December/January,2022,Arizona State,0,0,0,
All Games,2009,Arkansas,8,5,13,0.6153846153846154
at Home,2009,Arkansas,6,1,7,0.8571428571428571
on Road/Neutral Site,2009,Arkansas,2,4,6,0.3333333333333333
vs. Conference,2009,Arkansas,3,5,8,0.375
vs. Non-Conference,2009,Arkansas,5,0,5,1.0
vs. Ranked (AP),2009,Arkansas,0,4,4,0.0
vs. Unranked (AP),2009,Arkansas,8,1,9,0.8888888888888888
vs. FBS (I-A),2009,Arkansas,7,5,12,0.5833333333333334
vs. FCS (I-AA),2009,Arkansas,1,0,1,1.0
vs. FBS Winning,2009,Arkansas,4,5,9,0.4444444444444444
vs. FBS Non-Winning,2009,Arkansas,3,0,3,1.0
vs. BCS AQ,2009,Arkansas,4,5,9,0.4444444444444444
vs. BCS non-AQ,2009,Arkansas,3,0,3,1.0
vs. FBS Power 5,2009,Arkansas,4,5,9,0.4444444444444444
vs. FBS non-Power 5,2009,Arkansas,3,0,3,1.0
in August/September,2009,Arkansas,1,2,3,0.3333333333333333
in October,2009,Arkansas,3,2,5,0.6
in November,2009,Arkansas,3,1,4,0.75
in December/January,2009,Arkansas,1,0,1,1.0
All Games,2010,Arkansas,10,3,13,0.7692307692307693
at Home,2010,Arkansas,5,1,6,0.8333333333333334
on Road/Neutral Site,2010,Arkansas,5,2,7,0.7142857142857143
vs. Conference,2010,Arkansas,6,2,8,0.75
vs. Non-Conference,2010,Arkansas,4,1,5,0.8
vs. Ranked (AP),2010,Arkansas,4,3,7,0.5714285714285714
vs. Unranked (AP),2010,Arkansas,6,0,6,1.0
vs. FBS (I-A),2010,Arkansas,9,3,12,0.75
vs. FCS (I-AA),2010,Arkansas,1,0,1,1.0
vs. FBS Winning,2010,Arkansas,4,3,7,0.5714285714285714
vs. FBS Non-Winning,2010,Arkansas,5,0,5,1.0
vs. BCS AQ,2010,Arkansas,7,3,10,0.7
vs. BCS non-AQ,2010,Arkansas,2,0,2,1.0
vs. FBS Power 5,2010,Arkansas,7,3,10,0.7
vs. FBS non-Power 5,2010,Arkansas,2,0,2,1.0
in August/September,2010,Arkansas,3,1,4,0.75
in October,2010,Arkansas,3,1,4,0.75
in November,2010,Arkansas,4,0,4,1.0
in December/January,2010,Arkansas,0,1,1,0.0
All Games,2011,Arkansas,11,2,13,0.8461538461538461
at Home,2011,Arkansas,7,0,7,1.0
on Road/Neutral Site,2011,Arkansas,4,2,6,0.6666666666666666
vs. Conference,2011,Arkansas,6,2,8,0.75
vs. Non-Conference,2011,Arkansas,5,0,5,1.0
vs. Ranked (AP),2011,Arkansas,2,2,4,0.5
vs. Unranked (AP),2011,Arkansas,9,0,9,1.0
vs. FBS (I-A),2011,Arkansas,10,2,12,0.8333333333333334
vs. FCS (I-AA),2011,Arkansas,1,0,1,1.0
vs. FBS Winning,2011,Arkansas,5,2,7,0.7142857142857143
vs. FBS Non-Winning,2011,Arkansas,5,0,5,1.0
vs. BCS AQ,2011,Arkansas,8,2,10,0.8
vs. BCS non-AQ,2011,Arkansas,2,0,2,1.0
vs. FBS Power 5,2011,Arkansas,8,2,10,0.8
vs. FBS non-Power 5,2011,Arkansas,2,0,2,1.0
in August/September,2011,Arkansas,3,1,4,0.75
in October,2011,Arkansas,4,0,4,1.0
in November,2011,Arkansas,3,1,4,0.75
in December/January,2011,Arkansas,1,0,1,1.0
All Games,2012,Arkansas,4,8,12,0.3333333333333333
at Home,2012,Arkansas,3,4,7,0.42857142857142855
on Road/Neutral Site,2012,Arkansas,1,4,5,0.2
vs. Conference,2012,Arkansas,2,6,8,0.25
vs. Non-Conference,2012,Arkansas,2,2,4,0.5
vs. Ranked (AP),2012,Arkansas,0,4,4,0.0
vs. Unranked (AP),2012,Arkansas,4,4,8,0.5
vs. FBS (I-A),2012,Arkansas,3,8,11,0.2727272727272727
vs. FCS (I-AA),2012,Arkansas,1,0,1,1.0
vs. FBS Winning,2012,Arkansas,1,8,9,0.1111111111111111
vs. FBS Non-Winning,2012,Arkansas,2,0,2,1.0
vs. BCS AQ,2012,Arkansas,2,7,9,0.2222222222222222
vs. BCS non-AQ,2012,Arkansas,1,1,2,0.5
vs. FBS Power 5,2012,Arkansas,2,6,8,0.25
vs. FBS non-Power 5,2012,Arkansas,1,2,3,0.3333333333333333
in August/September,2012,Arkansas,1,4,5,0.2
in October,2012,Arkansas,2,1,3,0.6666666666666666
in November,2012,Arkansas,1,3,4,0.25
in December/January,2012,Arkansas,0,0,0,
All Games,2013,Arkansas,3,9,12,0.25
at Home,2013,Arkansas,3,4,7,0.42857142857142855
on Road/Neutral Site,2013,Arkansas,0,5,5,0.0
vs. Conference,2013,Arkansas,0,8,8,0.0
vs. Non-Conference,2013,Arkansas,3,1,4,0.75
vs. Ranked (AP),2013,Arkansas,0,5,5,0.0
vs. Unranked (AP),2013,Arkansas,3,4,7,0.42857142857142855
vs. FBS (I-A),2013,Arkansas,2,9,11,0.18181818181818182
vs. FCS (I-AA),2013,Arkansas,1,0,1,1.0
vs. FBS Winning,2013,Arkansas,1,7,8,0.125
vs. FBS Non-Winning,2013,Arkansas,1,2,3,0.3333333333333333
vs. BCS AQ,2013,Arkansas,0,9,9,0.0
vs. BCS non-AQ,2013,Arkansas,2,0,2,1.0
vs. FBS Power 5,2013,Arkansas,0,8,8,0.0
vs. FBS non-Power 5,2013,Arkansas,2,1,3,0.6666666666666666
in August/September,2013,Arkansas,3,2,5,0.6
in October,2013,Arkansas,0,3,3,0.0
in November,2013,Arkansas,0,4,4,0.0
in December/January,2013,Arkansas,0,0,0,
All Games,2014,Arkansas,7,6,13,0.5384615384615384
at Home,2014,Arkansas,5,2,7,0.7142857142857143
on Road/Neutral Site,2014,Arkansas,2,4,6,0.3333333333333333
vs. Conference,2014,Arkansas,2,6,8,0.25
vs. Non-Conference,2014,Arkansas,5,0,5,1.0
vs. Ranked (AP),2014,Arkansas,1,5,6,0.16666666666666666
vs. Unranked (AP),2014,Arkansas,6,1,7,0.8571428571428571
vs. FBS (I-A),2014,Arkansas,6,6,12,0.5
vs. FCS (I-AA),2014,Arkansas,1,0,1,1.0
vs. FBS Winning,2014,Arkansas,3,6,9,0.3333333333333333
vs. FBS Non-Winning,2014,Arkansas,3,0,3,1.0
vs. BCS AQ,2014,Arkansas,4,6,10,0.4
vs. BCS non-AQ,2014,Arkansas,2,0,2,1.0
vs. FBS Power 5,2014,Arkansas,4,6,10,0.4
vs. FBS non-Power 5,2014,Arkansas,2,0,2,1.0
in August/September,2014,Arkansas,3,2,5,0.6
in October,2014,Arkansas,1,2,3,0.3333333333333333
in November,2014,Arkansas,2,2,4,0.5
in December/January,2014,Arkansas,1,0,1,1.0
All Games,2015,Arkansas,8,5,13,0.6153846153846154
at Home,2015,Arkansas,4,2,6,0.6666666666666666
on Road/Neutral Site,2015,Arkansas,4,3,7,0.5714285714285714
vs. Conference,2015,Arkansas,5,3,8,0.625
vs. Non-Conference,2015,Arkansas,3,2,5,0.6
vs. Ranked (AP),2015,Arkansas,3,1,4,0.75
vs. Unranked (AP),2015,Arkansas,5,4,9,0.5555555555555556
vs. FBS (I-A),2015,Arkansas,7,5,12,0.5833333333333334
vs. FCS (I-AA),2015,Arkansas,1,0,1,1.0
vs. FBS Winning,2015,Arkansas,4,5,9,0.4444444444444444
vs. FBS Non-Winning,2015,Arkansas,3,0,3,1.0
vs. BCS AQ,2015,Arkansas,6,4,10,0.6
vs. BCS non-AQ,2015,Arkansas,1,1,2,0.5
vs. FBS Power 5,2015,Arkansas,6,4,10,0.6
vs. FBS non-Power 5,2015,Arkansas,1,1,2,0.5
in August/September,2015,Arkansas,1,3,4,0.25
in October,2015,Arkansas,3,1,4,0.75
in November,2015,Arkansas,3,1,4,0.75
in December/January,2015,Arkansas,1,0,1,1.0
All Games,2016,Arkansas,7,6,13,0.5384615384615384
at Home,2016,Arkansas,5,2,7,0.7142857142857143
on Road/Neutral Site,2016,Arkansas,2,4,6,0.3333333333333333
vs. Conference,2016,Arkansas,3,5,8,0.375
vs. Non-Conference,2016,Arkansas,4,1,5,0.8
vs. Ranked (AP),2016,Arkansas,1,4,5,0.2
vs. Unranked (AP),2016,Arkansas,6,2,8,0.75
vs. FBS (I-A),2016,Arkansas,6,6,12,0.5
vs. FCS (I-AA),2016,Arkansas,1,0,1,1.0
vs. FBS Winning,2016,Arkansas,2,5,7,0.2857142857142857
vs. FBS Non-Winning,2016,Arkansas,4,1,5,0.8
vs. BCS AQ,2016,Arkansas,4,6,10,0.4
vs. BCS non-AQ,2016,Arkansas,2,0,2,1.0
vs. FBS Power 5,2016,Arkansas,4,6,10,0.4
vs. FBS non-Power 5,2016,Arkansas,2,0,2,1.0
in August/September,2016,Arkansas,3,1,4,0.75
in October,2016,Arkansas,2,2,4,0.5
in November,2016,Arkansas,2,2,4,0.5
in December/January,2016,Arkansas,0,1,1,0.0
All Games,2017,Arkansas,4,8,12,0.3333333333333333
at Home,2017,Arkansas,2,4,6,0.3333333333333333
on Road/Neutral Site,2017,Arkansas,2,4,6,0.3333333333333333
vs. Conference,2017,Arkansas,1,7,8,0.125
vs. Non-Conference,2017,Arkansas,3,1,4,0.75
vs. Ranked (AP),2017,Arkansas,0,5,5,0.0
vs. Unranked (AP),2017,Arkansas,4,3,7,0.5714285714285714
vs. FBS (I-A),2017,Arkansas,3,8,11,0.2727272727272727
vs. FCS (I-AA),2017,Arkansas,1,0,1,1.0
vs. FBS Winning,2017,Arkansas,1,8,9,0.1111111111111111
vs. FBS Non-Winning,2017,Arkansas,2,0,2,1.0
vs. BCS AQ,2017,Arkansas,1,8,9,0.1111111111111111
vs. BCS non-AQ,2017,Arkansas,2,0,2,1.0
vs. FBS Power 5,2017,Arkansas,1,8,9,0.1111111111111111
vs. FBS non-Power 5,2017,Arkansas,2,0,2,1.0
in August/September,2017,Arkansas,2,2,4,0.5
in October,2017,Arkansas,1,3,4,0.25
in November,2017,Arkansas,1,3,4,0.25
in December/January,2017,Arkansas,0,0,0,
All Games,2018,Arkansas,2,10,12,0.16666666666666666
at Home,2018,Arkansas,2,5,7,0.2857142857142857
on Road/Neutral Site,2018,Arkansas,0,5,5,0.0
vs. Conference,2018,Arkansas,0,8,8,0.0
vs. Non-Conference,2018,Arkansas,2,2,4,0.5
vs. Ranked (AP),2018,Arkansas,0,3,3,0.0
vs. Unranked (AP),2018,Arkansas,2,7,9,0.2222222222222222
vs. FBS (I-A),2018,Arkansas,1,10,11,0.09090909090909091
vs. FCS (I-AA),2018,Arkansas,1,0,1,1.0
vs. FBS Winning,2018,Arkansas,0,7,7,0.0
vs. FBS Non-Winning,2018,Arkansas,1,3,4,0.25
vs. BCS AQ,2018,Arkansas,1,8,9,0.1111111111111111
vs. BCS non-AQ,2018,Arkansas,0,2,2,0.0
vs. FBS Power 5,2018,Arkansas,0,8,8,0.0
vs. FBS non-Power 5,2018,Arkansas,1,2,3,0.3333333333333333
in August/September,2018,Arkansas,1,4,5,0.2
in October,2018,Arkansas,1,3,4,0.25
in November,2018,Arkansas,0,3,3,0.0
in December/January,2018,Arkansas,0,0,0,
All Games,2019,Arkansas,2,10,12,0.16666666666666666
at Home,2019,Arkansas,2,5,7,0.2857142857142857
on Road/Neutral Site,2019,Arkansas,0,5,5,0.0
vs. Conference,2019,Arkansas,0,8,8,0.0
vs. Non-Conference,2019,Arkansas,2,2,4,0.5
vs. Ranked (AP),2019,Arkansas,0,3,3,0.0
vs. Unranked (AP),2019,Arkansas,2,7,9,0.2222222222222222
vs. FBS (I-A),2019,Arkansas,1,10,11,0.09090909090909091
vs. FCS (I-AA),2019,Arkansas,1,0,1,1.0
vs. FBS Winning,2019,Arkansas,0,6,6,0.0
vs. FBS Non-Winning,2019,Arkansas,1,4,5,0.2
vs. BCS AQ,2019,Arkansas,0,8,8,0.0
vs. BCS non-AQ,2019,Arkansas,1,2,3,0.3333333333333333
vs. FBS Power 5,2019,Arkansas,0,8,8,0.0
vs. FBS non-Power 5,2019,Arkansas,1,2,3,0.3333333333333333
in August/September,2019,Arkansas,2,3,5,0.4
in October,2019,Arkansas,0,3,3,0.0
in November,2019,Arkansas,0,4,4,0.0
in December/January,2019,Arkansas,0,0,0,
All Games,2020,Arkansas,3,7,10,0.3
at Home,2020,Arkansas,2,3,5,0.4
on Road/Neutral Site,2020,Arkansas,1,4,5,0.2
vs. Conference,2020,Arkansas,3,7,10,0.3
vs. Non-Conference,2020,Arkansas,0,0,0,
vs. Ranked (AP),2020,Arkansas,0,4,4,0.0
vs. Unranked (AP),2020,Arkansas,3,3,6,0.5
vs. FBS (I-A),2020,Arkansas,3,7,10,0.3
vs. FCS (I-AA),2020,Arkansas,0,0,0,
vs. FBS Winning,2020,Arkansas,0,5,5,0.0
vs. FBS Non-Winning,2020,Arkansas,3,2,5,0.6
vs. BCS AQ,2020,Arkansas,3,7,10,0.3
vs. BCS non-AQ,2020,Arkansas,0,0,0,
vs. FBS Power 5,2020,Arkansas,3,7,10,0.3
vs. FBS non-Power 5,2020,Arkansas,0,0,0,
in August/September,2020,Arkansas,0,1,1,0.0
in October,2020,Arkansas,2,2,4,0.5
in November,2020,Arkansas,1,2,3,0.3333333333333333
in December/January,2020,Arkansas,0,2,2,0.0
All Games,2021,Arkansas,9,4,13,0.6923076923076923
at Home,2021,Arkansas,6,1,7,0.8571428571428571
on Road/Neutral Site,2021,Arkansas,3,3,6,0.5
vs. Conference,2021,Arkansas,4,4,8,0.5
vs. Non-Conference,2021,Arkansas,5,0,5,1.0
vs. Ranked (AP),2021,Arkansas,0,3,3,0.0
vs. Unranked (AP),2021,Arkansas,9,1,10,0.9
vs. FBS (I-A),2021,Arkansas,8,4,12,0.6666666666666666
vs. FCS (I-AA),2021,Arkansas,1,0,1,1.0
vs. FBS Winning,2021,Arkansas,3,3,6,0.5
vs. FBS Non-Winning,2021,Arkansas,5,1,6,0.8333333333333334
vs. BCS AQ,2021,Arkansas,6,4,10,0.6
vs. BCS non-AQ,2021,Arkansas,2,0,2,1.0
vs. FBS Power 5,2021,Arkansas,6,4,10,0.6
vs. FBS non-Power 5,2021,Arkansas,2,0,2,1.0
in August/September,2021,Arkansas,4,0,4,1.0
in October,2021,Arkansas,1,3,4,0.25
in November,2021,Arkansas,3,1,4,0.75
in December/January,2021,Arkansas,1,0,1,1.0
All Games,2022,Arkansas,7,6,13,0.5384615384615384
at Home,2022,Arkansas,4,3,7,0.5714285714285714
on Road/Neutral Site,2022,Arkansas,3,3,6,0.5
vs. Conference,2022,Arkansas,3,5,8,0.375
vs. Non-Conference,2022,Arkansas,4,1,5,0.8
vs. Ranked (AP),2022,Arkansas,1,3,4,0.25
vs. Unranked (AP),2022,Arkansas,6,3,9,0.6666666666666666
vs. FBS (I-A),2022,Arkansas,6,6,12,0.5
vs. FCS (I-AA),2022,Arkansas,1,0,1,1.0
vs. FBS Winning,2022,Arkansas,4,4,8,0.5
vs. FBS Non-Winning,2022,Arkansas,2,2,4,0.5
vs. BCS AQ,2022,Arkansas,5,5,10,0.5
vs. BCS non-AQ,2022,Arkansas,1,1,2,0.5
vs. FBS Power 5,2022,Arkansas,4,5,9,0.4444444444444444
vs. FBS non-Power 5,2022,Arkansas,2,1,3,0.6666666666666666
in August/September,2022,Arkansas,3,1,4,0.75
in October,2022,Arkansas,2,2,4,0.5
in November,2022,Arkansas,1,3,4,0.25
in December/January,2022,Arkansas,1,0,1,1.0
All Games,2009,Arkansas State,4,8,12,0.3333333333333333
at Home,2009,Arkansas State,3,2,5,0.6
on Road/Neutral Site,2009,Arkansas State,1,6,7,0.14285714285714285
vs. Conference,2009,Arkansas State,3,5,8,0.375
vs. Non-Conference,2009,Arkansas State,1,3,4,0.25
vs. Ranked (AP),2009,Arkansas State,0,2,2,0.0
vs. Unranked (AP),2009,Arkansas State,4,6,10,0.4
vs. FBS (I-A),2009,Arkansas State,3,8,11,0.2727272727272727
vs. FCS (I-AA),2009,Arkansas State,1,0,1,1.0
vs. FBS Winning,2009,Arkansas State,0,4,4,0.0
vs. FBS Non-Winning,2009,Arkansas State,3,4,7,0.42857142857142855
vs. BCS AQ,2009,Arkansas State,0,3,3,0.0
vs. BCS non-AQ,2009,Arkansas State,3,5,8,0.375
vs. FBS Power 5,2009,Arkansas State,0,2,2,0.0
vs. FBS non-Power 5,2009,Arkansas State,3,6,9,0.3333333333333333
in August/September,2009,Arkansas State,1,2,3,0.3333333333333333
in October,2009,Arkansas State,1,3,4,0.25
in November,2009,Arkansas State,1,3,4,0.25
in December/January,2009,Arkansas State,1,0,1,1.0
All Games,2010,Arkansas State,4,8,12,0.3333333333333333
at Home,2010,Arkansas State,3,2,5,0.6
on Road/Neutral Site,2010,Arkansas State,1,6,7,0.14285714285714285
vs. Conference,2010,Arkansas State,4,4,8,0.5
vs. Non-Conference,2010,Arkansas State,0,4,4,0.0
vs. Ranked (AP),2010,Arkansas State,0,1,1,0.0
vs. Unranked (AP),2010,Arkansas State,4,7,11,0.36363636363636365
vs. FBS (I-A),2010,Arkansas State,4,8,12,0.3333333333333333
vs. FCS (I-AA),2010,Arkansas State,0,0,0,
vs. FBS Winning,2010,Arkansas State,0,5,5,0.0
vs. FBS Non-Winning,2010,Arkansas State,4,3,7,0.5714285714285714
vs. BCS AQ,2010,Arkansas State,0,3,3,0.0
vs. BCS non-AQ,2010,Arkansas State,4,5,9,0.4444444444444444
vs. FBS Power 5,2010,Arkansas State,0,2,2,0.0
vs. FBS non-Power 5,2010,Arkansas State,4,6,10,0.4
in August/September,2010,Arkansas State,1,3,4,0.25
in October,2010,Arkansas State,2,2,4,0.5
in November,2010,Arkansas State,1,3,4,0.25
in December/January,2010,Arkansas State,0,0,0,
All Games,2011,Arkansas State,10,3,13,0.7692307692307693
at Home,2011,Arkansas State,6,0,6,1.0
on Road/Neutral Site,2011,Arkansas State,4,3,7,0.5714285714285714
vs. Conference,2011,Arkansas State,8,0,8,1.0
vs. Non-Conference,2011,Arkansas State,2,3,5,0.4
vs. Ranked (AP),2011,Arkansas State,0,1,1,0.0
vs. Unranked (AP),2011,Arkansas State,10,2,12,0.8333333333333334
vs. FBS (I-A),2011,Arkansas State,9,3,12,0.75
vs. FCS (I-AA),2011,Arkansas State,1,0,1,1.0
vs. FBS Winning,2011,Arkansas State,3,3,6,0.5
vs. FBS Non-Winning,2011,Arkansas State,6,0,6,1.0
vs. BCS AQ,2011,Arkansas State,0,2,2,0.0
vs. BCS non-AQ,2011,Arkansas State,9,1,10,0.9
vs. FBS Power 5,2011,Arkansas State,0,2,2,0.0
vs. FBS non-Power 5,2011,Arkansas State,9,1,10,0.9
in August/September,2011,Arkansas State,2,2,4,0.5
in October,2011,Arkansas State,4,0,4,1.0
in November,2011,Arkansas State,3,0,3,1.0
in December/January,2011,Arkansas State,1,1,2,0.5
All Games,2012,Arkansas State,10,3,13,0.7692307692307693
at Home,2012,Arkansas State,5,1,6,0.8333333333333334
on Road/Neutral Site,2012,Arkansas State,5,2,7,0.7142857142857143
vs. Conference,2012,Arkansas State,7,1,8,0.875
vs. Non-Conference,2012,Arkansas State,3,2,5,0.6
vs. Ranked (AP),2012,Arkansas State,0,2,2,0.0
vs. Unranked (AP),2012,Arkansas State,10,1,11,0.9090909090909091
vs. FBS (I-A),2012,Arkansas State,9,3,12,0.75
vs. FCS (I-AA),2012,Arkansas State,1,0,1,1.0
vs. FBS Winning,2012,Arkansas State,4,3,7,0.5714285714285714
vs. FBS Non-Winning,2012,Arkansas State,5,0,5,1.0
vs. BCS AQ,2012,Arkansas State,0,2,2,0.0
vs. BCS non-AQ,2012,Arkansas State,9,1,10,0.9
vs. FBS Power 5,2012,Arkansas State,0,2,2,0.0
vs. FBS non-Power 5,2012,Arkansas State,9,1,10,0.9
in August/September,2012,Arkansas State,2,3,5,0.4
in October,2012,Arkansas State,3,0,3,1.0
in November,2012,Arkansas State,3,0,3,1.0
in December/January,2012,Arkansas State,2,0,2,1.0
All Games,2013,Arkansas State,8,5,13,0.6153846153846154
at Home,2013,Arkansas State,5,1,6,0.8333333333333334
on Road/Neutral Site,2013,Arkansas State,3,4,7,0.42857142857142855
vs. Conference,2013,Arkansas State,5,2,7,0.7142857142857143
vs. Non-Conference,2013,Arkansas State,3,3,6,0.5
vs. Ranked (AP),2013,Arkansas State,0,2,2,0.0
vs. Unranked (AP),2013,Arkansas State,8,3,11,0.7272727272727273
vs. FBS (I-A),2013,Arkansas State,7,5,12,0.5833333333333334
vs. FCS (I-AA),2013,Arkansas State,1,0,1,1.0
vs. FBS Winning,2013,Arkansas State,1,4,5,0.2
vs. FBS Non-Winning,2013,Arkansas State,6,1,7,0.8571428571428571
vs. BCS AQ,2013,Arkansas State,0,3,3,0.0
vs. BCS non-AQ,2013,Arkansas State,7,2,9,0.7777777777777778
vs. FBS Power 5,2013,Arkansas State,0,2,2,0.0
vs. FBS non-Power 5,2013,Arkansas State,7,3,10,0.7
in August/September,2013,Arkansas State,2,3,5,0.4
in October,2013,Arkansas State,1,1,2,0.5
in November,2013,Arkansas State,4,1,5,0.8
in December/January,2013,Arkansas State,1,0,1,1.0
All Games,2014,Arkansas State,7,6,13,0.5384615384615384
at Home,2014,Arkansas State,5,1,6,0.8333333333333334
on Road/Neutral Site,2014,Arkansas State,2,5,7,0.2857142857142857
vs. Conference,2014,Arkansas State,5,3,8,0.625
vs. Non-Conference,2014,Arkansas State,2,3,5,0.4
vs. Ranked (AP),2014,Arkansas State,0,0,0,
vs. Unranked (AP),2014,Arkansas State,7,6,13,0.5384615384615384
vs. FBS (I-A),2014,Arkansas State,6,6,12,0.5
vs. FCS (I-AA),2014,Arkansas State,1,0,1,1.0
vs. FBS Winning,2014,Arkansas State,1,5,6,0.16666666666666666
vs. FBS Non-Winning,2014,Arkansas State,5,1,6,0.8333333333333334
vs. BCS AQ,2014,Arkansas State,0,2,2,0.0
vs. BCS non-AQ,2014,Arkansas State,6,4,10,0.6
vs. FBS Power 5,2014,Arkansas State,0,2,2,0.0
vs. FBS non-Power 5,2014,Arkansas State,6,4,10,0.6
in August/September,2014,Arkansas State,2,2,4,0.5
in October,2014,Arkansas State,2,1,3,0.6666666666666666
in November,2014,Arkansas State,3,2,5,0.6
in December/January,2014,Arkansas State,0,1,1,0.0
All Games,2015,Arkansas State,9,4,13,0.6923076923076923
at Home,2015,Arkansas State,5,1,6,0.8333333333333334
on Road/Neutral Site,2015,Arkansas State,4,3,7,0.5714285714285714
vs. Conference,2015,Arkansas State,8,0,8,1.0
vs. Non-Conference,2015,Arkansas State,1,4,5,0.2
vs. Ranked (AP),2015,Arkansas State,0,0,0,
vs. Unranked (AP),2015,Arkansas State,9,4,13,0.6923076923076923
vs. FBS (I-A),2015,Arkansas State,8,4,12,0.6666666666666666
vs. FCS (I-AA),2015,Arkansas State,1,0,1,1.0
vs. FBS Winning,2015,Arkansas State,1,3,4,0.25
vs. FBS Non-Winning,2015,Arkansas State,7,1,8,0.875
vs. BCS AQ,2015,Arkansas State,0,2,2,0.0
vs. BCS non-AQ,2015,Arkansas State,8,2,10,0.8
vs. FBS Power 5,2015,Arkansas State,0,2,2,0.0
vs. FBS non-Power 5,2015,Arkansas State,8,2,10,0.8
in August/September,2015,Arkansas State,1,3,4,0.25
in October,2015,Arkansas State,4,0,4,1.0
in November,2015,Arkansas State,3,0,3,1.0
in December/January,2015,Arkansas State,1,1,2,0.5
All Games,2016,Arkansas State,8,5,13,0.6153846153846154
at Home,2016,Arkansas State,4,2,6,0.6666666666666666
on Road/Neutral Site,2016,Arkansas State,4,3,7,0.5714285714285714
vs. Conference,2016,Arkansas State,7,1,8,0.875
vs. Non-Conference,2016,Arkansas State,1,4,5,0.2
vs. Ranked (AP),2016,Arkansas State,0,1,1,0.0
vs. Unranked (AP),2016,Arkansas State,8,4,12,0.6666666666666666
vs. FBS (I-A),2016,Arkansas State,8,4,12,0.6666666666666666
vs. FCS (I-AA),2016,Arkansas State,0,1,1,0.0
vs. FBS Winning,2016,Arkansas State,1,2,3,0.3333333333333333
vs. FBS Non-Winning,2016,Arkansas State,7,2,9,0.7777777777777778
vs. BCS AQ,2016,Arkansas State,1,1,2,0.5
vs. BCS non-AQ,2016,Arkansas State,7,3,10,0.7
vs. FBS Power 5,2016,Arkansas State,0,1,1,0.0
vs. FBS non-Power 5,2016,Arkansas State,8,3,11,0.7272727272727273
in August/September,2016,Arkansas State,0,4,4,0.0
in October,2016,Arkansas State,3,0,3,1.0
in November,2016,Arkansas State,3,1,4,0.75
in December/January,2016,Arkansas State,2,0,2,1.0
All Games,2017,Arkansas State,7,5,12,0.5833333333333334
at Home,2017,Arkansas State,4,1,5,0.8
on Road/Neutral Site,2017,Arkansas State,3,4,7,0.42857142857142855
vs. Conference,2017,Arkansas State,6,2,8,0.75
vs. Non-Conference,2017,Arkansas State,1,3,4,0.25
vs. Ranked (AP),2017,Arkansas State,0,0,0,
vs. Unranked (AP),2017,Arkansas State,7,5,12,0.5833333333333334
vs. FBS (I-A),2017,Arkansas State,6,5,11,0.5454545454545454
vs. FCS (I-AA),2017,Arkansas State,1,0,1,1.0
vs. FBS Winning,2017,Arkansas State,1,3,4,0.25
vs. FBS Non-Winning,2017,Arkansas State,5,2,7,0.7142857142857143
vs. BCS AQ,2017,Arkansas State,0,2,2,0.0
vs. BCS non-AQ,2017,Arkansas State,6,3,9,0.6666666666666666
vs. FBS Power 5,2017,Arkansas State,0,1,1,0.0
vs. FBS non-Power 5,2017,Arkansas State,6,4,10,0.6
in August/September,2017,Arkansas State,1,2,3,0.3333333333333333
in October,2017,Arkansas State,4,0,4,1.0
in November,2017,Arkansas State,2,1,3,0.6666666666666666
in December/January,2017,Arkansas State,0,2,2,0.0
All Games,2018,Arkansas State,8,5,13,0.6153846153846154
at Home,2018,Arkansas State,5,1,6,0.8333333333333334
on Road/Neutral Site,2018,Arkansas State,3,4,7,0.42857142857142855
vs. Conference,2018,Arkansas State,5,3,8,0.625
vs. Non-Conference,2018,Arkansas State,3,2,5,0.6
vs. Ranked (AP),2018,Arkansas State,0,1,1,0.0
vs. Unranked (AP),2018,Arkansas State,8,4,12,0.6666666666666666
vs. FBS (I-A),2018,Arkansas State,7,5,12,0.5833333333333334
vs. FCS (I-AA),2018,Arkansas State,1,0,1,1.0
vs. FBS Winning,2018,Arkansas State,0,4,4,0.0
vs. FBS Non-Winning,2018,Arkansas State,7,1,8,0.875
vs. BCS AQ,2018,Arkansas State,1,1,2,0.5
vs. BCS non-AQ,2018,Arkansas State,6,4,10,0.6
vs. FBS Power 5,2018,Arkansas State,0,1,1,0.0
vs. FBS non-Power 5,2018,Arkansas State,7,4,11,0.6363636363636364
in August/September,2018,Arkansas State,3,2,5,0.6
in October,2018,Arkansas State,1,2,3,0.3333333333333333
in November,2018,Arkansas State,4,0,4,1.0
in December/January,2018,Arkansas State,0,1,1,0.0
All Games,2019,Arkansas State,8,5,13,0.6153846153846154
at Home,2019,Arkansas State,4,2,6,0.6666666666666666
on Road/Neutral Site,2019,Arkansas State,4,3,7,0.5714285714285714
vs. Conference,2019,Arkansas State,5,3,8,0.625
vs. Non-Conference,2019,Arkansas State,3,2,5,0.6
vs. Ranked (AP),2019,Arkansas State,0,1,1,0.0
vs. Unranked (AP),2019,Arkansas State,8,4,12,0.6666666666666666
vs. FBS (I-A),2019,Arkansas State,7,5,12,0.5833333333333334
vs. FCS (I-AA),2019,Arkansas State,1,0,1,1.0
vs. FBS Winning,2019,Arkansas State,1,4,5,0.2
vs. FBS Non-Winning,2019,Arkansas State,6,1,7,0.8571428571428571
vs. BCS AQ,2019,Arkansas State,0,2,2,0.0
vs. BCS non-AQ,2019,Arkansas State,7,3,10,0.7
vs. FBS Power 5,2019,Arkansas State,0,1,1,0.0
vs. FBS non-Power 5,2019,Arkansas State,7,4,11,0.6363636363636364
in August/September,2019,Arkansas State,3,2,5,0.6
in October,2019,Arkansas State,1,2,3,0.3333333333333333
in November,2019,Arkansas State,3,1,4,0.75
in December/January,2019,Arkansas State,1,0,1,1.0
All Games,2020,Arkansas State,4,7,11,0.36363636363636365
at Home,2020,Arkansas State,3,2,5,0.6
on Road/Neutral Site,2020,Arkansas State,1,5,6,0.16666666666666666
vs. Conference,2020,Arkansas State,2,6,8,0.25
vs. Non-Conference,2020,Arkansas State,2,1,3,0.6666666666666666
vs. Ranked (AP),2020,Arkansas State,0,2,2,0.0
vs. Unranked (AP),2020,Arkansas State,4,5,9,0.4444444444444444
vs. FBS (I-A),2020,Arkansas State,3,7,10,0.3
vs. FCS (I-AA),2020,Arkansas State,1,0,1,1.0
vs. FBS Winning,2020,Arkansas State,1,4,5,0.2
vs. FBS Non-Winning,2020,Arkansas State,2,3,5,0.4
vs. BCS AQ,2020,Arkansas State,1,1,2,0.5
vs. BCS non-AQ,2020,Arkansas State,2,6,8,0.25
vs. FBS Power 5,2020,Arkansas State,1,0,1,1.0
vs. FBS non-Power 5,2020,Arkansas State,2,7,9,0.2222222222222222
in August/September,2020,Arkansas State,1,1,2,0.5
in October,2020,Arkansas State,2,3,5,0.4
in November,2020,Arkansas State,0,3,3,0.0
in December/January,2020,Arkansas State,1,0,1,1.0
All Games,2021,Arkansas State,2,10,12,0.16666666666666666
at Home,2021,Arkansas State,1,5,6,0.16666666666666666
on Road/Neutral Site,2021,Arkansas State,1,5,6,0.16666666666666666
vs. Conference,2021,Arkansas State,1,7,8,0.125
vs. Non-Conference,2021,Arkansas State,1,3,4,0.25
vs. Ranked (AP),2021,Arkansas State,0,1,1,0.0
vs. Unranked (AP),2021,Arkansas State,2,9,11,0.18181818181818182
vs. FBS (I-A),2021,Arkansas State,1,10,11,0.09090909090909091
vs. FCS (I-AA),2021,Arkansas State,1,0,1,1.0
vs. FBS Winning,2021,Arkansas State,0,5,5,0.0
vs. FBS Non-Winning,2021,Arkansas State,1,5,6,0.16666666666666666
vs. BCS AQ,2021,Arkansas State,0,3,3,0.0
vs. BCS non-AQ,2021,Arkansas State,1,7,8,0.125
vs. FBS Power 5,2021,Arkansas State,0,1,1,0.0
vs. FBS non-Power 5,2021,Arkansas State,1,9,10,0.1
in August/September,2021,Arkansas State,1,3,4,0.25
in October,2021,Arkansas State,0,4,4,0.0
in November,2021,Arkansas State,1,3,4,0.25
in December/January,2021,Arkansas State,0,0,0,
All Games,2022,Arkansas State,3,9,12,0.25
at Home,2022,Arkansas State,3,3,6,0.5
on Road/Neutral Site,2022,Arkansas State,0,6,6,0.0
vs. Conference,2022,Arkansas State,1,7,8,0.125
vs. Non-Conference,2022,Arkansas State,2,2,4,0.5
vs. Ranked (AP),2022,Arkansas State,0,2,2,0.0
vs. Unranked (AP),2022,Arkansas State,3,7,10,0.3
vs. FBS (I-A),2022,Arkansas State,2,9,11,0.18181818181818182
vs. FCS (I-AA),2022,Arkansas State,1,0,1,1.0
vs. FBS Winning,2022,Arkansas State,0,6,6,0.0
vs. FBS Non-Winning,2022,Arkansas State,2,3,5,0.4
vs. BCS AQ,2022,Arkansas State,0,2,2,0.0
vs. BCS non-AQ,2022,Arkansas State,2,7,9,0.2222222222222222
vs. FBS Power 5,2022,Arkansas State,0,1,1,0.0
vs. FBS non-Power 5,2022,Arkansas State,2,8,10,0.2
in August/September,2022,Arkansas State,1,3,4,0.25
in October,2022,Arkansas State,1,4,5,0.2
in November,2022,Arkansas State,1,2,3,0.3333333333333333
in December/January,2022,Arkansas State,0,0,0,
All Games,2009,Army,5,7,12,0.4166666666666667
at Home,2009,Army,3,3,6,0.5
on Road/Neutral Site,2009,Army,2,4,6,0.3333333333333333
vs. Conference,2009,Army,0,1,1,0.0
vs. Non-Conference,2009,Army,5,6,11,0.45454545454545453
vs. Ranked (AP),2009,Army,0,0,0,
vs. Unranked (AP),2009,Army,5,7,12,0.4166666666666667
vs. FBS (I-A),2009,Army,4,7,11,0.36363636363636365
vs. FCS (I-AA),2009,Army,1,0,1,1.0
vs. FBS Winning,2009,Army,0,5,5,0.0
vs. FBS Non-Winning,2009,Army,4,2,6,0.6666666666666666
vs. BCS AQ,2009,Army,1,3,4,0.25
vs. BCS non-AQ,2009,Army,3,4,7,0.42857142857142855
vs. FBS Power 5,2009,Army,1,2,3,0.3333333333333333
vs. FBS non-Power 5,2009,Army,3,5,8,0.375
in August/September,2009,Army,2,2,4,0.5
in October,2009,Army,1,3,4,0.25
in November,2009,Army,2,1,3,0.6666666666666666
in December/January,2009,Army,0,1,1,0.0
All Games,2010,Army,7,6,13,0.5384615384615384
at Home,2010,Army,2,3,5,0.4
on Road/Neutral Site,2010,Army,5,3,8,0.625
vs. Conference,2010,Army,0,2,2,0.0
vs. Non-Conference,2010,Army,7,4,11,0.6363636363636364
vs. Ranked (AP),2010,Army,0,0,0,
vs. Unranked (AP),2010,Army,7,6,13,0.5384615384615384
vs. FBS (I-A),2010,Army,6,6,12,0.5
vs. FCS (I-AA),2010,Army,1,0,1,1.0
vs. FBS Winning,2010,Army,0,5,5,0.0
vs. FBS Non-Winning,2010,Army,6,1,7,0.8571428571428571
vs. BCS AQ,2010,Army,1,2,3,0.3333333333333333
vs. BCS non-AQ,2010,Army,5,4,9,0.5555555555555556
vs. FBS Power 5,2010,Army,1,0,1,1.0
vs. FBS non-Power 5,2010,Army,5,6,11,0.45454545454545453
in August/September,2010,Army,3,1,4,0.75
in October,2010,Army,2,2,4,0.5
in November,2010,Army,1,2,3,0.3333333333333333
in December/January,2010,Army,1,1,2,0.5
All Games,2011,Army,3,9,12,0.25
at Home,2011,Army,3,1,4,0.75
on Road/Neutral Site,2011,Army,0,8,8,0.0
vs. Conference,2011,Army,0,1,1,0.0
vs. Non-Conference,2011,Army,3,8,11,0.2727272727272727
vs. Ranked (AP),2011,Army,0,0,0,
vs. Unranked (AP),2011,Army,3,9,12,0.25
vs. FBS (I-A),2011,Army,2,9,11,0.18181818181818182
vs. FCS (I-AA),2011,Army,1,0,1,1.0
vs. FBS Winning,2011,Army,0,5,5,0.0
vs. FBS Non-Winning,2011,Army,2,4,6,0.3333333333333333
vs. BCS AQ,2011,Army,1,2,3,0.3333333333333333
vs. BCS non-AQ,2011,Army,1,7,8,0.125
vs. FBS Power 5,2011,Army,1,1,2,0.5
vs. FBS non-Power 5,2011,Army,1,8,9,0.1111111111111111
in August/September,2011,Army,1,3,4,0.25
in October,2011,Army,2,2,4,0.5
in November,2011,Army,0,3,3,0.0
in December/January,2011,Army,0,1,1,0.0
All Games,2012,Army,2,10,12,0.16666666666666666
at Home,2012,Army,2,5,7,0.2857142857142857
on Road/Neutral Site,2012,Army,0,5,5,0.0
vs. Conference,2012,Army,0,1,1,0.0
vs. Non-Conference,2012,Army,2,9,11,0.18181818181818182
vs. Ranked (AP),2012,Army,0,1,1,0.0
vs. Unranked (AP),2012,Army,2,9,11,0.18181818181818182
vs. FBS (I-A),2012,Army,2,9,11,0.18181818181818182
vs. FCS (I-AA),2012,Army,0,1,1,0.0
vs. FBS Winning,2012,Army,0,6,6,0.0
vs. FBS Non-Winning,2012,Army,2,3,5,0.4
vs. BCS AQ,2012,Army,1,3,4,0.25
vs. BCS non-AQ,2012,Army,1,6,7,0.14285714285714285
vs. FBS Power 5,2012,Army,1,1,2,0.5
vs. FBS non-Power 5,2012,Army,1,8,9,0.1111111111111111
in August/September,2012,Army,0,4,4,0.0
in October,2012,Army,1,3,4,0.25
in November,2012,Army,1,2,3,0.3333333333333333
in December/January,2012,Army,0,1,1,0.0
All Games,2013,Army,3,9,12,0.25
at Home,2013,Army,2,3,5,0.4
on Road/Neutral Site,2013,Army,1,6,7,0.14285714285714285
vs. Conference,2013,Army,0,1,1,0.0
vs. Non-Conference,2013,Army,3,8,11,0.2727272727272727
vs. Ranked (AP),2013,Army,0,1,1,0.0
vs. Unranked (AP),2013,Army,3,8,11,0.2727272727272727
vs. FBS (I-A),2013,Army,2,9,11,0.18181818181818182
vs. FCS (I-AA),2013,Army,1,0,1,1.0
vs. FBS Winning,2013,Army,0,5,5,0.0
vs. FBS Non-Winning,2013,Army,2,4,6,0.3333333333333333
vs. BCS AQ,2013,Army,0,4,4,0.0
vs. BCS non-AQ,2013,Army,2,5,7,0.2857142857142857
vs. FBS Power 5,2013,Army,0,3,3,0.0
vs. FBS non-Power 5,2013,Army,2,6,8,0.25
in August/September,2013,Army,2,3,5,0.4
in October,2013,Army,1,2,3,0.3333333333333333
in November,2013,Army,0,3,3,0.0
in December/January,2013,Army,0,1,1,0.0
All Games,2014,Army,4,8,12,0.3333333333333333
at Home,2014,Army,3,2,5,0.6
on Road/Neutral Site,2014,Army,1,6,7,0.14285714285714285
vs. Conference,2014,Army,0,1,1,0.0
vs. Non-Conference,2014,Army,4,7,11,0.36363636363636365
vs. Ranked (AP),2014,Army,0,0,0,
vs. Unranked (AP),2014,Army,4,8,12,0.3333333333333333
vs. FBS (I-A),2014,Army,3,7,10,0.3
vs. FCS (I-AA),2014,Army,1,1,2,0.5
vs. FBS Winning,2014,Army,0,5,5,0.0
vs. FBS Non-Winning,2014,Army,3,2,5,0.6
vs. BCS AQ,2014,Army,1,2,3,0.3333333333333333
vs. BCS non-AQ,2014,Army,2,5,7,0.2857142857142857
vs. FBS Power 5,2014,Army,0,2,2,0.0
vs. FBS non-Power 5,2014,Army,3,5,8,0.375
in August/September,2014,Army,1,3,4,0.25
in October,2014,Army,1,2,3,0.3333333333333333
in November,2014,Army,2,2,4,0.5
in December/January,2014,Army,0,1,1,0.0
All Games,2015,Army,2,10,12,0.16666666666666666
at Home,2015,Army,1,5,6,0.16666666666666666
on Road/Neutral Site,2015,Army,1,5,6,0.16666666666666666
vs. Conference,2015,Army,0,0,0,
vs. Non-Conference,2015,Army,2,10,12,0.16666666666666666
vs. Ranked (AP),2015,Army,0,1,1,0.0
vs. Unranked (AP),2015,Army,2,9,11,0.18181818181818182
vs. FBS (I-A),2015,Army,1,9,10,0.1
vs. FCS (I-AA),2015,Army,1,1,2,0.5
vs. FBS Winning,2015,Army,0,4,4,0.0
vs. FBS Non-Winning,2015,Army,1,5,6,0.16666666666666666
vs. BCS AQ,2015,Army,0,7,7,0.0
vs. BCS non-AQ,2015,Army,1,2,3,0.3333333333333333
vs. FBS Power 5,2015,Army,0,4,4,0.0
vs. FBS non-Power 5,2015,Army,1,5,6,0.16666666666666666
in August/September,2015,Army,1,3,4,0.25
in October,2015,Army,1,3,4,0.25
in November,2015,Army,0,3,3,0.0
in December/January,2015,Army,0,1,1,0.0
All Games,2016,Army,8,5,13,0.6153846153846154
at Home,2016,Army,3,2,5,0.6
on Road/Neutral Site,2016,Army,5,3,8,0.625
vs. Conference,2016,Army,0,1,1,0.0
vs. Non-Conference,2016,Army,8,4,12,0.6666666666666666
vs. Ranked (AP),2016,Army,1,0,1,1.0
vs. Unranked (AP),2016,Army,7,5,12,0.5833333333333334
vs. FBS (I-A),2016,Army,6,5,11,0.5454545454545454
vs. FCS (I-AA),2016,Army,2,0,2,1.0
vs. FBS Winning,2016,Army,3,1,4,0.75
vs. FBS Non-Winning,2016,Army,3,4,7,0.42857142857142855
vs. BCS AQ,2016,Army,3,2,5,0.6
vs. BCS non-AQ,2016,Army,3,3,6,0.5
vs. FBS Power 5,2016,Army,1,1,2,0.5
vs. FBS non-Power 5,2016,Army,5,4,9,0.5555555555555556
in August/September,2016,Army,3,1,4,0.75
in October,2016,Army,2,2,4,0.5
in November,2016,Army,1,2,3,0.3333333333333333
in December/January,2016,Army,2,0,2,1.0
All Games,2017,Army,10,3,13,0.7692307692307693
at Home,2017,Army,6,0,6,1.0
on Road/Neutral Site,2017,Army,4,3,7,0.5714285714285714
vs. Conference,2017,Army,0,0,0,
vs. Non-Conference,2017,Army,10,3,13,0.7692307692307693
vs. Ranked (AP),2017,Army,0,1,1,0.0
vs. Unranked (AP),2017,Army,10,2,12,0.8333333333333334
vs. FBS (I-A),2017,Army,9,3,12,0.75
vs. FCS (I-AA),2017,Army,1,0,1,1.0
vs. FBS Winning,2017,Army,4,2,6,0.6666666666666666
vs. FBS Non-Winning,2017,Army,5,1,6,0.8333333333333334
vs. BCS AQ,2017,Army,3,2,5,0.6
vs. BCS non-AQ,2017,Army,6,1,7,0.8571428571428571
vs. FBS Power 5,2017,Army,1,1,2,0.5
vs. FBS non-Power 5,2017,Army,8,2,10,0.8
in August/September,2017,Army,3,2,5,0.6
in October,2017,Army,3,0,3,1.0
in November,2017,Army,2,1,3,0.6666666666666666
in December/January,2017,Army,2,0,2,1.0
All Games,2018,Army,11,2,13,0.8461538461538461
at Home,2018,Army,6,0,6,1.0
on Road/Neutral Site,2018,Army,5,2,7,0.7142857142857143
vs. Conference,2018,Army,1,0,1,1.0
vs. Non-Conference,2018,Army,10,2,12,0.8333333333333334
vs. Ranked (AP),2018,Army,0,1,1,0.0
vs. Unranked (AP),2018,Army,11,1,12,0.9166666666666666
vs. FBS (I-A),2018,Army,9,2,11,0.8181818181818182
vs. FCS (I-AA),2018,Army,2,0,2,1.0
vs. FBS Winning,2018,Army,4,2,6,0.6666666666666666
vs. FBS Non-Winning,2018,Army,5,0,5,1.0
vs. BCS AQ,2018,Army,2,2,4,0.5
vs. BCS non-AQ,2018,Army,7,0,7,1.0
vs. FBS Power 5,2018,Army,0,2,2,0.0
vs. FBS non-Power 5,2018,Army,9,0,9,1.0
in August/September,2018,Army,3,2,5,0.6
in October,2018,Army,3,0,3,1.0
in November,2018,Army,3,0,3,1.0
in December/January,2018,Army,2,0,2,1.0
All Games,2019,Army,5,8,13,0.38461538461538464
at Home,2019,Army,4,2,6,0.6666666666666666
on Road/Neutral Site,2019,Army,1,6,7,0.14285714285714285
vs. Conference,2019,Army,1,0,1,1.0
vs. Non-Conference,2019,Army,4,8,12,0.3333333333333333
vs. Ranked (AP),2019,Army,0,3,3,0.0
vs. Unranked (AP),2019,Army,5,5,10,0.5
vs. FBS (I-A),2019,Army,3,8,11,0.2727272727272727
vs. FCS (I-AA),2019,Army,2,0,2,1.0
vs. FBS Winning,2019,Army,0,7,7,0.0
vs. FBS Non-Winning,2019,Army,3,1,4,0.75
vs. BCS AQ,2019,Army,0,3,3,0.0
vs. BCS non-AQ,2019,Army,3,5,8,0.375
vs. FBS Power 5,2019,Army,0,1,1,0.0
vs. FBS non-Power 5,2019,Army,3,7,10,0.3
in August/September,2019,Army,3,1,4,0.75
in October,2019,Army,0,4,4,0.0
in November,2019,Army,2,2,4,0.5
in December/January,2019,Army,0,1,1,0.0
All Games,2020,Army,9,3,12,0.75
at Home,2020,Army,8,0,8,1.0
on Road/Neutral Site,2020,Army,1,3,4,0.25
vs. Conference,2020,Army,0,0,0,
vs. Non-Conference,2020,Army,9,3,12,0.75
vs. Ranked (AP),2020,Army,0,1,1,0.0
vs. Unranked (AP),2020,Army,9,2,11,0.8181818181818182
vs. FBS (I-A),2020,Army,6,3,9,0.6666666666666666
vs. FCS (I-AA),2020,Army,3,0,3,1.0
vs. FBS Winning,2020,Army,2,2,4,0.5
vs. FBS Non-Winning,2020,Army,4,1,5,0.8
vs. BCS AQ,2020,Army,1,3,4,0.25
vs. BCS non-AQ,2020,Army,5,0,5,1.0
vs. FBS Power 5,2020,Army,0,1,1,0.0
vs. FBS non-Power 5,2020,Army,6,2,8,0.75
in August/September,2020,Army,2,1,3,0.6666666666666666
in October,2020,Army,4,0,4,1.0
in November,2020,Army,1,1,2,0.5
in December/January,2020,Army,2,1,3,0.6666666666666666
All Games,2021,Army,9,4,13,0.6923076923076923
at Home,2021,Army,5,1,6,0.8333333333333334
on Road/Neutral Site,2021,Army,4,3,7,0.5714285714285714
vs. Conference,2021,Army,3,0,3,1.0
vs. Non-Conference,2021,Army,6,4,10,0.6
vs. Ranked (AP),2021,Army,0,1,1,0.0
vs. Unranked (AP),2021,Army,9,3,12,0.75
vs. FBS (I-A),2021,Army,8,4,12,0.6666666666666666
vs. FCS (I-AA),2021,Army,1,0,1,1.0
vs. FBS Winning,2021,Army,5,2,7,0.7142857142857143
vs. FBS Non-Winning,2021,Army,3,2,5,0.6
vs. BCS AQ,2021,Army,1,3,4,0.25
vs. BCS non-AQ,2021,Army,7,1,8,0.875
vs. FBS Power 5,2021,Army,1,2,3,0.3333333333333333
vs. FBS non-Power 5,2021,Army,7,2,9,0.7777777777777778
in August/September,2021,Army,4,0,4,1.0
in October,2021,Army,0,3,3,0.0
in November,2021,Army,4,0,4,1.0
in December/January,2021,Army,1,1,2,0.5
All Games,2022,Army,6,6,12,0.5
at Home,2022,Army,4,2,6,0.6666666666666666
on Road/Neutral Site,2022,Army,2,4,6,0.3333333333333333
vs. Conference,2022,Army,2,0,2,1.0
vs. Non-Conference,2022,Army,4,6,10,0.4
vs. Ranked (AP),2022,Army,0,1,1,0.0
vs. Unranked (AP),2022,Army,6,5,11,0.5454545454545454
vs. FBS (I-A),2022,Army,4,6,10,0.4
vs. FCS (I-AA),2022,Army,2,0,2,1.0
vs. FBS Winning,2022,Army,0,5,5,0.0
vs. FBS Non-Winning,2022,Army,4,1,5,0.8
vs. BCS AQ,2022,Army,1,1,2,0.5
vs. BCS non-AQ,2022,Army,3,5,8,0.375
vs. FBS Power 5,2022,Army,0,1,1,0.0
vs. FBS non-Power 5,2022,Army,4,5,9,0.4444444444444444
in August/September,2022,Army,1,2,3,0.3333333333333333
in October,2022,Army,2,2,4,0.5
in November,2022,Army,2,2,4,0.5
in December/January,2022,Army,1,0,1,1.0
All Games,2009,Auburn,8,5,13,0.6153846153846154
at Home,2009,Auburn,6,2,8,0.75
on Road/Neutral Site,2009,Auburn,2,3,5,0.4
vs. Conference,2009,Auburn,3,5,8,0.375
vs. Non-Conference,2009,Auburn,5,0,5,1.0
vs. Ranked (AP),2009,Auburn,2,2,4,0.5
vs. Unranked (AP),2009,Auburn,6,3,9,0.6666666666666666
vs. FBS (I-A),2009,Auburn,7,5,12,0.5833333333333334
vs. FCS (I-AA),2009,Auburn,1,0,1,1.0
vs. FBS Winning,2009,Auburn,4,5,9,0.4444444444444444
vs. FBS Non-Winning,2009,Auburn,3,0,3,1.0
vs. BCS AQ,2009,Auburn,5,5,10,0.5
vs. BCS non-AQ,2009,Auburn,2,0,2,1.0
vs. FBS Power 5,2009,Auburn,4,5,9,0.4444444444444444
vs. FBS non-Power 5,2009,Auburn,3,0,3,1.0
in August/September,2009,Auburn,4,0,4,1.0
in October,2009,Auburn,2,3,5,0.4
in November,2009,Auburn,1,2,3,0.3333333333333333
in December/January,2009,Auburn,1,0,1,1.0
All Games,2010,Auburn,14,0,14,1.0
at Home,2010,Auburn,8,0,8,1.0
on Road/Neutral Site,2010,Auburn,6,0,6,1.0
vs. Conference,2010,Auburn,9,0,9,1.0
vs. Non-Conference,2010,Auburn,5,0,5,1.0
vs. Ranked (AP),2010,Auburn,7,0,7,1.0
vs. Unranked (AP),2010,Auburn,7,0,7,1.0
vs. FBS (I-A),2010,Auburn,13,0,13,1.0
vs. FCS (I-AA),2010,Auburn,1,0,1,1.0
vs. FBS Winning,2010,Auburn,7,0,7,1.0
vs. FBS Non-Winning,2010,Auburn,6,0,6,1.0
vs. BCS AQ,2010,Auburn,11,0,11,1.0
vs. BCS non-AQ,2010,Auburn,2,0,2,1.0
vs. FBS Power 5,2010,Auburn,11,0,11,1.0
vs. FBS non-Power 5,2010,Auburn,2,0,2,1.0
in August/September,2010,Auburn,4,0,4,1.0
in October,2010,Auburn,5,0,5,1.0
in November,2010,Auburn,3,0,3,1.0
in December/January,2010,Auburn,2,0,2,1.0
All Games,2011,Auburn,8,5,13,0.6153846153846154
at Home,2011,Auburn,6,1,7,0.8571428571428571
on Road/Neutral Site,2011,Auburn,2,4,6,0.3333333333333333
vs. Conference,2011,Auburn,4,4,8,0.5
vs. Non-Conference,2011,Auburn,4,1,5,0.8
vs. Ranked (AP),2011,Auburn,1,5,6,0.16666666666666666
vs. Unranked (AP),2011,Auburn,7,0,7,1.0
vs. FBS (I-A),2011,Auburn,7,5,12,0.5833333333333334
vs. FCS (I-AA),2011,Auburn,1,0,1,1.0
vs. FBS Winning,2011,Auburn,5,5,10,0.5
vs. FBS Non-Winning,2011,Auburn,2,0,2,1.0
vs. BCS AQ,2011,Auburn,5,5,10,0.5
vs. BCS non-AQ,2011,Auburn,2,0,2,1.0
vs. FBS Power 5,2011,Auburn,5,5,10,0.5
vs. FBS non-Power 5,2011,Auburn,2,0,2,1.0
in August/September,2011,Auburn,3,1,4,0.75
in October,2011,Auburn,3,2,5,0.6
in November,2011,Auburn,1,2,3,0.3333333333333333
in December/January,2011,Auburn,1,0,1,1.0
All Games,2012,Auburn,3,9,12,0.25
at Home,2012,Auburn,3,4,7,0.42857142857142855
on Road/Neutral Site,2012,Auburn,0,5,5,0.0
vs. Conference,2012,Auburn,0,8,8,0.0
vs. Non-Conference,2012,Auburn,3,1,4,0.75
vs. Ranked (AP),2012,Auburn,0,6,6,0.0
vs. Unranked (AP),2012,Auburn,3,3,6,0.5
vs. FBS (I-A),2012,Auburn,2,9,11,0.18181818181818182
vs. FCS (I-AA),2012,Auburn,1,0,1,1.0
vs. FBS Winning,2012,Auburn,1,8,9,0.1111111111111111
vs. FBS Non-Winning,2012,Auburn,1,1,2,0.5
vs. BCS AQ,2012,Auburn,0,9,9,0.0
vs. BCS non-AQ,2012,Auburn,2,0,2,1.0
vs. FBS Power 5,2012,Auburn,0,9,9,0.0
vs. FBS non-Power 5,2012,Auburn,2,0,2,1.0
in August/September,2012,Auburn,1,3,4,0.25
in October,2012,Auburn,0,4,4,0.0
in November,2012,Auburn,2,2,4,0.5
in December/January,2012,Auburn,0,0,0,
All Games,2013,Auburn,12,2,14,0.8571428571428571
at Home,2013,Auburn,8,0,8,1.0
on Road/Neutral Site,2013,Auburn,4,2,6,0.6666666666666666
vs. Conference,2013,Auburn,8,1,9,0.8888888888888888
vs. Non-Conference,2013,Auburn,4,1,5,0.8
vs. Ranked (AP),2013,Auburn,3,2,5,0.6
vs. Unranked (AP),2013,Auburn,9,0,9,1.0
vs. FBS (I-A),2013,Auburn,11,2,13,0.8461538461538461
vs. FCS (I-AA),2013,Auburn,1,0,1,1.0
vs. FBS Winning,2013,Auburn,7,2,9,0.7777777777777778
vs. FBS Non-Winning,2013,Auburn,4,0,4,1.0
vs. BCS AQ,2013,Auburn,9,2,11,0.8181818181818182
vs. BCS non-AQ,2013,Auburn,2,0,2,1.0
vs. FBS Power 5,2013,Auburn,9,2,11,0.8181818181818182
vs. FBS non-Power 5,2013,Auburn,2,0,2,1.0
in August/September,2013,Auburn,3,1,4,0.75
in October,2013,Auburn,4,0,4,1.0
in November,2013,Auburn,4,0,4,1.0
in December/January,2013,Auburn,1,1,2,0.5
All Games,2014,Auburn,8,5,13,0.6153846153846154
at Home,2014,Auburn,6,1,7,0.8571428571428571
on Road/Neutral Site,2014,Auburn,2,4,6,0.3333333333333333
vs. Conference,2014,Auburn,4,4,8,0.5
vs. Non-Conference,2014,Auburn,4,1,5,0.8
vs. Ranked (AP),2014,Auburn,2,4,6,0.3333333333333333
vs. Unranked (AP),2014,Auburn,6,1,7,0.8571428571428571
vs. FBS (I-A),2014,Auburn,7,5,12,0.5833333333333334
vs. FCS (I-AA),2014,Auburn,1,0,1,1.0
vs. FBS Winning,2014,Auburn,6,5,11,0.5454545454545454
vs. FBS Non-Winning,2014,Auburn,1,0,1,1.0
vs. BCS AQ,2014,Auburn,5,5,10,0.5
vs. BCS non-AQ,2014,Auburn,2,0,2,1.0
vs. FBS Power 5,2014,Auburn,5,5,10,0.5
vs. FBS non-Power 5,2014,Auburn,2,0,2,1.0
in August/September,2014,Auburn,4,0,4,1.0
in October,2014,Auburn,2,1,3,0.6666666666666666
in November,2014,Auburn,2,3,5,0.4
in December/January,2014,Auburn,0,1,1,0.0
All Games,2015,Auburn,7,6,13,0.5384615384615384
at Home,2015,Auburn,3,4,7,0.42857142857142855
on Road/Neutral Site,2015,Auburn,4,2,6,0.6666666666666666
vs. Conference,2015,Auburn,2,6,8,0.25
vs. Non-Conference,2015,Auburn,5,0,5,1.0
vs. Ranked (AP),2015,Auburn,0,3,3,0.0
vs. Unranked (AP),2015,Auburn,7,3,10,0.7
vs. FBS (I-A),2015,Auburn,6,6,12,0.5
vs. FCS (I-AA),2015,Auburn,1,0,1,1.0
vs. FBS Winning,2015,Auburn,3,6,9,0.3333333333333333
vs. FBS Non-Winning,2015,Auburn,3,0,3,1.0
vs. BCS AQ,2015,Auburn,4,6,10,0.4
vs. BCS non-AQ,2015,Auburn,2,0,2,1.0
vs. FBS Power 5,2015,Auburn,3,6,9,0.3333333333333333
vs. FBS non-Power 5,2015,Auburn,3,0,3,1.0
in August/September,2015,Auburn,2,2,4,0.5
in October,2015,Auburn,2,2,4,0.5
in November,2015,Auburn,2,2,4,0.5
in December/January,2015,Auburn,1,0,1,1.0
All Games,2016,Auburn,8,5,13,0.6153846153846154
at Home,2016,Auburn,6,2,8,0.75
on Road/Neutral Site,2016,Auburn,2,3,5,0.4
vs. Conference,2016,Auburn,5,3,8,0.625
vs. Non-Conference,2016,Auburn,3,2,5,0.6
vs. Ranked (AP),2016,Auburn,1,3,4,0.25
vs. Unranked (AP),2016,Auburn,7,2,9,0.7777777777777778
vs. FBS (I-A),2016,Auburn,7,5,12,0.5833333333333334
vs. FCS (I-AA),2016,Auburn,1,0,1,1.0
vs. FBS Winning,2016,Auburn,3,5,8,0.375
vs. FBS Non-Winning,2016,Auburn,4,0,4,1.0
vs. BCS AQ,2016,Auburn,5,5,10,0.5
vs. BCS non-AQ,2016,Auburn,2,0,2,1.0
vs. FBS Power 5,2016,Auburn,5,5,10,0.5
vs. FBS non-Power 5,2016,Auburn,2,0,2,1.0
in August/September,2016,Auburn,2,2,4,0.5
in October,2016,Auburn,4,0,4,1.0
in November,2016,Auburn,2,2,4,0.5
in December/January,2016,Auburn,0,1,1,0.0
All Games,2017,Auburn,10,4,14,0.7142857142857143
at Home,2017,Auburn,7,0,7,1.0
on Road/Neutral Site,2017,Auburn,3,4,7,0.42857142857142855
vs. Conference,2017,Auburn,7,2,9,0.7777777777777778
vs. Non-Conference,2017,Auburn,3,2,5,0.6
vs. Ranked (AP),2017,Auburn,3,4,7,0.42857142857142855
vs. Unranked (AP),2017,Auburn,7,0,7,1.0
vs. FBS (I-A),2017,Auburn,9,4,13,0.6923076923076923
vs. FCS (I-AA),2017,Auburn,1,0,1,1.0
vs. FBS Winning,2017,Auburn,5,4,9,0.5555555555555556
vs. FBS Non-Winning,2017,Auburn,4,0,4,1.0
vs. BCS AQ,2017,Auburn,7,4,11,0.6363636363636364
vs. BCS non-AQ,2017,Auburn,2,0,2,1.0
vs. FBS Power 5,2017,Auburn,7,3,10,0.7
vs. FBS non-Power 5,2017,Auburn,2,1,3,0.6666666666666666
in August/September,2017,Auburn,4,1,5,0.8
in October,2017,Auburn,2,1,3,0.6666666666666666
in November,2017,Auburn,4,0,4,1.0
in December/January,2017,Auburn,0,2,2,0.0
All Games,2018,Auburn,8,5,13,0.6153846153846154
at Home,2018,Auburn,5,2,7,0.7142857142857143
on Road/Neutral Site,2018,Auburn,3,3,6,0.5
vs. Conference,2018,Auburn,3,5,8,0.375
vs. Non-Conference,2018,Auburn,5,0,5,1.0
vs. Ranked (AP),2018,Auburn,2,3,5,0.4
vs. Unranked (AP),2018,Auburn,6,2,8,0.75
vs. FBS (I-A),2018,Auburn,7,5,12,0.5833333333333334
vs. FCS (I-AA),2018,Auburn,1,0,1,1.0
vs. FBS Winning,2018,Auburn,3,4,7,0.42857142857142855
vs. FBS Non-Winning,2018,Auburn,4,1,5,0.8
vs. BCS AQ,2018,Auburn,5,5,10,0.5
vs. BCS non-AQ,2018,Auburn,2,0,2,1.0
vs. FBS Power 5,2018,Auburn,5,5,10,0.5
vs. FBS non-Power 5,2018,Auburn,2,0,2,1.0
in August/September,2018,Auburn,4,1,5,0.8
in October,2018,Auburn,1,2,3,0.3333333333333333
in November,2018,Auburn,2,2,4,0.5
in December/January,2018,Auburn,1,0,1,1.0
All Games,2019,Auburn,9,4,13,0.6923076923076923
at Home,2019,Auburn,6,1,7,0.8571428571428571
on Road/Neutral Site,2019,Auburn,3,3,6,0.5
vs. Conference,2019,Auburn,5,3,8,0.625
vs. Non-Conference,2019,Auburn,4,1,5,0.8
vs. Ranked (AP),2019,Auburn,2,4,6,0.3333333333333333
vs. Unranked (AP),2019,Auburn,7,0,7,1.0
vs. FBS (I-A),2019,Auburn,8,4,12,0.6666666666666666
vs. FCS (I-AA),2019,Auburn,1,0,1,1.0
vs. FBS Winning,2019,Auburn,5,4,9,0.5555555555555556
vs. FBS Non-Winning,2019,Auburn,3,0,3,1.0
vs. BCS AQ,2019,Auburn,7,4,11,0.6363636363636364
vs. BCS non-AQ,2019,Auburn,1,0,1,1.0
vs. FBS Power 5,2019,Auburn,6,4,10,0.6
vs. FBS non-Power 5,2019,Auburn,2,0,2,1.0
in August/September,2019,Auburn,5,0,5,1.0
in October,2019,Auburn,1,2,3,0.3333333333333333
in November,2019,Auburn,3,1,4,0.75
in December/January,2019,Auburn,0,1,1,0.0
All Games,2020,Auburn,6,5,11,0.5454545454545454
at Home,2020,Auburn,4,1,5,0.8
on Road/Neutral Site,2020,Auburn,2,4,6,0.3333333333333333
vs. Conference,2020,Auburn,6,4,10,0.6
vs. Non-Conference,2020,Auburn,0,1,1,0.0
vs. Ranked (AP),2020,Auburn,0,4,4,0.0
vs. Unranked (AP),2020,Auburn,6,1,7,0.8571428571428571
vs. FBS (I-A),2020,Auburn,6,5,11,0.5454545454545454
vs. FCS (I-AA),2020,Auburn,0,0,0,
vs. FBS Winning,2020,Auburn,0,4,4,0.0
vs. FBS Non-Winning,2020,Auburn,6,1,7,0.8571428571428571
vs. BCS AQ,2020,Auburn,6,5,11,0.5454545454545454
vs. BCS non-AQ,2020,Auburn,0,0,0,
vs. FBS Power 5,2020,Auburn,6,5,11,0.5454545454545454
vs. FBS non-Power 5,2020,Auburn,0,0,0,
in August/September,2020,Auburn,1,0,1,1.0
in October,2020,Auburn,3,2,5,0.6
in November,2020,Auburn,1,1,2,0.5
in December/January,2020,Auburn,1,2,3,0.3333333333333333
All Games,2021,Auburn,6,7,13,0.46153846153846156
at Home,2021,Auburn,4,3,7,0.5714285714285714
on Road/Neutral Site,2021,Auburn,2,4,6,0.3333333333333333
vs. Conference,2021,Auburn,3,5,8,0.375
vs. Non-Conference,2021,Auburn,3,2,5,0.6
vs. Ranked (AP),2021,Auburn,2,3,5,0.4
vs. Unranked (AP),2021,Auburn,4,4,8,0.5
vs. FBS (I-A),2021,Auburn,5,7,12,0.4166666666666667
vs. FCS (I-AA),2021,Auburn,1,0,1,1.0
vs. FBS Winning,2021,Auburn,3,7,10,0.3
vs. FBS Non-Winning,2021,Auburn,2,0,2,1.0
vs. BCS AQ,2021,Auburn,3,7,10,0.3
vs. BCS non-AQ,2021,Auburn,2,0,2,1.0
vs. FBS Power 5,2021,Auburn,3,6,9,0.3333333333333333
vs. FBS non-Power 5,2021,Auburn,2,1,3,0.6666666666666666
in August/September,2021,Auburn,3,1,4,0.75
in October,2021,Auburn,3,1,4,0.75
in November,2021,Auburn,0,4,4,0.0
in December/January,2021,Auburn,0,1,1,0.0
All Games,2022,Auburn,5,7,12,0.4166666666666667
at Home,2022,Auburn,5,3,8,0.625
on Road/Neutral Site,2022,Auburn,0,4,4,0.0
vs. Conference,2022,Auburn,2,6,8,0.25
vs. Non-Conference,2022,Auburn,3,1,4,0.75
vs. Ranked (AP),2022,Auburn,0,5,5,0.0
vs. Unranked (AP),2022,Auburn,5,2,7,0.7142857142857143
vs. FBS (I-A),2022,Auburn,4,7,11,0.36363636363636365
vs. FCS (I-AA),2022,Auburn,1,0,1,1.0
vs. FBS Winning,2022,Auburn,2,7,9,0.2222222222222222
vs. FBS Non-Winning,2022,Auburn,2,0,2,1.0
vs. BCS AQ,2022,Auburn,2,7,9,0.2222222222222222
vs. BCS non-AQ,2022,Auburn,2,0,2,1.0
vs. FBS Power 5,2022,Auburn,2,7,9,0.2222222222222222
vs. FBS non-Power 5,2022,Auburn,2,0,2,1.0
in August/September,2022,Auburn,3,1,4,0.75
in October,2022,Auburn,0,4,4,0.0
in November,2022,Auburn,2,2,4,0.5
in December/January,2022,Auburn,0,0,0,
All Games,2009,BYU,11,2,13,0.8461538461538461
at Home,2009,BYU,4,2,6,0.6666666666666666
on Road/Neutral Site,2009,BYU,7,0,7,1.0
vs. Conference,2009,BYU,7,1,8,0.875
vs. Non-Conference,2009,BYU,4,1,5,0.8
vs. Ranked (AP),2009,BYU,1,1,2,0.5
vs. Unranked (AP),2009,BYU,10,1,11,0.9090909090909091
vs. FBS (I-A),2009,BYU,11,2,13,0.8461538461538461
vs. FCS (I-AA),2009,BYU,0,0,0,
vs. FBS Winning,2009,BYU,5,2,7,0.7142857142857143
vs. FBS Non-Winning,2009,BYU,6,0,6,1.0
vs. BCS AQ,2009,BYU,2,1,3,0.6666666666666666
vs. BCS non-AQ,2009,BYU,9,1,10,0.9
vs. FBS Power 5,2009,BYU,2,1,3,0.6666666666666666
vs. FBS non-Power 5,2009,BYU,9,1,10,0.9
in August/September,2009,BYU,3,1,4,0.75
in October,2009,BYU,3,1,4,0.75
in November,2009,BYU,4,0,4,1.0
in December/January,2009,BYU,1,0,1,1.0
All Games,2010,BYU,7,6,13,0.5384615384615384
at Home,2010,BYU,5,1,6,0.8333333333333334
on Road/Neutral Site,2010,BYU,2,5,7,0.2857142857142857
vs. Conference,2010,BYU,5,3,8,0.625
vs. Non-Conference,2010,BYU,2,3,5,0.4
vs. Ranked (AP),2010,BYU,0,3,3,0.0
vs. Unranked (AP),2010,BYU,7,3,10,0.7
vs. FBS (I-A),2010,BYU,7,6,13,0.5384615384615384
vs. FCS (I-AA),2010,BYU,0,0,0,
vs. FBS Winning,2010,BYU,2,5,7,0.2857142857142857
vs. FBS Non-Winning,2010,BYU,5,1,6,0.8333333333333334
vs. BCS AQ,2010,BYU,1,1,2,0.5
vs. BCS non-AQ,2010,BYU,6,5,11,0.5454545454545454
vs. FBS Power 5,2010,BYU,1,1,2,0.5
vs. FBS non-Power 5,2010,BYU,6,5,11,0.5454545454545454
in August/September,2010,BYU,1,3,4,0.25
in October,2010,BYU,2,2,4,0.5
in November,2010,BYU,3,1,4,0.75
in December/January,2010,BYU,1,0,1,1.0
All Games,2011,BYU,10,3,13,0.7692307692307693
at Home,2011,BYU,6,1,7,0.8571428571428571
on Road/Neutral Site,2011,BYU,4,2,6,0.6666666666666666
vs. Conference,2011,BYU,0,0,0,
vs. Non-Conference,2011,BYU,10,3,13,0.7692307692307693
vs. Ranked (AP),2011,BYU,0,1,1,0.0
vs. Unranked (AP),2011,BYU,10,2,12,0.8333333333333334
vs. FBS (I-A),2011,BYU,9,3,12,0.75
vs. FCS (I-AA),2011,BYU,1,0,1,1.0
vs. FBS Winning,2011,BYU,2,3,5,0.4
vs. FBS Non-Winning,2011,BYU,7,0,7,1.0
vs. BCS AQ,2011,BYU,2,2,4,0.5
vs. BCS non-AQ,2011,BYU,7,1,8,0.875
vs. FBS Power 5,2011,BYU,2,2,4,0.5
vs. FBS non-Power 5,2011,BYU,7,1,8,0.875
in August/September,2011,BYU,3,2,5,0.6
in October,2011,BYU,3,1,4,0.75
in November,2011,BYU,2,0,2,1.0
in December/January,2011,BYU,2,0,2,1.0
All Games,2012,BYU,8,5,13,0.6153846153846154
at Home,2012,BYU,5,1,6,0.8333333333333334
on Road/Neutral Site,2012,BYU,3,4,7,0.42857142857142855
vs. Conference,2012,BYU,0,1,1,0.0
vs. Non-Conference,2012,BYU,8,4,12,0.6666666666666666
vs. Ranked (AP),2012,BYU,1,4,5,0.2
vs. Unranked (AP),2012,BYU,7,1,8,0.875
vs. FBS (I-A),2012,BYU,7,5,12,0.5833333333333334
vs. FCS (I-AA),2012,BYU,1,0,1,1.0
vs. FBS Winning,2012,BYU,2,4,6,0.3333333333333333
vs. FBS Non-Winning,2012,BYU,5,1,6,0.8333333333333334
vs. BCS AQ,2012,BYU,2,3,5,0.4
vs. BCS non-AQ,2012,BYU,5,2,7,0.7142857142857143
vs. FBS Power 5,2012,BYU,2,2,4,0.5
vs. FBS non-Power 5,2012,BYU,5,3,8,0.625
in August/September,2012,BYU,3,2,5,0.6
in October,2012,BYU,2,2,4,0.5
in November,2012,BYU,2,1,3,0.6666666666666666
in December/January,2012,BYU,1,0,1,1.0
All Games,2013,BYU,8,5,13,0.6153846153846154
at Home,2013,BYU,5,1,6,0.8333333333333334
on Road/Neutral Site,2013,BYU,3,4,7,0.42857142857142855
vs. Conference,2013,BYU,0,1,1,0.0
vs. Non-Conference,2013,BYU,8,4,12,0.6666666666666666
vs. Ranked (AP),2013,BYU,0,3,3,0.0
vs. Unranked (AP),2013,BYU,8,2,10,0.8
vs. FBS (I-A),2013,BYU,7,5,12,0.5833333333333334
vs. FCS (I-AA),2013,BYU,1,0,1,1.0
vs. FBS Winning,2013,BYU,6,3,9,0.6666666666666666
vs. FBS Non-Winning,2013,BYU,1,2,3,0.3333333333333333
vs. BCS AQ,2013,BYU,3,5,8,0.375
vs. BCS non-AQ,2013,BYU,4,0,4,1.0
vs. FBS Power 5,2013,BYU,2,4,6,0.3333333333333333
vs. FBS non-Power 5,2013,BYU,5,1,6,0.8333333333333334
in August/September,2013,BYU,2,2,4,0.5
in October,2013,BYU,4,0,4,1.0
in November,2013,BYU,2,2,4,0.5
in December/January,2013,BYU,0,1,1,0.0
All Games,2014,BYU,8,5,13,0.6153846153846154
at Home,2014,BYU,4,2,6,0.6666666666666666
on Road/Neutral Site,2014,BYU,4,3,7,0.5714285714285714
vs. Conference,2014,BYU,0,0,0,
vs. Non-Conference,2014,BYU,8,5,13,0.6153846153846154
vs. Ranked (AP),2014,BYU,0,2,2,0.0
vs. Unranked (AP),2014,BYU,8,3,11,0.7272727272727273
vs. FBS (I-A),2014,BYU,7,5,12,0.5833333333333334
vs. FCS (I-AA),2014,BYU,1,0,1,1.0
vs. FBS Winning,2014,BYU,1,5,6,0.16666666666666666
vs. FBS Non-Winning,2014,BYU,6,0,6,1.0
vs. BCS AQ,2014,BYU,5,2,7,0.7142857142857143
vs. BCS non-AQ,2014,BYU,2,3,5,0.4
vs. FBS Power 5,2014,BYU,3,0,3,1.0
vs. FBS non-Power 5,2014,BYU,4,5,9,0.4444444444444444
in August/September,2014,BYU,4,0,4,1.0
in October,2014,BYU,0,4,4,0.0
in November,2014,BYU,4,0,4,1.0
in December/January,2014,BYU,0,1,1,0.0
All Games,2015,BYU,9,4,13,0.6923076923076923
at Home,2015,BYU,6,0,6,1.0
on Road/Neutral Site,2015,BYU,3,4,7,0.42857142857142855
vs. Conference,2015,BYU,0,0,0,
vs. Non-Conference,2015,BYU,9,4,13,0.6923076923076923
vs. Ranked (AP),2015,BYU,0,2,2,0.0
vs. Unranked (AP),2015,BYU,9,2,11,0.8181818181818182
vs. FBS (I-A),2015,BYU,8,4,12,0.6666666666666666
vs. FCS (I-AA),2015,BYU,1,0,1,1.0
vs. FBS Winning,2015,BYU,2,3,5,0.4
vs. FBS Non-Winning,2015,BYU,6,1,7,0.8571428571428571
vs. BCS AQ,2015,BYU,4,4,8,0.5
vs. BCS non-AQ,2015,BYU,4,0,4,1.0
vs. FBS Power 5,2015,BYU,1,4,5,0.2
vs. FBS non-Power 5,2015,BYU,7,0,7,1.0
in August/September,2015,BYU,2,2,4,0.5
in October,2015,BYU,4,0,4,1.0
in November,2015,BYU,3,1,4,0.75
in December/January,2015,BYU,0,1,1,0.0
All Games,2016,BYU,9,4,13,0.6923076923076923
at Home,2016,BYU,5,1,6,0.8333333333333334
on Road/Neutral Site,2016,BYU,4,3,7,0.5714285714285714
vs. Conference,2016,BYU,1,0,1,1.0
vs. Non-Conference,2016,BYU,8,4,12,0.6666666666666666
vs. Ranked (AP),2016,BYU,0,1,1,0.0
vs. Unranked (AP),2016,BYU,9,3,12,0.75
vs. FBS (I-A),2016,BYU,8,4,12,0.6666666666666666
vs. FCS (I-AA),2016,BYU,1,0,1,1.0
vs. FBS Winning,2016,BYU,2,3,5,0.4
vs. FBS Non-Winning,2016,BYU,6,1,7,0.8571428571428571
vs. BCS AQ,2016,BYU,4,3,7,0.5714285714285714
vs. BCS non-AQ,2016,BYU,4,1,5,0.8
vs. FBS Power 5,2016,BYU,3,3,6,0.5
vs. FBS non-Power 5,2016,BYU,5,1,6,0.8333333333333334
in August/September,2016,BYU,2,3,5,0.4
in October,2016,BYU,2,1,3,0.6666666666666666
in November,2016,BYU,4,0,4,1.0
in December/January,2016,BYU,1,0,1,1.0
All Games,2017,BYU,4,9,13,0.3076923076923077
at Home,2017,BYU,2,4,6,0.3333333333333333
on Road/Neutral Site,2017,BYU,2,5,7,0.2857142857142857
vs. Conference,2017,BYU,0,1,1,0.0
vs. Non-Conference,2017,BYU,4,8,12,0.3333333333333333
vs. Ranked (AP),2017,BYU,0,4,4,0.0
vs. Unranked (AP),2017,BYU,4,5,9,0.4444444444444444
vs. FBS (I-A),2017,BYU,3,9,12,0.25
vs. FCS (I-AA),2017,BYU,1,0,1,1.0
vs. FBS Winning,2017,BYU,0,6,6,0.0
vs. FBS Non-Winning,2017,BYU,3,3,6,0.5
vs. BCS AQ,2017,BYU,0,5,5,0.0
vs. BCS non-AQ,2017,BYU,3,4,7,0.42857142857142855
vs. FBS Power 5,2017,BYU,0,4,4,0.0
vs. FBS non-Power 5,2017,BYU,3,5,8,0.375
in August/September,2017,BYU,1,4,5,0.2
in October,2017,BYU,1,3,4,0.25
in November,2017,BYU,2,2,4,0.5
in December/January,2017,BYU,0,0,0,
All Games,2018,BYU,7,6,13,0.5384615384615384
at Home,2018,BYU,3,3,6,0.5
on Road/Neutral Site,2018,BYU,4,3,7,0.5714285714285714
vs. Conference,2018,BYU,2,0,2,1.0
vs. Non-Conference,2018,BYU,5,6,11,0.45454545454545453
vs. Ranked (AP),2018,BYU,0,3,3,0.0
vs. Unranked (AP),2018,BYU,7,3,10,0.7
vs. FBS (I-A),2018,BYU,6,6,12,0.5
vs. FCS (I-AA),2018,BYU,1,0,1,1.0
vs. FBS Winning,2018,BYU,3,6,9,0.3333333333333333
vs. FBS Non-Winning,2018,BYU,3,0,3,1.0
vs. BCS AQ,2018,BYU,2,3,5,0.4
vs. BCS non-AQ,2018,BYU,4,3,7,0.5714285714285714
vs. FBS Power 5,2018,BYU,2,3,5,0.4
vs. FBS non-Power 5,2018,BYU,4,3,7,0.5714285714285714
in August/September,2018,BYU,3,2,5,0.6
in October,2018,BYU,1,2,3,0.3333333333333333
in November,2018,BYU,2,2,4,0.5
in December/January,2018,BYU,1,0,1,1.0
All Games,2019,BYU,7,6,13,0.5384615384615384
at Home,2019,BYU,4,2,6,0.6666666666666666
on Road/Neutral Site,2019,BYU,3,4,7,0.42857142857142855
vs. Conference,2019,BYU,2,0,2,1.0
vs. Non-Conference,2019,BYU,5,6,11,0.45454545454545453
vs. Ranked (AP),2019,BYU,1,1,2,0.5
vs. Unranked (AP),2019,BYU,6,5,11,0.5454545454545454
vs. FBS (I-A),2019,BYU,6,6,12,0.5
vs. FCS (I-AA),2019,BYU,1,0,1,1.0
vs. FBS Winning,2019,BYU,5,4,9,0.5555555555555556
vs. FBS Non-Winning,2019,BYU,1,2,3,0.3333333333333333
vs. BCS AQ,2019,BYU,2,3,5,0.4
vs. BCS non-AQ,2019,BYU,4,3,7,0.5714285714285714
vs. FBS Power 5,2019,BYU,2,2,4,0.5
vs. FBS non-Power 5,2019,BYU,4,4,8,0.5
in August/September,2019,BYU,2,3,5,0.4
in October,2019,BYU,1,1,2,0.5
in November,2019,BYU,4,1,5,0.8
in December/January,2019,BYU,0,1,1,0.0
All Games,2020,BYU,11,1,12,0.9166666666666666
at Home,2020,BYU,7,0,7,1.0
on Road/Neutral Site,2020,BYU,4,1,5,0.8
vs. Conference,2020,BYU,0,0,0,
vs. Non-Conference,2020,BYU,11,1,12,0.9166666666666666
vs. Ranked (AP),2020,BYU,0,1,1,0.0
vs. Unranked (AP),2020,BYU,11,0,11,1.0
vs. FBS (I-A),2020,BYU,10,1,11,0.9090909090909091
vs. FCS (I-AA),2020,BYU,1,0,1,1.0
vs. FBS Winning,2020,BYU,3,1,4,0.75
vs. FBS Non-Winning,2020,BYU,7,0,7,1.0
vs. BCS AQ,2020,BYU,3,0,3,1.0
vs. BCS non-AQ,2020,BYU,7,1,8,0.875
vs. FBS Power 5,2020,BYU,0,0,0,
vs. FBS non-Power 5,2020,BYU,10,1,11,0.9090909090909091
in August/September,2020,BYU,2,0,2,1.0
in October,2020,BYU,5,0,5,1.0
in November,2020,BYU,2,0,2,1.0
in December/January,2020,BYU,2,1,3,0.6666666666666666
All Games,2021,BYU,10,3,13,0.7692307692307693
at Home,2021,BYU,5,1,6,0.8333333333333334
on Road/Neutral Site,2021,BYU,5,2,7,0.7142857142857143
vs. Conference,2021,BYU,0,0,0,
vs. Non-Conference,2021,BYU,10,3,13,0.7692307692307693
vs. Ranked (AP),2021,BYU,2,1,3,0.6666666666666666
vs. Unranked (AP),2021,BYU,8,2,10,0.8
vs. FBS (I-A),2021,BYU,9,3,12,0.75
vs. FCS (I-AA),2021,BYU,1,0,1,1.0
vs. FBS Winning,2021,BYU,4,3,7,0.5714285714285714
vs. FBS Non-Winning,2021,BYU,5,0,5,1.0
vs. BCS AQ,2021,BYU,7,1,8,0.875
vs. BCS non-AQ,2021,BYU,2,2,4,0.5
vs. FBS Power 5,2021,BYU,6,1,7,0.8571428571428571
vs. FBS non-Power 5,2021,BYU,3,2,5,0.6
in August/September,2021,BYU,4,0,4,1.0
in October,2021,BYU,3,2,5,0.6
in November,2021,BYU,3,0,3,1.0
in December/January,2021,BYU,0,1,1,0.0
All Games,2022,BYU,8,5,13,0.6153846153846154
at Home,2022,BYU,4,2,6,0.6666666666666666
on Road/Neutral Site,2022,BYU,4,3,7,0.5714285714285714
vs. Conference,2022,BYU,0,2,2,0.0
vs. Non-Conference,2022,BYU,8,3,11,0.7272727272727273
vs. Ranked (AP),2022,BYU,0,2,2,0.0
vs. Unranked (AP),2022,BYU,8,3,11,0.7272727272727273
vs. FBS (I-A),2022,BYU,7,5,12,0.5833333333333334
vs. FCS (I-AA),2022,BYU,1,0,1,1.0
vs. FBS Winning,2022,BYU,3,5,8,0.375
vs. FBS Non-Winning,2022,BYU,4,0,4,1.0
vs. BCS AQ,2022,BYU,4,4,8,0.5
vs. BCS non-AQ,2022,BYU,3,1,4,0.75
vs. FBS Power 5,2022,BYU,2,2,4,0.5
vs. FBS non-Power 5,2022,BYU,5,3,8,0.625
in August/September,2022,BYU,4,1,5,0.8
in October,2022,BYU,0,4,4,0.0
in November,2022,BYU,3,0,3,1.0
in December/January,2022,BYU,1,0,1,1.0
All Games,2009,Ball State,2,10,12,0.16666666666666666
at Home,2009,Ball State,0,6,6,0.0
on Road/Neutral Site,2009,Ball State,2,4,6,0.3333333333333333
vs. Conference,2009,Ball State,2,6,8,0.25
vs. Non-Conference,2009,Ball State,0,4,4,0.0
vs. Ranked (AP),2009,Ball State,0,1,1,0.0
vs. Unranked (AP),2009,Ball State,2,9,11,0.18181818181818182
vs. FBS (I-A),2009,Ball State,2,9,11,0.18181818181818182
vs. FCS (I-AA),2009,Ball State,0,1,1,0.0
vs. FBS Winning,2009,Ball State,0,6,6,0.0
vs. FBS Non-Winning,2009,Ball State,2,3,5,0.4
vs. BCS AQ,2009,Ball State,0,1,1,0.0
vs. BCS non-AQ,2009,Ball State,2,8,10,0.2
vs. FBS Power 5,2009,Ball State,0,1,1,0.0
vs. FBS non-Power 5,2009,Ball State,2,8,10,0.2
in August/September,2009,Ball State,0,4,4,0.0
in October,2009,Ball State,1,4,5,0.2
in November,2009,Ball State,1,2,3,0.3333333333333333
in December/January,2009,Ball State,0,0,0,
All Games,2010,Ball State,4,8,12,0.3333333333333333
at Home,2010,Ball State,2,4,6,0.3333333333333333
on Road/Neutral Site,2010,Ball State,2,4,6,0.3333333333333333
vs. Conference,2010,Ball State,3,5,8,0.375
vs. Non-Conference,2010,Ball State,1,3,4,0.25
vs. Ranked (AP),2010,Ball State,0,0,0,
vs. Unranked (AP),2010,Ball State,4,8,12,0.3333333333333333
vs. FBS (I-A),2010,Ball State,3,7,10,0.3
vs. FCS (I-AA),2010,Ball State,1,1,2,0.5
vs. FBS Winning,2010,Ball State,0,3,3,0.0
vs. FBS Non-Winning,2010,Ball State,3,4,7,0.42857142857142855
vs. BCS AQ,2010,Ball State,0,2,2,0.0
vs. BCS non-AQ,2010,Ball State,3,5,8,0.375
vs. FBS Power 5,2010,Ball State,0,2,2,0.0
vs. FBS non-Power 5,2010,Ball State,3,5,8,0.375
in August/September,2010,Ball State,1,3,4,0.25
in October,2010,Ball State,1,4,5,0.2
in November,2010,Ball State,2,1,3,0.6666666666666666
in December/January,2010,Ball State,0,0,0,
All Games,2011,Ball State,6,6,12,0.5
at Home,2011,Ball State,3,2,5,0.6
on Road/Neutral Site,2011,Ball State,3,4,7,0.42857142857142855
vs. Conference,2011,Ball State,4,4,8,0.5
vs. Non-Conference,2011,Ball State,2,2,4,0.5
vs. Ranked (AP),2011,Ball State,0,1,1,0.0
vs. Unranked (AP),2011,Ball State,6,5,11,0.5454545454545454
vs. FBS (I-A),2011,Ball State,6,6,12,0.5
vs. FCS (I-AA),2011,Ball State,0,0,0,
vs. FBS Winning,2011,Ball State,1,5,6,0.16666666666666666
vs. FBS Non-Winning,2011,Ball State,5,1,6,0.8333333333333334
vs. BCS AQ,2011,Ball State,1,2,3,0.3333333333333333
vs. BCS non-AQ,2011,Ball State,5,4,9,0.5555555555555556
vs. FBS Power 5,2011,Ball State,1,1,2,0.5
vs. FBS non-Power 5,2011,Ball State,5,5,10,0.5
in August/September,2011,Ball State,3,1,4,0.75
in October,2011,Ball State,2,3,5,0.4
in November,2011,Ball State,1,2,3,0.3333333333333333
in December/January,2011,Ball State,0,0,0,
All Games,2012,Ball State,9,4,13,0.6923076923076923
at Home,2012,Ball State,4,1,5,0.8
on Road/Neutral Site,2012,Ball State,5,3,8,0.625
vs. Conference,2012,Ball State,6,2,8,0.75
vs. Non-Conference,2012,Ball State,3,2,5,0.6
vs. Ranked (AP),2012,Ball State,0,2,2,0.0
vs. Unranked (AP),2012,Ball State,9,2,11,0.8181818181818182
vs. FBS (I-A),2012,Ball State,9,4,13,0.6923076923076923
vs. FCS (I-AA),2012,Ball State,0,0,0,
vs. FBS Winning,2012,Ball State,3,4,7,0.42857142857142855
vs. FBS Non-Winning,2012,Ball State,6,0,6,1.0
vs. BCS AQ,2012,Ball State,2,1,3,0.6666666666666666
vs. BCS non-AQ,2012,Ball State,7,3,10,0.7
vs. FBS Power 5,2012,Ball State,1,1,2,0.5
vs. FBS non-Power 5,2012,Ball State,8,3,11,0.7272727272727273
in August/September,2012,Ball State,3,2,5,0.6
in October,2012,Ball State,3,1,4,0.75
in November,2012,Ball State,3,0,3,1.0
in December/January,2012,Ball State,0,1,1,0.0
All Games,2013,Ball State,10,3,13,0.7692307692307693
at Home,2013,Ball State,6,0,6,1.0
on Road/Neutral Site,2013,Ball State,4,3,7,0.5714285714285714
vs. Conference,2013,Ball State,7,1,8,0.875
vs. Non-Conference,2013,Ball State,3,2,5,0.6
vs. Ranked (AP),2013,Ball State,0,0,0,
vs. Unranked (AP),2013,Ball State,10,3,13,0.7692307692307693
vs. FBS (I-A),2013,Ball State,9,3,12,0.75
vs. FCS (I-AA),2013,Ball State,1,0,1,1.0
vs. FBS Winning,2013,Ball State,1,3,4,0.25
vs. FBS Non-Winning,2013,Ball State,8,0,8,1.0
vs. BCS AQ,2013,Ball State,1,0,1,1.0
vs. BCS non-AQ,2013,Ball State,8,3,11,0.7272727272727273
vs. FBS Power 5,2013,Ball State,1,0,1,1.0
vs. FBS non-Power 5,2013,Ball State,8,3,11,0.7272727272727273
in August/September,2013,Ball State,4,1,5,0.8
in October,2013,Ball State,4,0,4,1.0
in November,2013,Ball State,2,1,3,0.6666666666666666
in December/January,2013,Ball State,0,1,1,0.0
All Games,2014,Ball State,5,7,12,0.4166666666666667
at Home,2014,Ball State,3,3,6,0.5
on Road/Neutral Site,2014,Ball State,2,4,6,0.3333333333333333
vs. Conference,2014,Ball State,4,4,8,0.5
vs. Non-Conference,2014,Ball State,1,3,4,0.25
vs. Ranked (AP),2014,Ball State,0,0,0,
vs. Unranked (AP),2014,Ball State,5,7,12,0.4166666666666667
vs. FBS (I-A),2014,Ball State,4,6,10,0.4
vs. FCS (I-AA),2014,Ball State,1,1,2,0.5
vs. FBS Winning,2014,Ball State,2,4,6,0.3333333333333333
vs. FBS Non-Winning,2014,Ball State,2,2,4,0.5
vs. BCS AQ,2014,Ball State,0,1,1,0.0
vs. BCS non-AQ,2014,Ball State,4,5,9,0.4444444444444444
vs. FBS Power 5,2014,Ball State,0,1,1,0.0
vs. FBS non-Power 5,2014,Ball State,4,5,9,0.4444444444444444
in August/September,2014,Ball State,1,3,4,0.25
in October,2014,Ball State,2,2,4,0.5
in November,2014,Ball State,2,2,4,0.5
in December/January,2014,Ball State,0,0,0,
All Games,2015,Ball State,3,9,12,0.25
at Home,2015,Ball State,2,4,6,0.3333333333333333
on Road/Neutral Site,2015,Ball State,1,5,6,0.16666666666666666
vs. Conference,2015,Ball State,2,6,8,0.25
vs. Non-Conference,2015,Ball State,1,3,4,0.25
vs. Ranked (AP),2015,Ball State,0,1,1,0.0
vs. Unranked (AP),2015,Ball State,3,8,11,0.2727272727272727
vs. FBS (I-A),2015,Ball State,2,9,11,0.18181818181818182
vs. FCS (I-AA),2015,Ball State,1,0,1,1.0
vs. FBS Winning,2015,Ball State,0,8,8,0.0
vs. FBS Non-Winning,2015,Ball State,2,1,3,0.6666666666666666
vs. BCS AQ,2015,Ball State,0,2,2,0.0
vs. BCS non-AQ,2015,Ball State,2,7,9,0.2222222222222222
vs. FBS Power 5,2015,Ball State,0,2,2,0.0
vs. FBS non-Power 5,2015,Ball State,2,7,9,0.2222222222222222
in August/September,2015,Ball State,2,2,4,0.5
in October,2015,Ball State,1,4,5,0.2
in November,2015,Ball State,0,3,3,0.0
in December/January,2015,Ball State,0,0,0,
All Games,2016,Ball State,4,8,12,0.3333333333333333
at Home,2016,Ball State,1,4,5,0.2
on Road/Neutral Site,2016,Ball State,3,4,7,0.42857142857142855
vs. Conference,2016,Ball State,1,7,8,0.125
vs. Non-Conference,2016,Ball State,3,1,4,0.75
vs. Ranked (AP),2016,Ball State,0,1,1,0.0
vs. Unranked (AP),2016,Ball State,4,7,11,0.36363636363636365
vs. FBS (I-A),2016,Ball State,3,8,11,0.2727272727272727
vs. FCS (I-AA),2016,Ball State,1,0,1,1.0
vs. FBS Winning,2016,Ball State,0,3,3,0.0
vs. FBS Non-Winning,2016,Ball State,3,5,8,0.375
vs. BCS AQ,2016,Ball State,0,1,1,0.0
vs. BCS non-AQ,2016,Ball State,3,7,10,0.3
vs. FBS Power 5,2016,Ball State,0,1,1,0.0
vs. FBS non-Power 5,2016,Ball State,3,7,10,0.3
in August/September,2016,Ball State,3,1,4,0.75
in October,2016,Ball State,1,3,4,0.25
in November,2016,Ball State,0,4,4,0.0
in December/January,2016,Ball State,0,0,0,
All Games,2017,Ball State,2,10,12,0.16666666666666666
at Home,2017,Ball State,2,4,6,0.3333333333333333
on Road/Neutral Site,2017,Ball State,0,6,6,0.0
vs. Conference,2017,Ball State,0,8,8,0.0
vs. Non-Conference,2017,Ball State,2,2,4,0.5
vs. Ranked (AP),2017,Ball State,0,0,0,
vs. Unranked (AP),2017,Ball State,2,10,12,0.16666666666666666
vs. FBS (I-A),2017,Ball State,1,10,11,0.09090909090909091
vs. FCS (I-AA),2017,Ball State,1,0,1,1.0
vs. FBS Winning,2017,Ball State,1,3,4,0.25
vs. FBS Non-Winning,2017,Ball State,0,7,7,0.0
vs. BCS AQ,2017,Ball State,0,1,1,0.0
vs. BCS non-AQ,2017,Ball State,1,9,10,0.1
vs. FBS Power 5,2017,Ball State,0,1,1,0.0
vs. FBS non-Power 5,2017,Ball State,1,9,10,0.1
in August/September,2017,Ball State,2,3,5,0.4
in October,2017,Ball State,0,3,3,0.0
in November,2017,Ball State,0,4,4,0.0
in December/January,2017,Ball State,0,0,0,
All Games,2018,Ball State,4,8,12,0.3333333333333333
at Home,2018,Ball State,3,3,6,0.5
on Road/Neutral Site,2018,Ball State,1,5,6,0.16666666666666666
vs. Conference,2018,Ball State,3,5,8,0.375
vs. Non-Conference,2018,Ball State,1,3,4,0.25
vs. Ranked (AP),2018,Ball State,0,1,1,0.0
vs. Unranked (AP),2018,Ball State,4,7,11,0.36363636363636365
vs. FBS (I-A),2018,Ball State,3,8,11,0.2727272727272727
vs. FCS (I-AA),2018,Ball State,1,0,1,1.0
vs. FBS Winning,2018,Ball State,1,5,6,0.16666666666666666
vs. FBS Non-Winning,2018,Ball State,2,3,5,0.4
vs. BCS AQ,2018,Ball State,0,2,2,0.0
vs. BCS non-AQ,2018,Ball State,3,6,9,0.3333333333333333
vs. FBS Power 5,2018,Ball State,0,1,1,0.0
vs. FBS non-Power 5,2018,Ball State,3,7,10,0.3
in August/September,2018,Ball State,2,3,5,0.4
in October,2018,Ball State,1,4,5,0.2
in November,2018,Ball State,1,1,2,0.5
in December/January,2018,Ball State,0,0,0,
All Games,2019,Ball State,5,7,12,0.4166666666666667
at Home,2019,Ball State,3,3,6,0.5
on Road/Neutral Site,2019,Ball State,2,4,6,0.3333333333333333
vs. Conference,2019,Ball State,4,4,8,0.5
vs. Non-Conference,2019,Ball State,1,3,4,0.25
vs. Ranked (AP),2019,Ball State,0,0,0,
vs. Unranked (AP),2019,Ball State,5,7,12,0.4166666666666667
vs. FBS (I-A),2019,Ball State,4,7,11,0.36363636363636365
vs. FCS (I-AA),2019,Ball State,1,0,1,1.0
vs. FBS Winning,2019,Ball State,1,6,7,0.14285714285714285
vs. FBS Non-Winning,2019,Ball State,3,1,4,0.75
vs. BCS AQ,2019,Ball State,0,2,2,0.0
vs. BCS non-AQ,2019,Ball State,4,5,9,0.4444444444444444
vs. FBS Power 5,2019,Ball State,0,2,2,0.0
vs. FBS non-Power 5,2019,Ball State,4,5,9,0.4444444444444444
in August/September,2019,Ball State,1,3,4,0.25
in October,2019,Ball State,3,1,4,0.75
in November,2019,Ball State,1,3,4,0.25
in December/January,2019,Ball State,0,0,0,
All Games,2020,Ball State,7,1,8,0.875
at Home,2020,Ball State,3,0,3,1.0
on Road/Neutral Site,2020,Ball State,4,1,5,0.8
vs. Conference,2020,Ball State,6,1,7,0.8571428571428571
vs. Non-Conference,2020,Ball State,1,0,1,1.0
vs. Ranked (AP),2020,Ball State,1,0,1,1.0
vs. Unranked (AP),2020,Ball State,6,1,7,0.8571428571428571
vs. FBS (I-A),2020,Ball State,7,1,8,0.875
vs. FCS (I-AA),2020,Ball State,0,0,0,
vs. FBS Winning,2020,Ball State,4,1,5,0.8
vs. FBS Non-Winning,2020,Ball State,3,0,3,1.0
vs. BCS AQ,2020,Ball State,0,0,0,
vs. BCS non-AQ,2020,Ball State,7,1,8,0.875
vs. FBS Power 5,2020,Ball State,0,0,0,
vs. FBS non-Power 5,2020,Ball State,7,1,8,0.875
in August/September,2020,Ball State,0,0,0,
in October,2020,Ball State,0,0,0,
in November,2020,Ball State,3,1,4,0.75
in December/January,2020,Ball State,4,0,4,1.0
All Games,2021,Ball State,6,7,13,0.46153846153846156
at Home,2021,Ball State,3,3,6,0.5
on Road/Neutral Site,2021,Ball State,3,4,7,0.42857142857142855
vs. Conference,2021,Ball State,4,4,8,0.5
vs. Non-Conference,2021,Ball State,2,3,5,0.4
vs. Ranked (AP),2021,Ball State,0,0,0,
vs. Unranked (AP),2021,Ball State,6,7,13,0.46153846153846156
vs. FBS (I-A),2021,Ball State,5,7,12,0.4166666666666667
vs. FCS (I-AA),2021,Ball State,1,0,1,1.0
vs. FBS Winning,2021,Ball State,3,7,10,0.3
vs. FBS Non-Winning,2021,Ball State,2,0,2,1.0
vs. BCS AQ,2021,Ball State,0,1,1,0.0
vs. BCS non-AQ,2021,Ball State,5,6,11,0.45454545454545453
vs. FBS Power 5,2021,Ball State,0,1,1,0.0
vs. FBS non-Power 5,2021,Ball State,5,6,11,0.45454545454545453
in August/September,2021,Ball State,1,3,4,0.25
in October,2021,Ball State,3,1,4,0.75
in November,2021,Ball State,2,2,4,0.5
in December/January,2021,Ball State,0,1,1,0.0
All Games,2022,Ball State,5,7,12,0.4166666666666667
at Home,2022,Ball State,3,3,6,0.5
on Road/Neutral Site,2022,Ball State,2,4,6,0.3333333333333333
vs. Conference,2022,Ball State,3,5,8,0.375
vs. Non-Conference,2022,Ball State,2,2,4,0.5
vs. Ranked (AP),2022,Ball State,0,1,1,0.0
vs. Unranked (AP),2022,Ball State,5,6,11,0.45454545454545453
vs. FBS (I-A),2022,Ball State,4,7,11,0.36363636363636365
vs. FCS (I-AA),2022,Ball State,1,0,1,1.0
vs. FBS Winning,2022,Ball State,0,4,4,0.0
vs. FBS Non-Winning,2022,Ball State,4,3,7,0.5714285714285714
vs. BCS AQ,2022,Ball State,0,1,1,0.0
vs. BCS non-AQ,2022,Ball State,4,6,10,0.4
vs. FBS Power 5,2022,Ball State,0,1,1,0.0
vs. FBS non-Power 5,2022,Ball State,4,6,10,0.4
in August/September,2022,Ball State,1,3,4,0.25
in October,2022,Ball State,3,1,4,0.75
in November,2022,Ball State,1,3,4,0.25
in December/January,2022,Ball State,0,0,0,
All Games,2009,Baylor,4,8,12,0.3333333333333333
at Home,2009,Baylor,2,5,7,0.2857142857142857
on Road/Neutral Site,2009,Baylor,2,3,5,0.4
vs. Conference,2009,Baylor,1,7,8,0.125
vs. Non-Conference,2009,Baylor,3,1,4,0.75
vs. Ranked (AP),2009,Baylor,0,3,3,0.0
vs. Unranked (AP),2009,Baylor,4,5,9,0.4444444444444444
vs. FBS (I-A),2009,Baylor,3,8,11,0.2727272727272727
vs. FCS (I-AA),2009,Baylor,1,0,1,1.0
vs. FBS Winning,2009,Baylor,1,7,8,0.125
vs. FBS Non-Winning,2009,Baylor,2,1,3,0.6666666666666666
vs. BCS AQ,2009,Baylor,2,8,10,0.2
vs. BCS non-AQ,2009,Baylor,1,0,1,1.0
vs. FBS Power 5,2009,Baylor,2,7,9,0.2222222222222222
vs. FBS non-Power 5,2009,Baylor,1,1,2,0.5
in August/September,2009,Baylor,2,1,3,0.6666666666666666
in October,2009,Baylor,1,4,5,0.2
in November,2009,Baylor,1,3,4,0.25
in December/January,2009,Baylor,0,0,0,
All Games,2010,Baylor,7,6,13,0.5384615384615384
at Home,2010,Baylor,4,2,6,0.6666666666666666
on Road/Neutral Site,2010,Baylor,3,4,7,0.42857142857142855
vs. Conference,2010,Baylor,4,4,8,0.5
vs. Non-Conference,2010,Baylor,3,2,5,0.6
vs. Ranked (AP),2010,Baylor,0,4,4,0.0
vs. Unranked (AP),2010,Baylor,7,2,9,0.7777777777777778
vs. FBS (I-A),2010,Baylor,6,6,12,0.5
vs. FCS (I-AA),2010,Baylor,1,0,1,1.0
vs. FBS Winning,2010,Baylor,1,6,7,0.14285714285714285
vs. FBS Non-Winning,2010,Baylor,5,0,5,1.0
vs. BCS AQ,2010,Baylor,4,5,9,0.4444444444444444
vs. BCS non-AQ,2010,Baylor,2,1,3,0.6666666666666666
vs. FBS Power 5,2010,Baylor,4,5,9,0.4444444444444444
vs. FBS non-Power 5,2010,Baylor,2,1,3,0.6666666666666666
in August/September,2010,Baylor,3,1,4,0.75
in October,2010,Baylor,4,1,5,0.8
in November,2010,Baylor,0,3,3,0.0
in December/January,2010,Baylor,0,1,1,0.0
All Games,2011,Baylor,10,3,13,0.7692307692307693
at Home,2011,Baylor,7,0,7,1.0
on Road/Neutral Site,2011,Baylor,3,3,6,0.5
vs. Conference,2011,Baylor,6,3,9,0.6666666666666666
vs. Non-Conference,2011,Baylor,4,0,4,1.0
vs. Ranked (AP),2011,Baylor,2,2,4,0.5
vs. Unranked (AP),2011,Baylor,8,1,9,0.8888888888888888
vs. FBS (I-A),2011,Baylor,9,3,12,0.75
vs. FCS (I-AA),2011,Baylor,1,0,1,1.0
vs. FBS Winning,2011,Baylor,5,3,8,0.625
vs. FBS Non-Winning,2011,Baylor,4,0,4,1.0
vs. BCS AQ,2011,Baylor,7,3,10,0.7
vs. BCS non-AQ,2011,Baylor,2,0,2,1.0
vs. FBS Power 5,2011,Baylor,7,3,10,0.7
vs. FBS non-Power 5,2011,Baylor,2,0,2,1.0
in August/September,2011,Baylor,3,0,3,1.0
in October,2011,Baylor,1,3,4,0.25
in November,2011,Baylor,4,0,4,1.0
in December/January,2011,Baylor,2,0,2,1.0
All Games,2012,Baylor,8,5,13,0.6153846153846154
at Home,2012,Baylor,5,1,6,0.8333333333333334
on Road/Neutral Site,2012,Baylor,3,4,7,0.42857142857142855
vs. Conference,2012,Baylor,4,5,9,0.4444444444444444
vs. Non-Conference,2012,Baylor,4,0,4,1.0
vs. Ranked (AP),2012,Baylor,1,2,3,0.3333333333333333
vs. Unranked (AP),2012,Baylor,7,3,10,0.7
vs. FBS (I-A),2012,Baylor,7,5,12,0.5833333333333334
vs. FCS (I-AA),2012,Baylor,1,0,1,1.0
vs. FBS Winning,2012,Baylor,6,4,10,0.6
vs. FBS Non-Winning,2012,Baylor,1,1,2,0.5
vs. BCS AQ,2012,Baylor,5,5,10,0.5
vs. BCS non-AQ,2012,Baylor,2,0,2,1.0
vs. FBS Power 5,2012,Baylor,5,5,10,0.5
vs. FBS non-Power 5,2012,Baylor,2,0,2,1.0
in August/September,2012,Baylor,3,1,4,0.75
in October,2012,Baylor,0,3,3,0.0
in November,2012,Baylor,3,1,4,0.75
in December/January,2012,Baylor,2,0,2,1.0
All Games,2013,Baylor,11,2,13,0.8461538461538461
at Home,2013,Baylor,7,0,7,1.0
on Road/Neutral Site,2013,Baylor,4,2,6,0.6666666666666666
vs. Conference,2013,Baylor,8,1,9,0.8888888888888888
vs. Non-Conference,2013,Baylor,3,1,4,0.75
vs. Ranked (AP),2013,Baylor,1,2,3,0.3333333333333333
vs. Unranked (AP),2013,Baylor,10,0,10,1.0
vs. FBS (I-A),2013,Baylor,10,2,12,0.8333333333333334
vs. FCS (I-AA),2013,Baylor,1,0,1,1.0
vs. FBS Winning,2013,Baylor,5,2,7,0.7142857142857143
vs. FBS Non-Winning,2013,Baylor,5,0,5,1.0
vs. BCS AQ,2013,Baylor,8,2,10,0.8
vs. BCS non-AQ,2013,Baylor,2,0,2,1.0
vs. FBS Power 5,2013,Baylor,8,1,9,0.8888888888888888
vs. FBS non-Power 5,2013,Baylor,2,1,3,0.6666666666666666
in August/September,2013,Baylor,3,0,3,1.0
in October,2013,Baylor,4,0,4,1.0
in November,2013,Baylor,3,1,4,0.75
in December/January,2013,Baylor,1,1,2,0.5
All Games,2014,Baylor,11,2,13,0.8461538461538461
at Home,2014,Baylor,6,0,6,1.0
on Road/Neutral Site,2014,Baylor,5,2,7,0.7142857142857143
vs. Conference,2014,Baylor,8,1,9,0.8888888888888888
vs. Non-Conference,2014,Baylor,3,1,4,0.75
vs. Ranked (AP),2014,Baylor,2,1,3,0.6666666666666666
vs. Unranked (AP),2014,Baylor,9,1,10,0.9
vs. FBS (I-A),2014,Baylor,10,2,12,0.8333333333333334
vs. FCS (I-AA),2014,Baylor,1,0,1,1.0
vs. FBS Winning,2014,Baylor,4,2,6,0.6666666666666666
vs. FBS Non-Winning,2014,Baylor,6,0,6,1.0
vs. BCS AQ,2014,Baylor,9,2,11,0.8181818181818182
vs. BCS non-AQ,2014,Baylor,1,0,1,1.0
vs. FBS Power 5,2014,Baylor,8,2,10,0.8
vs. FBS non-Power 5,2014,Baylor,2,0,2,1.0
in August/September,2014,Baylor,4,0,4,1.0
in October,2014,Baylor,2,1,3,0.6666666666666666
in November,2014,Baylor,4,0,4,1.0
in December/January,2014,Baylor,1,1,2,0.5
All Games,2015,Baylor,10,3,13,0.7692307692307693
at Home,2015,Baylor,4,2,6,0.6666666666666666
on Road/Neutral Site,2015,Baylor,6,1,7,0.8571428571428571
vs. Conference,2015,Baylor,6,3,9,0.6666666666666666
vs. Non-Conference,2015,Baylor,4,0,4,1.0
vs. Ranked (AP),2015,Baylor,2,2,4,0.5
vs. Unranked (AP),2015,Baylor,8,1,9,0.8888888888888888
vs. FBS (I-A),2015,Baylor,9,3,12,0.75
vs. FCS (I-AA),2015,Baylor,1,0,1,1.0
vs. FBS Winning,2015,Baylor,4,2,6,0.6666666666666666
vs. FBS Non-Winning,2015,Baylor,5,1,6,0.8333333333333334
vs. BCS AQ,2015,Baylor,8,3,11,0.7272727272727273
vs. BCS non-AQ,2015,Baylor,1,0,1,1.0
vs. FBS Power 5,2015,Baylor,7,3,10,0.7
vs. FBS non-Power 5,2015,Baylor,2,0,2,1.0
in August/September,2015,Baylor,3,0,3,1.0
in October,2015,Baylor,4,0,4,1.0
in November,2015,Baylor,2,2,4,0.5
in December/January,2015,Baylor,1,1,2,0.5
All Games,2016,Baylor,7,6,13,0.5384615384615384
at Home,2016,Baylor,4,2,6,0.6666666666666666
on Road/Neutral Site,2016,Baylor,3,4,7,0.42857142857142855
vs. Conference,2016,Baylor,3,6,9,0.3333333333333333
vs. Non-Conference,2016,Baylor,4,0,4,1.0
vs. Ranked (AP),2016,Baylor,1,2,3,0.3333333333333333
vs. Unranked (AP),2016,Baylor,6,4,10,0.6
vs. FBS (I-A),2016,Baylor,6,6,12,0.5
vs. FCS (I-AA),2016,Baylor,1,0,1,1.0
vs. FBS Winning,2016,Baylor,2,3,5,0.4
vs. FBS Non-Winning,2016,Baylor,4,3,7,0.5714285714285714
vs. BCS AQ,2016,Baylor,4,6,10,0.4
vs. BCS non-AQ,2016,Baylor,2,0,2,1.0
vs. FBS Power 5,2016,Baylor,3,6,9,0.3333333333333333
vs. FBS non-Power 5,2016,Baylor,3,0,3,1.0
in August/September,2016,Baylor,4,0,4,1.0
in October,2016,Baylor,2,1,3,0.6666666666666666
in November,2016,Baylor,0,4,4,0.0
in December/January,2016,Baylor,1,1,2,0.5
All Games,2017,Baylor,1,11,12,0.08333333333333333
at Home,2017,Baylor,0,6,6,0.0
on Road/Neutral Site,2017,Baylor,1,5,6,0.16666666666666666
vs. Conference,2017,Baylor,1,8,9,0.1111111111111111
vs. Non-Conference,2017,Baylor,0,3,3,0.0
vs. Ranked (AP),2017,Baylor,0,3,3,0.0
vs. Unranked (AP),2017,Baylor,1,8,9,0.1111111111111111
vs. FBS (I-A),2017,Baylor,1,10,11,0.09090909090909091
vs. FCS (I-AA),2017,Baylor,0,1,1,0.0
vs. FBS Winning,2017,Baylor,0,9,9,0.0
vs. FBS Non-Winning,2017,Baylor,1,1,2,0.5
vs. BCS AQ,2017,Baylor,1,9,10,0.1
vs. BCS non-AQ,2017,Baylor,0,1,1,0.0
vs. FBS Power 5,2017,Baylor,1,9,10,0.1
vs. FBS non-Power 5,2017,Baylor,0,1,1,0.0
in August/September,2017,Baylor,0,5,5,0.0
in October,2017,Baylor,0,3,3,0.0
in November,2017,Baylor,1,3,4,0.25
in December/January,2017,Baylor,0,0,0,
All Games,2018,Baylor,7,6,13,0.5384615384615384
at Home,2018,Baylor,4,2,6,0.6666666666666666
on Road/Neutral Site,2018,Baylor,3,4,7,0.42857142857142855
vs. Conference,2018,Baylor,4,5,9,0.4444444444444444
vs. Non-Conference,2018,Baylor,3,1,4,0.75
vs. Ranked (AP),2018,Baylor,0,3,3,0.0
vs. Unranked (AP),2018,Baylor,7,3,10,0.7
vs. FBS (I-A),2018,Baylor,6,6,12,0.5
vs. FCS (I-AA),2018,Baylor,1,0,1,1.0
vs. FBS Winning,2018,Baylor,1,6,7,0.14285714285714285
vs. FBS Non-Winning,2018,Baylor,5,0,5,1.0
vs. BCS AQ,2018,Baylor,5,6,11,0.45454545454545453
vs. BCS non-AQ,2018,Baylor,1,0,1,1.0
vs. FBS Power 5,2018,Baylor,5,6,11,0.45454545454545453
vs. FBS non-Power 5,2018,Baylor,1,0,1,1.0
in August/September,2018,Baylor,3,2,5,0.6
in October,2018,Baylor,1,2,3,0.3333333333333333
in November,2018,Baylor,2,2,4,0.5
in December/January,2018,Baylor,1,0,1,1.0
All Games,2019,Baylor,11,3,14,0.7857142857142857
at Home,2019,Baylor,6,1,7,0.8571428571428571
on Road/Neutral Site,2019,Baylor,5,2,7,0.7142857142857143
vs. Conference,2019,Baylor,8,2,10,0.8
vs. Non-Conference,2019,Baylor,3,1,4,0.75
vs. Ranked (AP),2019,Baylor,1,3,4,0.25
vs. Unranked (AP),2019,Baylor,10,0,10,1.0
vs. FBS (I-A),2019,Baylor,10,3,13,0.7692307692307693
vs. FCS (I-AA),2019,Baylor,1,0,1,1.0
vs. FBS Winning,2019,Baylor,4,3,7,0.5714285714285714
vs. FBS Non-Winning,2019,Baylor,6,0,6,1.0
vs. BCS AQ,2019,Baylor,8,3,11,0.7272727272727273
vs. BCS non-AQ,2019,Baylor,2,0,2,1.0
vs. FBS Power 5,2019,Baylor,8,3,11,0.7272727272727273
vs. FBS non-Power 5,2019,Baylor,2,0,2,1.0
in August/September,2019,Baylor,4,0,4,1.0
in October,2019,Baylor,4,0,4,1.0
in November,2019,Baylor,3,1,4,0.75
in December/January,2019,Baylor,0,2,2,0.0
All Games,2020,Baylor,2,7,9,0.2222222222222222
at Home,2020,Baylor,2,2,4,0.5
on Road/Neutral Site,2020,Baylor,0,5,5,0.0
vs. Conference,2020,Baylor,2,7,9,0.2222222222222222
vs. Non-Conference,2020,Baylor,0,0,0,
vs. Ranked (AP),2020,Baylor,0,3,3,0.0
vs. Unranked (AP),2020,Baylor,2,4,6,0.3333333333333333
vs. FBS (I-A),2020,Baylor,2,7,9,0.2222222222222222
vs. FCS (I-AA),2020,Baylor,0,0,0,
vs. FBS Winning,2020,Baylor,0,6,6,0.0
vs. FBS Non-Winning,2020,Baylor,2,1,3,0.6666666666666666
vs. BCS AQ,2020,Baylor,2,7,9,0.2222222222222222
vs. BCS non-AQ,2020,Baylor,0,0,0,
vs. FBS Power 5,2020,Baylor,2,7,9,0.2222222222222222
vs. FBS non-Power 5,2020,Baylor,0,0,0,
in August/September,2020,Baylor,1,0,1,1.0
in October,2020,Baylor,0,3,3,0.0
in November,2020,Baylor,1,2,3,0.3333333333333333
in December/January,2020,Baylor,0,2,2,0.0
All Games,2021,Baylor,12,2,14,0.8571428571428571
at Home,2021,Baylor,7,0,7,1.0
on Road/Neutral Site,2021,Baylor,5,2,7,0.7142857142857143
vs. Conference,2021,Baylor,8,2,10,0.8
vs. Non-Conference,2021,Baylor,4,0,4,1.0
vs. Ranked (AP),2021,Baylor,4,1,5,0.8
vs. Unranked (AP),2021,Baylor,8,1,9,0.8888888888888888
vs. FBS (I-A),2021,Baylor,11,2,13,0.8461538461538461
vs. FCS (I-AA),2021,Baylor,1,0,1,1.0
vs. FBS Winning,2021,Baylor,7,1,8,0.875
vs. FBS Non-Winning,2021,Baylor,4,1,5,0.8
vs. BCS AQ,2021,Baylor,9,2,11,0.8181818181818182
vs. BCS non-AQ,2021,Baylor,2,0,2,1.0
vs. FBS Power 5,2021,Baylor,9,2,11,0.8181818181818182
vs. FBS non-Power 5,2021,Baylor,2,0,2,1.0
in August/September,2021,Baylor,4,0,4,1.0
in October,2021,Baylor,3,1,4,0.75
in November,2021,Baylor,3,1,4,0.75
in December/January,2021,Baylor,2,0,2,1.0
All Games,2022,Baylor,6,7,13,0.46153846153846156
at Home,2022,Baylor,3,3,6,0.5
on Road/Neutral Site,2022,Baylor,3,4,7,0.42857142857142855
vs. Conference,2022,Baylor,4,5,9,0.4444444444444444
vs. Non-Conference,2022,Baylor,2,2,4,0.5
vs. Ranked (AP),2022,Baylor,0,3,3,0.0
vs. Unranked (AP),2022,Baylor,6,4,10,0.6
vs. FBS (I-A),2022,Baylor,5,7,12,0.4166666666666667
vs. FCS (I-AA),2022,Baylor,1,0,1,1.0
vs. FBS Winning,2022,Baylor,1,6,7,0.14285714285714285
vs. FBS Non-Winning,2022,Baylor,4,1,5,0.8
vs. BCS AQ,2022,Baylor,4,5,9,0.4444444444444444
vs. BCS non-AQ,2022,Baylor,1,2,3,0.3333333333333333
vs. FBS Power 5,2022,Baylor,4,5,9,0.4444444444444444
vs. FBS non-Power 5,2022,Baylor,1,2,3,0.3333333333333333
in August/September,2022,Baylor,3,1,4,0.75
in October,2022,Baylor,2,2,4,0.5
in November,2022,Baylor,1,3,4,0.25
in December/January,2022,Baylor,0,1,1,0.0
All Games,2009,Boise State,14,0,14,1.0
at Home,2009,Boise State,7,0,7,1.0
on Road/Neutral Site,2009,Boise State,7,0,7,1.0
vs. Conference,2009,Boise State,8,0,8,1.0
vs. Non-Conference,2009,Boise State,6,0,6,1.0
vs. Ranked (AP),2009,Boise State,2,0,2,1.0
vs. Unranked (AP),2009,Boise State,12,0,12,1.0
vs. FBS (I-A),2009,Boise State,13,0,13,1.0
vs. FCS (I-AA),2009,Boise State,1,0,1,1.0
vs. FBS Winning,2009,Boise State,6,0,6,1.0
vs. FBS Non-Winning,2009,Boise State,7,0,7,1.0
vs. BCS AQ,2009,Boise State,1,0,1,1.0
vs. BCS non-AQ,2009,Boise State,12,0,12,1.0
vs. FBS Power 5,2009,Boise State,1,0,1,1.0
vs. FBS non-Power 5,2009,Boise State,12,0,12,1.0
in August/September,2009,Boise State,4,0,4,1.0
in October,2009,Boise State,4,0,4,1.0
in November,2009,Boise State,4,0,4,1.0
in December/January,2009,Boise State,2,0,2,1.0
All Games,2010,Boise State,12,1,13,0.9230769230769231
at Home,2010,Boise State,6,0,6,1.0
on Road/Neutral Site,2010,Boise State,6,1,7,0.8571428571428571
vs. Conference,2010,Boise State,7,1,8,0.875
vs. Non-Conference,2010,Boise State,5,0,5,1.0
vs. Ranked (AP),2010,Boise State,1,1,2,0.5
vs. Unranked (AP),2010,Boise State,11,0,11,1.0
vs. FBS (I-A),2010,Boise State,12,1,13,0.9230769230769231
vs. FCS (I-AA),2010,Boise State,0,0,0,
vs. FBS Winning,2010,Boise State,5,1,6,0.8333333333333334
vs. FBS Non-Winning,2010,Boise State,7,0,7,1.0
vs. BCS AQ,2010,Boise State,2,0,2,1.0
vs. BCS non-AQ,2010,Boise State,10,1,11,0.9090909090909091
vs. FBS Power 5,2010,Boise State,2,0,2,1.0
vs. FBS non-Power 5,2010,Boise State,10,1,11,0.9090909090909091
in August/September,2010,Boise State,3,0,3,1.0
in October,2010,Boise State,4,0,4,1.0
in November,2010,Boise State,3,1,4,0.75
in December/January,2010,Boise State,2,0,2,1.0
All Games,2011,Boise State,12,1,13,0.9230769230769231
at Home,2011,Boise State,5,1,6,0.8333333333333334
on Road/Neutral Site,2011,Boise State,7,0,7,1.0
vs. Conference,2011,Boise State,6,1,7,0.8571428571428571
vs. Non-Conference,2011,Boise State,6,0,6,1.0
vs. Ranked (AP),2011,Boise State,1,1,2,0.5
vs. Unranked (AP),2011,Boise State,11,0,11,1.0
vs. FBS (I-A),2011,Boise State,12,1,13,0.9230769230769231
vs. FCS (I-AA),2011,Boise State,0,0,0,
vs. FBS Winning,2011,Boise State,7,1,8,0.875
vs. FBS Non-Winning,2011,Boise State,5,0,5,1.0
vs. BCS AQ,2011,Boise State,2,0,2,1.0
vs. BCS non-AQ,2011,Boise State,10,1,11,0.9090909090909091
vs. FBS Power 5,2011,Boise State,2,0,2,1.0
vs. FBS non-Power 5,2011,Boise State,10,1,11,0.9090909090909091
in August/September,2011,Boise State,3,0,3,1.0
in October,2011,Boise State,4,0,4,1.0
in November,2011,Boise State,3,1,4,0.75
in December/January,2011,Boise State,2,0,2,1.0
All Games,2012,Boise State,11,2,13,0.8461538461538461
at Home,2012,Boise State,5,1,6,0.8333333333333334
on Road/Neutral Site,2012,Boise State,6,1,7,0.8571428571428571
vs. Conference,2012,Boise State,7,1,8,0.875
vs. Non-Conference,2012,Boise State,4,1,5,0.8
vs. Ranked (AP),2012,Boise State,0,0,0,
vs. Unranked (AP),2012,Boise State,11,2,13,0.8461538461538461
vs. FBS (I-A),2012,Boise State,11,2,13,0.8461538461538461
vs. FCS (I-AA),2012,Boise State,0,0,0,
vs. FBS Winning,2012,Boise State,4,2,6,0.6666666666666666
vs. FBS Non-Winning,2012,Boise State,7,0,7,1.0
vs. BCS AQ,2012,Boise State,1,1,2,0.5
vs. BCS non-AQ,2012,Boise State,10,1,11,0.9090909090909091
vs. FBS Power 5,2012,Boise State,1,1,2,0.5
vs. FBS non-Power 5,2012,Boise State,10,1,11,0.9090909090909091
in August/September,2012,Boise State,3,1,4,0.75
in October,2012,Boise State,4,0,4,1.0
in November,2012,Boise State,2,1,3,0.6666666666666666
in December/January,2012,Boise State,2,0,2,1.0
All Games,2013,Boise State,8,5,13,0.6153846153846154
at Home,2013,Boise State,6,0,6,1.0
on Road/Neutral Site,2013,Boise State,2,5,7,0.2857142857142857
vs. Conference,2013,Boise State,6,2,8,0.75
vs. Non-Conference,2013,Boise State,2,3,5,0.4
vs. Ranked (AP),2013,Boise State,0,1,1,0.0
vs. Unranked (AP),2013,Boise State,8,4,12,0.6666666666666666
vs. FBS (I-A),2013,Boise State,7,5,12,0.5833333333333334
vs. FCS (I-AA),2013,Boise State,1,0,1,1.0
vs. FBS Winning,2013,Boise State,2,5,7,0.2857142857142857
vs. FBS Non-Winning,2013,Boise State,5,0,5,1.0
vs. BCS AQ,2013,Boise State,0,2,2,0.0
vs. BCS non-AQ,2013,Boise State,7,3,10,0.7
vs. FBS Power 5,2013,Boise State,0,2,2,0.0
vs. FBS non-Power 5,2013,Boise State,7,3,10,0.7
in August/September,2013,Boise State,3,2,5,0.6
in October,2013,Boise State,2,1,3,0.6666666666666666
in November,2013,Boise State,3,1,4,0.75
in December/January,2013,Boise State,0,1,1,0.0
All Games,2014,Boise State,12,2,14,0.8571428571428571
at Home,2014,Boise State,7,0,7,1.0
on Road/Neutral Site,2014,Boise State,5,2,7,0.7142857142857143
vs. Conference,2014,Boise State,8,1,9,0.8888888888888888
vs. Non-Conference,2014,Boise State,4,1,5,0.8
vs. Ranked (AP),2014,Boise State,1,1,2,0.5
vs. Unranked (AP),2014,Boise State,11,1,12,0.9166666666666666
vs. FBS (I-A),2014,Boise State,12,2,14,0.8571428571428571
vs. FCS (I-AA),2014,Boise State,0,0,0,
vs. FBS Winning,2014,Boise State,7,2,9,0.7777777777777778
vs. FBS Non-Winning,2014,Boise State,5,0,5,1.0
vs. BCS AQ,2014,Boise State,2,1,3,0.6666666666666666
vs. BCS non-AQ,2014,Boise State,10,1,11,0.9090909090909091
vs. FBS Power 5,2014,Boise State,1,1,2,0.5
vs. FBS non-Power 5,2014,Boise State,11,1,12,0.9166666666666666
in August/September,2014,Boise State,3,2,5,0.6
in October,2014,Boise State,3,0,3,1.0
in November,2014,Boise State,4,0,4,1.0
in December/January,2014,Boise State,2,0,2,1.0
All Games,2015,Boise State,9,4,13,0.6923076923076923
at Home,2015,Boise State,4,2,6,0.6666666666666666
on Road/Neutral Site,2015,Boise State,5,2,7,0.7142857142857143
vs. Conference,2015,Boise State,5,3,8,0.625
vs. Non-Conference,2015,Boise State,4,1,5,0.8
vs. Ranked (AP),2015,Boise State,0,0,0,
vs. Unranked (AP),2015,Boise State,9,4,13,0.6923076923076923
vs. FBS (I-A),2015,Boise State,8,4,12,0.6666666666666666
vs. FCS (I-AA),2015,Boise State,1,0,1,1.0
vs. FBS Winning,2015,Boise State,3,3,6,0.5
vs. FBS Non-Winning,2015,Boise State,5,1,6,0.8333333333333334
vs. BCS AQ,2015,Boise State,2,0,2,1.0
vs. BCS non-AQ,2015,Boise State,6,4,10,0.6
vs. FBS Power 5,2015,Boise State,2,0,2,1.0
vs. FBS non-Power 5,2015,Boise State,6,4,10,0.6
in August/September,2015,Boise State,3,1,4,0.75
in October,2015,Boise State,4,1,5,0.8
in November,2015,Boise State,1,2,3,0.3333333333333333
in December/January,2015,Boise State,1,0,1,1.0
All Games,2016,Boise State,10,3,13,0.7692307692307693
at Home,2016,Boise State,6,0,6,1.0
on Road/Neutral Site,2016,Boise State,4,3,7,0.5714285714285714
vs. Conference,2016,Boise State,6,2,8,0.75
vs. Non-Conference,2016,Boise State,4,1,5,0.8
vs. Ranked (AP),2016,Boise State,0,0,0,
vs. Unranked (AP),2016,Boise State,10,3,13,0.7692307692307693
vs. FBS (I-A),2016,Boise State,10,3,13,0.7692307692307693
vs. FCS (I-AA),2016,Boise State,0,0,0,
vs. FBS Winning,2016,Boise State,4,3,7,0.5714285714285714
vs. FBS Non-Winning,2016,Boise State,6,0,6,1.0
vs. BCS AQ,2016,Boise State,2,1,3,0.6666666666666666
vs. BCS non-AQ,2016,Boise State,8,2,10,0.8
vs. FBS Power 5,2016,Boise State,2,1,3,0.6666666666666666
vs. FBS non-Power 5,2016,Boise State,8,2,10,0.8
in August/September,2016,Boise State,3,0,3,1.0
in October,2016,Boise State,4,1,5,0.8
in November,2016,Boise State,3,1,4,0.75
in December/January,2016,Boise State,0,1,1,0.0
All Games,2017,Boise State,11,3,14,0.7857142857142857
at Home,2017,Boise State,6,1,7,0.8571428571428571
on Road/Neutral Site,2017,Boise State,5,2,7,0.7142857142857143
vs. Conference,2017,Boise State,8,1,9,0.8888888888888888
vs. Non-Conference,2017,Boise State,3,2,5,0.6
vs. Ranked (AP),2017,Boise State,0,0,0,
vs. Unranked (AP),2017,Boise State,11,3,14,0.7857142857142857
vs. FBS (I-A),2017,Boise State,11,3,14,0.7857142857142857
vs. FCS (I-AA),2017,Boise State,0,0,0,
vs. FBS Winning,2017,Boise State,6,2,8,0.75
vs. FBS Non-Winning,2017,Boise State,5,1,6,0.8333333333333334
vs. BCS AQ,2017,Boise State,1,2,3,0.3333333333333333
vs. BCS non-AQ,2017,Boise State,10,1,11,0.9090909090909091
vs. FBS Power 5,2017,Boise State,1,2,3,0.3333333333333333
vs. FBS non-Power 5,2017,Boise State,10,1,11,0.9090909090909091
in August/September,2017,Boise State,2,2,4,0.5
in October,2017,Boise State,4,0,4,1.0
in November,2017,Boise State,3,1,4,0.75
in December/January,2017,Boise State,2,0,2,1.0
All Games,2018,Boise State,10,3,13,0.7692307692307693
at Home,2018,Boise State,5,2,7,0.7142857142857143
on Road/Neutral Site,2018,Boise State,5,1,6,0.8333333333333334
vs. Conference,2018,Boise State,7,2,9,0.7777777777777778
vs. Non-Conference,2018,Boise State,3,1,4,0.75
vs. Ranked (AP),2018,Boise State,2,1,3,0.6666666666666666
vs. Unranked (AP),2018,Boise State,8,2,10,0.8
vs. FBS (I-A),2018,Boise State,10,3,13,0.7692307692307693
vs. FCS (I-AA),2018,Boise State,0,0,0,
vs. FBS Winning,2018,Boise State,5,3,8,0.625
vs. FBS Non-Winning,2018,Boise State,5,0,5,1.0
vs. BCS AQ,2018,Boise State,1,1,2,0.5
vs. BCS non-AQ,2018,Boise State,9,2,11,0.8181818181818182
vs. FBS Power 5,2018,Boise State,0,1,1,0.0
vs. FBS non-Power 5,2018,Boise State,10,2,12,0.8333333333333334
in August/September,2018,Boise State,3,1,4,0.75
in October,2018,Boise State,3,1,4,0.75
in November,2018,Boise State,4,0,4,1.0
in December/January,2018,Boise State,0,1,1,0.0
All Games,2019,Boise State,12,2,14,0.8571428571428571
at Home,2019,Boise State,7,0,7,1.0
on Road/Neutral Site,2019,Boise State,5,2,7,0.7142857142857143
vs. Conference,2019,Boise State,9,0,9,1.0
vs. Non-Conference,2019,Boise State,3,2,5,0.6
vs. Ranked (AP),2019,Boise State,1,0,1,1.0
vs. Unranked (AP),2019,Boise State,11,2,13,0.8461538461538461
vs. FBS (I-A),2019,Boise State,11,2,13,0.8461538461538461
vs. FCS (I-AA),2019,Boise State,1,0,1,1.0
vs. FBS Winning,2019,Boise State,6,2,8,0.75
vs. FBS Non-Winning,2019,Boise State,5,0,5,1.0
vs. BCS AQ,2019,Boise State,1,1,2,0.5
vs. BCS non-AQ,2019,Boise State,10,1,11,0.9090909090909091
vs. FBS Power 5,2019,Boise State,1,1,2,0.5
vs. FBS non-Power 5,2019,Boise State,10,1,11,0.9090909090909091
in August/September,2019,Boise State,4,0,4,1.0
in October,2019,Boise State,2,1,3,0.6666666666666666
in November,2019,Boise State,5,0,5,1.0
in December/January,2019,Boise State,1,1,2,0.5
All Games,2020,Boise State,5,2,7,0.7142857142857143
at Home,2020,Boise State,2,1,3,0.6666666666666666
on Road/Neutral Site,2020,Boise State,3,1,4,0.75
vs. Conference,2020,Boise State,5,1,6,0.8333333333333334
vs. Non-Conference,2020,Boise State,0,1,1,0.0
vs. Ranked (AP),2020,Boise State,0,2,2,0.0
vs. Unranked (AP),2020,Boise State,5,0,5,1.0
vs. FBS (I-A),2020,Boise State,5,2,7,0.7142857142857143
vs. FCS (I-AA),2020,Boise State,0,0,0,
vs. FBS Winning,2020,Boise State,1,2,3,0.3333333333333333
vs. FBS Non-Winning,2020,Boise State,4,0,4,1.0
vs. BCS AQ,2020,Boise State,0,0,0,
vs. BCS non-AQ,2020,Boise State,5,2,7,0.7142857142857143
vs. FBS Power 5,2020,Boise State,0,0,0,
vs. FBS non-Power 5,2020,Boise State,5,2,7,0.7142857142857143
in August/September,2020,Boise State,0,0,0,
in October,2020,Boise State,2,0,2,1.0
in November,2020,Boise State,2,1,3,0.6666666666666666
in December/January,2020,Boise State,1,1,2,0.5
All Games,2021,Boise State,7,5,12,0.5833333333333334
at Home,2021,Boise State,3,3,6,0.5
on Road/Neutral Site,2021,Boise State,4,2,6,0.6666666666666666
vs. Conference,2021,Boise State,5,3,8,0.625
vs. Non-Conference,2021,Boise State,2,2,4,0.5
vs. Ranked (AP),2021,Boise State,2,2,4,0.5
vs. Unranked (AP),2021,Boise State,5,3,8,0.625
vs. FBS (I-A),2021,Boise State,7,5,12,0.5833333333333334
vs. FCS (I-AA),2021,Boise State,0,0,0,
vs. FBS Winning,2021,Boise State,5,5,10,0.5
vs. FBS Non-Winning,2021,Boise State,2,0,2,1.0
vs. BCS AQ,2021,Boise State,0,2,2,0.0
vs. BCS non-AQ,2021,Boise State,7,3,10,0.7
vs. FBS Power 5,2021,Boise State,0,1,1,0.0
vs. FBS non-Power 5,2021,Boise State,7,4,11,0.6363636363636364
in August/September,2021,Boise State,2,2,4,0.5
in October,2021,Boise State,2,2,4,0.5
in November,2021,Boise State,3,1,4,0.75
in December/January,2021,Boise State,0,0,0,
All Games,2022,Boise State,10,4,14,0.7142857142857143
at Home,2022,Boise State,5,2,7,0.7142857142857143
on Road/Neutral Site,2022,Boise State,5,2,7,0.7142857142857143
vs. Conference,2022,Boise State,8,1,9,0.8888888888888888
vs. Non-Conference,2022,Boise State,2,3,5,0.4
vs. Ranked (AP),2022,Boise State,1,2,3,0.3333333333333333
vs. Unranked (AP),2022,Boise State,9,2,11,0.8181818181818182
vs. FBS (I-A),2022,Boise State,9,4,13,0.6923076923076923
vs. FCS (I-AA),2022,Boise State,1,0,1,1.0
vs. FBS Winning,2022,Boise State,4,3,7,0.5714285714285714
vs. FBS Non-Winning,2022,Boise State,5,1,6,0.8333333333333334
vs. BCS AQ,2022,Boise State,0,1,1,0.0
vs. BCS non-AQ,2022,Boise State,9,3,12,0.75
vs. FBS Power 5,2022,Boise State,0,1,1,0.0
vs. FBS non-Power 5,2022,Boise State,9,3,12,0.75
in August/September,2022,Boise State,3,2,5,0.6
in October,2022,Boise State,3,0,3,1.0
in November,2022,Boise State,3,1,4,0.75
in December/January,2022,Boise State,1,1,2,0.5
All Games,2009,Boston College,8,5,13,0.6153846153846154
at Home,2009,Boston College,6,1,7,0.8571428571428571
on Road/Neutral Site,2009,Boston College,2,4,6,0.3333333333333333
vs. Conference,2009,Boston College,5,3,8,0.625
vs. Non-Conference,2009,Boston College,3,2,5,0.6
vs. Ranked (AP),2009,Boston College,1,3,4,0.25
vs. Unranked (AP),2009,Boston College,7,2,9,0.7777777777777778
vs. FBS (I-A),2009,Boston College,7,5,12,0.5833333333333334
vs. FCS (I-AA),2009,Boston College,1,0,1,1.0
vs. FBS Winning,2009,Boston College,2,4,6,0.3333333333333333
vs. FBS Non-Winning,2009,Boston College,5,1,6,0.8333333333333334
vs. BCS AQ,2009,Boston College,5,5,10,0.5
vs. BCS non-AQ,2009,Boston College,2,0,2,1.0
vs. FBS Power 5,2009,Boston College,5,4,9,0.5555555555555556
vs. FBS non-Power 5,2009,Boston College,2,1,3,0.6666666666666666
in August/September,2009,Boston College,3,1,4,0.75
in October,2009,Boston College,3,2,5,0.6
in November,2009,Boston College,2,1,3,0.6666666666666666
in December/January,2009,Boston College,0,1,1,0.0
All Games,2010,Boston College,7,6,13,0.5384615384615384
at Home,2010,Boston College,4,3,7,0.5714285714285714
on Road/Neutral Site,2010,Boston College,3,3,6,0.5
vs. Conference,2010,Boston College,4,4,8,0.5
vs. Non-Conference,2010,Boston College,3,2,5,0.6
vs. Ranked (AP),2010,Boston College,0,5,5,0.0
vs. Unranked (AP),2010,Boston College,7,1,8,0.875
vs. FBS (I-A),2010,Boston College,6,6,12,0.5
vs. FCS (I-AA),2010,Boston College,1,0,1,1.0
vs. FBS Winning,2010,Boston College,1,6,7,0.14285714285714285
vs. FBS Non-Winning,2010,Boston College,5,0,5,1.0
vs. BCS AQ,2010,Boston College,5,5,10,0.5
vs. BCS non-AQ,2010,Boston College,1,1,2,0.5
vs. FBS Power 5,2010,Boston College,4,4,8,0.5
vs. FBS non-Power 5,2010,Boston College,2,2,4,0.5
in August/September,2010,Boston College,2,1,3,0.6666666666666666
in October,2010,Boston College,1,4,5,0.2
in November,2010,Boston College,4,0,4,1.0
in December/January,2010,Boston College,0,1,1,0.0
All Games,2011,Boston College,4,8,12,0.3333333333333333
at Home,2011,Boston College,2,4,6,0.3333333333333333
on Road/Neutral Site,2011,Boston College,2,4,6,0.3333333333333333
vs. Conference,2011,Boston College,3,5,8,0.375
vs. Non-Conference,2011,Boston College,1,3,4,0.25
vs. Ranked (AP),2011,Boston College,0,3,3,0.0
vs. Unranked (AP),2011,Boston College,4,5,9,0.4444444444444444
vs. FBS (I-A),2011,Boston College,3,8,11,0.2727272727272727
vs. FCS (I-AA),2011,Boston College,1,0,1,1.0
vs. FBS Winning,2011,Boston College,1,4,5,0.2
vs. FBS Non-Winning,2011,Boston College,2,4,6,0.3333333333333333
vs. BCS AQ,2011,Boston College,3,7,10,0.3
vs. BCS non-AQ,2011,Boston College,0,1,1,0.0
vs. FBS Power 5,2011,Boston College,3,6,9,0.3333333333333333
vs. FBS non-Power 5,2011,Boston College,0,2,2,0.0
in August/September,2011,Boston College,1,3,4,0.25
in October,2011,Boston College,1,3,4,0.25
in November,2011,Boston College,2,2,4,0.5
in December/January,2011,Boston College,0,0,0,
All Games,2012,Boston College,2,10,12,0.16666666666666666
at Home,2012,Boston College,2,4,6,0.3333333333333333
on Road/Neutral Site,2012,Boston College,0,6,6,0.0
vs. Conference,2012,Boston College,1,7,8,0.125
vs. Non-Conference,2012,Boston College,1,3,4,0.25
vs. Ranked (AP),2012,Boston College,0,4,4,0.0
vs. Unranked (AP),2012,Boston College,2,6,8,0.25
vs. FBS (I-A),2012,Boston College,1,10,11,0.09090909090909091
vs. FCS (I-AA),2012,Boston College,1,0,1,1.0
vs. FBS Winning,2012,Boston College,0,7,7,0.0
vs. FBS Non-Winning,2012,Boston College,1,3,4,0.25
vs. BCS AQ,2012,Boston College,1,9,10,0.1
vs. BCS non-AQ,2012,Boston College,0,1,1,0.0
vs. FBS Power 5,2012,Boston College,1,8,9,0.1111111111111111
vs. FBS non-Power 5,2012,Boston College,0,2,2,0.0
in August/September,2012,Boston College,1,3,4,0.25
in October,2012,Boston College,1,3,4,0.25
in November,2012,Boston College,0,4,4,0.0
in December/January,2012,Boston College,0,0,0,
All Games,2013,Boston College,7,6,13,0.5384615384615384
at Home,2013,Boston College,5,1,6,0.8333333333333334
on Road/Neutral Site,2013,Boston College,2,5,7,0.2857142857142857
vs. Conference,2013,Boston College,4,4,8,0.5
vs. Non-Conference,2013,Boston College,3,2,5,0.6
vs. Ranked (AP),2013,Boston College,0,3,3,0.0
vs. Unranked (AP),2013,Boston College,7,3,10,0.7
vs. FBS (I-A),2013,Boston College,6,6,12,0.5
vs. FCS (I-AA),2013,Boston College,1,0,1,1.0
vs. FBS Winning,2013,Boston College,2,6,8,0.25
vs. FBS Non-Winning,2013,Boston College,4,0,4,1.0
vs. BCS AQ,2013,Boston College,4,6,10,0.4
vs. BCS non-AQ,2013,Boston College,2,0,2,1.0
vs. FBS Power 5,2013,Boston College,4,6,10,0.4
vs. FBS non-Power 5,2013,Boston College,2,0,2,1.0
in August/September,2013,Boston College,2,2,4,0.5
in October,2013,Boston College,1,2,3,0.3333333333333333
in November,2013,Boston College,4,1,5,0.8
in December/January,2013,Boston College,0,1,1,0.0
All Games,2014,Boston College,7,6,13,0.5384615384615384
at Home,2014,Boston College,3,4,7,0.42857142857142855
on Road/Neutral Site,2014,Boston College,4,2,6,0.6666666666666666
vs. Conference,2014,Boston College,4,4,8,0.5
vs. Non-Conference,2014,Boston College,3,2,5,0.6
vs. Ranked (AP),2014,Boston College,1,3,4,0.25
vs. Unranked (AP),2014,Boston College,6,3,9,0.6666666666666666
vs. FBS (I-A),2014,Boston College,6,6,12,0.5
vs. FCS (I-AA),2014,Boston College,1,0,1,1.0
vs. FBS Winning,2014,Boston College,3,5,8,0.375
vs. FBS Non-Winning,2014,Boston College,3,1,4,0.75
vs. BCS AQ,2014,Boston College,5,5,10,0.5
vs. BCS non-AQ,2014,Boston College,1,1,2,0.5
vs. FBS Power 5,2014,Boston College,5,5,10,0.5
vs. FBS non-Power 5,2014,Boston College,1,1,2,0.5
in August/September,2014,Boston College,3,2,5,0.6
in October,2014,Boston College,2,1,3,0.6666666666666666
in November,2014,Boston College,2,2,4,0.5
in December/January,2014,Boston College,0,1,1,0.0
All Games,2015,Boston College,3,9,12,0.25
at Home,2015,Boston College,3,4,7,0.42857142857142855
on Road/Neutral Site,2015,Boston College,0,5,5,0.0
vs. Conference,2015,Boston College,0,8,8,0.0
vs. Non-Conference,2015,Boston College,3,1,4,0.75
vs. Ranked (AP),2015,Boston College,0,3,3,0.0
vs. Unranked (AP),2015,Boston College,3,6,9,0.3333333333333333
vs. FBS (I-A),2015,Boston College,1,9,10,0.1
vs. FCS (I-AA),2015,Boston College,2,0,2,1.0
vs. FBS Winning,2015,Boston College,1,7,8,0.125
vs. FBS Non-Winning,2015,Boston College,0,2,2,0.0
vs. BCS AQ,2015,Boston College,0,9,9,0.0
vs. BCS non-AQ,2015,Boston College,1,0,1,1.0
vs. FBS Power 5,2015,Boston College,0,8,8,0.0
vs. FBS non-Power 5,2015,Boston College,1,1,2,0.5
in August/September,2015,Boston College,3,1,4,0.75
in October,2015,Boston College,0,5,5,0.0
in November,2015,Boston College,0,3,3,0.0
in December/January,2015,Boston College,0,0,0,
All Games,2016,Boston College,7,6,13,0.5384615384615384
at Home,2016,Boston College,3,3,6,0.5
on Road/Neutral Site,2016,Boston College,4,3,7,0.5714285714285714
vs. Conference,2016,Boston College,2,6,8,0.25
vs. Non-Conference,2016,Boston College,5,0,5,1.0
vs. Ranked (AP),2016,Boston College,0,4,4,0.0
vs. Unranked (AP),2016,Boston College,7,2,9,0.7777777777777778
vs. FBS (I-A),2016,Boston College,6,6,12,0.5
vs. FCS (I-AA),2016,Boston College,1,0,1,1.0
vs. FBS Winning,2016,Boston College,2,5,7,0.2857142857142857
vs. FBS Non-Winning,2016,Boston College,4,1,5,0.8
vs. BCS AQ,2016,Boston College,4,6,10,0.4
vs. BCS non-AQ,2016,Boston College,2,0,2,1.0
vs. FBS Power 5,2016,Boston College,3,6,9,0.3333333333333333
vs. FBS non-Power 5,2016,Boston College,3,0,3,1.0
in August/September,2016,Boston College,2,2,4,0.5
in October,2016,Boston College,2,2,4,0.5
in November,2016,Boston College,2,2,4,0.5
in December/January,2016,Boston College,1,0,1,1.0
All Games,2017,Boston College,7,6,13,0.5384615384615384
at Home,2017,Boston College,2,4,6,0.3333333333333333
on Road/Neutral Site,2017,Boston College,5,2,7,0.7142857142857143
vs. Conference,2017,Boston College,4,4,8,0.5
vs. Non-Conference,2017,Boston College,3,2,5,0.6
vs. Ranked (AP),2017,Boston College,0,4,4,0.0
vs. Unranked (AP),2017,Boston College,7,2,9,0.7777777777777778
vs. FBS (I-A),2017,Boston College,7,6,13,0.5384615384615384
vs. FCS (I-AA),2017,Boston College,0,0,0,
vs. FBS Winning,2017,Boston College,4,6,10,0.4
vs. FBS Non-Winning,2017,Boston College,3,0,3,1.0
vs. BCS AQ,2017,Boston College,5,6,11,0.45454545454545453
vs. BCS non-AQ,2017,Boston College,2,0,2,1.0
vs. FBS Power 5,2017,Boston College,4,5,9,0.4444444444444444
vs. FBS non-Power 5,2017,Boston College,3,1,4,0.75
in August/September,2017,Boston College,2,3,5,0.4
in October,2017,Boston College,3,1,4,0.75
in November,2017,Boston College,2,1,3,0.6666666666666666
in December/January,2017,Boston College,0,1,1,0.0
All Games,2018,Boston College,7,5,12,0.5833333333333334
at Home,2018,Boston College,5,2,7,0.7142857142857143
on Road/Neutral Site,2018,Boston College,2,3,5,0.4
vs. Conference,2018,Boston College,4,4,8,0.5
vs. Non-Conference,2018,Boston College,3,1,4,0.75
vs. Ranked (AP),2018,Boston College,0,2,2,0.0
vs. Unranked (AP),2018,Boston College,7,3,10,0.7
vs. FBS (I-A),2018,Boston College,6,5,11,0.5454545454545454
vs. FCS (I-AA),2018,Boston College,1,0,1,1.0
vs. FBS Winning,2018,Boston College,3,3,6,0.5
vs. FBS Non-Winning,2018,Boston College,3,2,5,0.6
vs. BCS AQ,2018,Boston College,5,5,10,0.5
vs. BCS non-AQ,2018,Boston College,1,0,1,1.0
vs. FBS Power 5,2018,Boston College,4,5,9,0.4444444444444444
vs. FBS non-Power 5,2018,Boston College,2,0,2,1.0
in August/September,2018,Boston College,4,1,5,0.8
in October,2018,Boston College,2,1,3,0.6666666666666666
in November,2018,Boston College,1,3,4,0.25
in December/January,2018,Boston College,0,0,0,
All Games,2019,Boston College,6,7,13,0.46153846153846156
at Home,2019,Boston College,3,3,6,0.5
on Road/Neutral Site,2019,Boston College,3,4,7,0.42857142857142855
vs. Conference,2019,Boston College,4,4,8,0.5
vs. Non-Conference,2019,Boston College,2,3,5,0.4
vs. Ranked (AP),2019,Boston College,0,3,3,0.0
vs. Unranked (AP),2019,Boston College,6,4,10,0.6
vs. FBS (I-A),2019,Boston College,5,7,12,0.4166666666666667
vs. FCS (I-AA),2019,Boston College,1,0,1,1.0
vs. FBS Winning,2019,Boston College,2,5,7,0.2857142857142857
vs. FBS Non-Winning,2019,Boston College,3,2,5,0.6
vs. BCS AQ,2019,Boston College,5,7,12,0.4166666666666667
vs. BCS non-AQ,2019,Boston College,0,0,0,
vs. FBS Power 5,2019,Boston College,5,5,10,0.5
vs. FBS non-Power 5,2019,Boston College,0,2,2,0.0
in August/September,2019,Boston College,3,2,5,0.6
in October,2019,Boston College,1,2,3,0.3333333333333333
in November,2019,Boston College,2,2,4,0.5
in December/January,2019,Boston College,0,1,1,0.0
All Games,2020,Boston College,6,5,11,0.5454545454545454
at Home,2020,Boston College,4,2,6,0.6666666666666666
on Road/Neutral Site,2020,Boston College,2,3,5,0.4
vs. Conference,2020,Boston College,5,5,10,0.5
vs. Non-Conference,2020,Boston College,1,0,1,1.0
vs. Ranked (AP),2020,Boston College,0,3,3,0.0
vs. Unranked (AP),2020,Boston College,6,2,8,0.75
vs. FBS (I-A),2020,Boston College,6,5,11,0.5454545454545454
vs. FCS (I-AA),2020,Boston College,0,0,0,
vs. FBS Winning,2020,Boston College,1,3,4,0.25
vs. FBS Non-Winning,2020,Boston College,5,2,7,0.7142857142857143
vs. BCS AQ,2020,Boston College,5,5,10,0.5
vs. BCS non-AQ,2020,Boston College,1,0,1,1.0
vs. FBS Power 5,2020,Boston College,5,5,10,0.5
vs. FBS non-Power 5,2020,Boston College,1,0,1,1.0
in August/September,2020,Boston College,2,0,2,1.0
in October,2020,Boston College,2,3,5,0.4
in November,2020,Boston College,2,1,3,0.6666666666666666
in December/January,2020,Boston College,0,1,1,0.0
All Games,2021,Boston College,6,6,12,0.5
at Home,2021,Boston College,3,3,6,0.5
on Road/Neutral Site,2021,Boston College,3,3,6,0.5
vs. Conference,2021,Boston College,2,6,8,0.25
vs. Non-Conference,2021,Boston College,4,0,4,1.0
vs. Ranked (AP),2021,Boston College,0,3,3,0.0
vs. Unranked (AP),2021,Boston College,6,3,9,0.6666666666666666
vs. FBS (I-A),2021,Boston College,5,6,11,0.45454545454545453
vs. FCS (I-AA),2021,Boston College,1,0,1,1.0
vs. FBS Winning,2021,Boston College,0,3,3,0.0
vs. FBS Non-Winning,2021,Boston College,5,3,8,0.625
vs. BCS AQ,2021,Boston College,4,6,10,0.4
vs. BCS non-AQ,2021,Boston College,1,0,1,1.0
vs. FBS Power 5,2021,Boston College,3,6,9,0.3333333333333333
vs. FBS non-Power 5,2021,Boston College,2,0,2,1.0
in August/September,2021,Boston College,4,0,4,1.0
in October,2021,Boston College,0,4,4,0.0
in November,2021,Boston College,2,2,4,0.5
in December/January,2021,Boston College,0,0,0,
All Games,2022,Boston College,3,9,12,0.25
at Home,2022,Boston College,2,4,6,0.3333333333333333
on Road/Neutral Site,2022,Boston College,1,5,6,0.16666666666666666
vs. Conference,2022,Boston College,2,6,8,0.25
vs. Non-Conference,2022,Boston College,1,3,4,0.25
vs. Ranked (AP),2022,Boston College,0,3,3,0.0
vs. Unranked (AP),2022,Boston College,3,6,9,0.3333333333333333
vs. FBS (I-A),2022,Boston College,2,9,11,0.18181818181818182
vs. FCS (I-AA),2022,Boston College,1,0,1,1.0
vs. FBS Winning,2022,Boston College,2,6,8,0.25
vs. FBS Non-Winning,2022,Boston College,0,3,3,0.0
vs. BCS AQ,2022,Boston College,2,8,10,0.2
vs. BCS non-AQ,2022,Boston College,0,1,1,0.0
vs. FBS Power 5,2022,Boston College,2,7,9,0.2222222222222222
vs. FBS non-Power 5,2022,Boston College,0,2,2,0.0
in August/September,2022,Boston College,1,3,4,0.25
in October,2022,Boston College,1,3,4,0.25
in November,2022,Boston College,1,3,4,0.25
in December/January,2022,Boston College,0,0,0,
All Games,2009,Bowling Green,7,6,13,0.5384615384615384
at Home,2009,Bowling Green,3,3,6,0.5
on Road/Neutral Site,2009,Bowling Green,4,3,7,0.5714285714285714
vs. Conference,2009,Bowling Green,6,2,8,0.75
vs. Non-Conference,2009,Bowling Green,1,4,5,0.2
vs. Ranked (AP),2009,Bowling Green,0,2,2,0.0
vs. Unranked (AP),2009,Bowling Green,7,4,11,0.6363636363636364
vs. FBS (I-A),2009,Bowling Green,7,6,13,0.5384615384615384
vs. FCS (I-AA),2009,Bowling Green,0,0,0,
vs. FBS Winning,2009,Bowling Green,1,6,7,0.14285714285714285
vs. FBS Non-Winning,2009,Bowling Green,6,0,6,1.0
vs. BCS AQ,2009,Bowling Green,0,1,1,0.0
vs. BCS non-AQ,2009,Bowling Green,7,5,12,0.5833333333333334
vs. FBS Power 5,2009,Bowling Green,0,1,1,0.0
vs. FBS non-Power 5,2009,Bowling Green,7,5,12,0.5833333333333334
in August/September,2009,Bowling Green,1,3,4,0.25
in October,2009,Bowling Green,2,2,4,0.5
in November,2009,Bowling Green,4,0,4,1.0
in December/January,2009,Bowling Green,0,1,1,0.0
All Games,2010,Bowling Green,2,10,12,0.16666666666666666
at Home,2010,Bowling Green,1,4,5,0.2
on Road/Neutral Site,2010,Bowling Green,1,6,7,0.14285714285714285
vs. Conference,2010,Bowling Green,1,7,8,0.125
vs. Non-Conference,2010,Bowling Green,1,3,4,0.25
vs. Ranked (AP),2010,Bowling Green,0,1,1,0.0
vs. Unranked (AP),2010,Bowling Green,2,9,11,0.18181818181818182
vs. FBS (I-A),2010,Bowling Green,2,10,12,0.16666666666666666
vs. FCS (I-AA),2010,Bowling Green,0,0,0,
vs. FBS Winning,2010,Bowling Green,0,7,7,0.0
vs. FBS Non-Winning,2010,Bowling Green,2,3,5,0.4
vs. BCS AQ,2010,Bowling Green,0,1,1,0.0
vs. BCS non-AQ,2010,Bowling Green,2,9,11,0.18181818181818182
vs. FBS Power 5,2010,Bowling Green,0,1,1,0.0
vs. FBS non-Power 5,2010,Bowling Green,2,9,11,0.18181818181818182
in August/September,2010,Bowling Green,1,3,4,0.25
in October,2010,Bowling Green,1,4,5,0.2
in November,2010,Bowling Green,0,3,3,0.0
in December/January,2010,Bowling Green,0,0,0,
All Games,2011,Bowling Green,5,7,12,0.4166666666666667
at Home,2011,Bowling Green,2,4,6,0.3333333333333333
on Road/Neutral Site,2011,Bowling Green,3,3,6,0.5
vs. Conference,2011,Bowling Green,3,5,8,0.375
vs. Non-Conference,2011,Bowling Green,2,2,4,0.5
vs. Ranked (AP),2011,Bowling Green,0,1,1,0.0
vs. Unranked (AP),2011,Bowling Green,5,6,11,0.45454545454545453
vs. FBS (I-A),2011,Bowling Green,4,7,11,0.36363636363636365
vs. FCS (I-AA),2011,Bowling Green,1,0,1,1.0
vs. FBS Winning,2011,Bowling Green,1,6,7,0.14285714285714285
vs. FBS Non-Winning,2011,Bowling Green,3,1,4,0.75
vs. BCS AQ,2011,Bowling Green,0,1,1,0.0
vs. BCS non-AQ,2011,Bowling Green,4,6,10,0.4
vs. FBS Power 5,2011,Bowling Green,0,0,0,
vs. FBS non-Power 5,2011,Bowling Green,4,7,11,0.36363636363636365
in August/September,2011,Bowling Green,3,1,4,0.75
in October,2011,Bowling Green,1,4,5,0.2
in November,2011,Bowling Green,1,2,3,0.3333333333333333
in December/January,2011,Bowling Green,0,0,0,
All Games,2012,Bowling Green,8,5,13,0.6153846153846154
at Home,2012,Bowling Green,4,1,5,0.8
on Road/Neutral Site,2012,Bowling Green,4,4,8,0.5
vs. Conference,2012,Bowling Green,6,2,8,0.75
vs. Non-Conference,2012,Bowling Green,2,3,5,0.4
vs. Ranked (AP),2012,Bowling Green,0,2,2,0.0
vs. Unranked (AP),2012,Bowling Green,8,3,11,0.7272727272727273
vs. FBS (I-A),2012,Bowling Green,7,5,12,0.5833333333333334
vs. FCS (I-AA),2012,Bowling Green,1,0,1,1.0
vs. FBS Winning,2012,Bowling Green,1,5,6,0.16666666666666666
vs. FBS Non-Winning,2012,Bowling Green,6,0,6,1.0
vs. BCS AQ,2012,Bowling Green,0,2,2,0.0
vs. BCS non-AQ,2012,Bowling Green,7,3,10,0.7
vs. FBS Power 5,2012,Bowling Green,0,2,2,0.0
vs. FBS non-Power 5,2012,Bowling Green,7,3,10,0.7
in August/September,2012,Bowling Green,2,3,5,0.4
in October,2012,Bowling Green,4,0,4,1.0
in November,2012,Bowling Green,2,1,3,0.6666666666666666
in December/January,2012,Bowling Green,0,1,1,0.0
All Games,2013,Bowling Green,10,4,14,0.7142857142857143
at Home,2013,Bowling Green,5,1,6,0.8333333333333334
on Road/Neutral Site,2013,Bowling Green,5,3,8,0.625
vs. Conference,2013,Bowling Green,8,1,9,0.8888888888888888
vs. Non-Conference,2013,Bowling Green,2,3,5,0.4
vs. Ranked (AP),2013,Bowling Green,0,0,0,
vs. Unranked (AP),2013,Bowling Green,10,4,14,0.7142857142857143
vs. FBS (I-A),2013,Bowling Green,9,4,13,0.6923076923076923
vs. FCS (I-AA),2013,Bowling Green,1,0,1,1.0
vs. FBS Winning,2013,Bowling Green,3,3,6,0.5
vs. FBS Non-Winning,2013,Bowling Green,6,1,7,0.8571428571428571
vs. BCS AQ,2013,Bowling Green,0,3,3,0.0
vs. BCS non-AQ,2013,Bowling Green,9,1,10,0.9
vs. FBS Power 5,2013,Bowling Green,0,3,3,0.0
vs. FBS non-Power 5,2013,Bowling Green,9,1,10,0.9
in August/September,2013,Bowling Green,4,1,5,0.8
in October,2013,Bowling Green,1,2,3,0.3333333333333333
in November,2013,Bowling Green,4,0,4,1.0
in December/January,2013,Bowling Green,1,1,2,0.5
All Games,2014,Bowling Green,8,6,14,0.5714285714285714
at Home,2014,Bowling Green,4,2,6,0.6666666666666666
on Road/Neutral Site,2014,Bowling Green,4,4,8,0.5
vs. Conference,2014,Bowling Green,5,4,9,0.5555555555555556
vs. Non-Conference,2014,Bowling Green,3,2,5,0.6
vs. Ranked (AP),2014,Bowling Green,0,1,1,0.0
vs. Unranked (AP),2014,Bowling Green,8,5,13,0.6153846153846154
vs. FBS (I-A),2014,Bowling Green,7,6,13,0.5384615384615384
vs. FCS (I-AA),2014,Bowling Green,1,0,1,1.0
vs. FBS Winning,2014,Bowling Green,0,5,5,0.0
vs. FBS Non-Winning,2014,Bowling Green,7,1,8,0.875
vs. BCS AQ,2014,Bowling Green,1,1,2,0.5
vs. BCS non-AQ,2014,Bowling Green,6,5,11,0.5454545454545454
vs. FBS Power 5,2014,Bowling Green,1,1,2,0.5
vs. FBS non-Power 5,2014,Bowling Green,6,5,11,0.5454545454545454
in August/September,2014,Bowling Green,3,2,5,0.6
in October,2014,Bowling Green,2,1,3,0.6666666666666666
in November,2014,Bowling Green,2,2,4,0.5
in December/January,2014,Bowling Green,1,1,2,0.5
All Games,2015,Bowling Green,10,4,14,0.7142857142857143
at Home,2015,Bowling Green,3,2,5,0.6
on Road/Neutral Site,2015,Bowling Green,7,2,9,0.7777777777777778
vs. Conference,2015,Bowling Green,8,1,9,0.8888888888888888
vs. Non-Conference,2015,Bowling Green,2,3,5,0.4
vs. Ranked (AP),2015,Bowling Green,0,1,1,0.0
vs. Unranked (AP),2015,Bowling Green,10,3,13,0.7692307692307693
vs. FBS (I-A),2015,Bowling Green,10,4,14,0.7142857142857143
vs. FCS (I-AA),2015,Bowling Green,0,0,0,
vs. FBS Winning,2015,Bowling Green,4,4,8,0.5
vs. FBS Non-Winning,2015,Bowling Green,6,0,6,1.0
vs. BCS AQ,2015,Bowling Green,2,2,4,0.5
vs. BCS non-AQ,2015,Bowling Green,8,2,10,0.8
vs. FBS Power 5,2015,Bowling Green,2,1,3,0.6666666666666666
vs. FBS non-Power 5,2015,Bowling Green,8,3,11,0.7272727272727273
in August/September,2015,Bowling Green,2,2,4,0.5
in October,2015,Bowling Green,4,0,4,1.0
in November,2015,Bowling Green,3,1,4,0.75
in December/January,2015,Bowling Green,1,1,2,0.5
All Games,2016,Bowling Green,4,8,12,0.3333333333333333
at Home,2016,Bowling Green,3,3,6,0.5
on Road/Neutral Site,2016,Bowling Green,1,5,6,0.16666666666666666
vs. Conference,2016,Bowling Green,3,5,8,0.375
vs. Non-Conference,2016,Bowling Green,1,3,4,0.25
vs. Ranked (AP),2016,Bowling Green,0,1,1,0.0
vs. Unranked (AP),2016,Bowling Green,4,7,11,0.36363636363636365
vs. FBS (I-A),2016,Bowling Green,3,8,11,0.2727272727272727
vs. FCS (I-AA),2016,Bowling Green,1,0,1,1.0
vs. FBS Winning,2016,Bowling Green,0,6,6,0.0
vs. FBS Non-Winning,2016,Bowling Green,3,2,5,0.6
vs. BCS AQ,2016,Bowling Green,0,2,2,0.0
vs. BCS non-AQ,2016,Bowling Green,3,6,9,0.3333333333333333
vs. FBS Power 5,2016,Bowling Green,0,1,1,0.0
vs. FBS non-Power 5,2016,Bowling Green,3,7,10,0.3
in August/September,2016,Bowling Green,1,3,4,0.25
in October,2016,Bowling Green,0,4,4,0.0
in November,2016,Bowling Green,3,1,4,0.75
in December/January,2016,Bowling Green,0,0,0,
All Games,2017,Bowling Green,2,10,12,0.16666666666666666
at Home,2017,Bowling Green,0,5,5,0.0
on Road/Neutral Site,2017,Bowling Green,2,5,7,0.2857142857142857
vs. Conference,2017,Bowling Green,2,6,8,0.25
vs. Non-Conference,2017,Bowling Green,0,4,4,0.0
vs. Ranked (AP),2017,Bowling Green,0,2,2,0.0
vs. Unranked (AP),2017,Bowling Green,2,8,10,0.2
vs. FBS (I-A),2017,Bowling Green,2,9,11,0.18181818181818182
vs. FCS (I-AA),2017,Bowling Green,0,1,1,0.0
vs. FBS Winning,2017,Bowling Green,0,6,6,0.0
vs. FBS Non-Winning,2017,Bowling Green,2,3,5,0.4
vs. BCS AQ,2017,Bowling Green,0,2,2,0.0
vs. BCS non-AQ,2017,Bowling Green,2,7,9,0.2222222222222222
vs. FBS Power 5,2017,Bowling Green,0,2,2,0.0
vs. FBS non-Power 5,2017,Bowling Green,2,7,9,0.2222222222222222
in August/September,2017,Bowling Green,0,5,5,0.0
in October,2017,Bowling Green,2,2,4,0.5
in November,2017,Bowling Green,0,3,3,0.0
in December/January,2017,Bowling Green,0,0,0,
All Games,2018,Bowling Green,3,9,12,0.25
at Home,2018,Bowling Green,1,5,6,0.16666666666666666
on Road/Neutral Site,2018,Bowling Green,2,4,6,0.3333333333333333
vs. Conference,2018,Bowling Green,2,6,8,0.25
vs. Non-Conference,2018,Bowling Green,1,3,4,0.25
vs. Ranked (AP),2018,Bowling Green,0,0,0,
vs. Unranked (AP),2018,Bowling Green,3,9,12,0.25
vs. FBS (I-A),2018,Bowling Green,2,9,11,0.18181818181818182
vs. FCS (I-AA),2018,Bowling Green,1,0,1,1.0
vs. FBS Winning,2018,Bowling Green,0,6,6,0.0
vs. FBS Non-Winning,2018,Bowling Green,2,3,5,0.4
vs. BCS AQ,2018,Bowling Green,0,3,3,0.0
vs. BCS non-AQ,2018,Bowling Green,2,6,8,0.25
vs. FBS Power 5,2018,Bowling Green,0,3,3,0.0
vs. FBS non-Power 5,2018,Bowling Green,2,6,8,0.25
in August/September,2018,Bowling Green,1,4,5,0.2
in October,2018,Bowling Green,0,4,4,0.0
in November,2018,Bowling Green,2,1,3,0.6666666666666666
in December/January,2018,Bowling Green,0,0,0,
All Games,2019,Bowling Green,3,9,12,0.25
at Home,2019,Bowling Green,3,3,6,0.5
on Road/Neutral Site,2019,Bowling Green,0,6,6,0.0
vs. Conference,2019,Bowling Green,2,6,8,0.25
vs. Non-Conference,2019,Bowling Green,1,3,4,0.25
vs. Ranked (AP),2019,Bowling Green,0,1,1,0.0
vs. Unranked (AP),2019,Bowling Green,3,8,11,0.2727272727272727
vs. FBS (I-A),2019,Bowling Green,2,9,11,0.18181818181818182
vs. FCS (I-AA),2019,Bowling Green,1,0,1,1.0
vs. FBS Winning,2019,Bowling Green,0,9,9,0.0
vs. FBS Non-Winning,2019,Bowling Green,2,0,2,1.0
vs. BCS AQ,2019,Bowling Green,0,2,2,0.0
vs. BCS non-AQ,2019,Bowling Green,2,7,9,0.2222222222222222
vs. FBS Power 5,2019,Bowling Green,0,1,1,0.0
vs. FBS non-Power 5,2019,Bowling Green,2,8,10,0.2
in August/September,2019,Bowling Green,1,3,4,0.25
in October,2019,Bowling Green,1,3,4,0.25
in November,2019,Bowling Green,1,3,4,0.25
in December/January,2019,Bowling Green,0,0,0,
All Games,2020,Bowling Green,0,5,5,0.0
at Home,2020,Bowling Green,0,2,2,0.0
on Road/Neutral Site,2020,Bowling Green,0,3,3,0.0
vs. Conference,2020,Bowling Green,0,5,5,0.0
vs. Non-Conference,2020,Bowling Green,0,0,0,
vs. Ranked (AP),2020,Bowling Green,0,0,0,
vs. Unranked (AP),2020,Bowling Green,0,5,5,0.0
vs. FBS (I-A),2020,Bowling Green,0,5,5,0.0
vs. FCS (I-AA),2020,Bowling Green,0,0,0,
vs. FBS Winning,2020,Bowling Green,0,4,4,0.0
vs. FBS Non-Winning,2020,Bowling Green,0,1,1,0.0
vs. BCS AQ,2020,Bowling Green,0,0,0,
vs. BCS non-AQ,2020,Bowling Green,0,5,5,0.0
vs. FBS Power 5,2020,Bowling Green,0,0,0,
vs. FBS non-Power 5,2020,Bowling Green,0,5,5,0.0
in August/September,2020,Bowling Green,0,0,0,
in October,2020,Bowling Green,0,0,0,
in November,2020,Bowling Green,0,4,4,0.0
in December/January,2020,Bowling Green,0,1,1,0.0
All Games,2021,Bowling Green,4,8,12,0.3333333333333333
at Home,2021,Bowling Green,2,4,6,0.3333333333333333
on Road/Neutral Site,2021,Bowling Green,2,4,6,0.3333333333333333
vs. Conference,2021,Bowling Green,2,6,8,0.25
vs. Non-Conference,2021,Bowling Green,2,2,4,0.5
vs. Ranked (AP),2021,Bowling Green,0,0,0,
vs. Unranked (AP),2021,Bowling Green,4,8,12,0.3333333333333333
vs. FBS (I-A),2021,Bowling Green,3,8,11,0.2727272727272727
vs. FCS (I-AA),2021,Bowling Green,1,0,1,1.0
vs. FBS Winning,2021,Bowling Green,1,5,6,0.16666666666666666
vs. FBS Non-Winning,2021,Bowling Green,2,3,5,0.4
vs. BCS AQ,2021,Bowling Green,1,1,2,0.5
vs. BCS non-AQ,2021,Bowling Green,2,7,9,0.2222222222222222
vs. FBS Power 5,2021,Bowling Green,1,1,2,0.5
vs. FBS non-Power 5,2021,Bowling Green,2,7,9,0.2222222222222222
in August/September,2021,Bowling Green,2,2,4,0.5
in October,2021,Bowling Green,1,4,5,0.2
in November,2021,Bowling Green,1,2,3,0.3333333333333333
in December/January,2021,Bowling Green,0,0,0,
All Games,2022,Bowling Green,6,7,13,0.46153846153846156
at Home,2022,Bowling Green,3,3,6,0.5
on Road/Neutral Site,2022,Bowling Green,3,4,7,0.42857142857142855
vs. Conference,2022,Bowling Green,5,3,8,0.625
vs. Non-Conference,2022,Bowling Green,1,4,5,0.2
vs. Ranked (AP),2022,Bowling Green,0,2,2,0.0
vs. Unranked (AP),2022,Bowling Green,6,5,11,0.5454545454545454
vs. FBS (I-A),2022,Bowling Green,6,6,12,0.5
vs. FCS (I-AA),2022,Bowling Green,0,1,1,0.0
vs. FBS Winning,2022,Bowling Green,2,5,7,0.2857142857142857
vs. FBS Non-Winning,2022,Bowling Green,4,1,5,0.8
vs. BCS AQ,2022,Bowling Green,0,2,2,0.0
vs. BCS non-AQ,2022,Bowling Green,6,4,10,0.6
vs. FBS Power 5,2022,Bowling Green,0,2,2,0.0
vs. FBS non-Power 5,2022,Bowling Green,6,4,10,0.6
in August/September,2022,Bowling Green,1,3,4,0.25
in October,2022,Bowling Green,3,1,4,0.75
in November,2022,Bowling Green,2,2,4,0.5
in December/January,2022,Bowling Green,0,1,1,0.0
All Games,2009,Buffalo,5,7,12,0.4166666666666667
at Home,2009,Buffalo,2,4,6,0.3333333333333333
on Road/Neutral Site,2009,Buffalo,3,3,6,0.5
vs. Conference,2009,Buffalo,3,5,8,0.375
vs. Non-Conference,2009,Buffalo,2,2,4,0.5
vs. Ranked (AP),2009,Buffalo,0,2,2,0.0
vs. Unranked (AP),2009,Buffalo,5,5,10,0.5
vs. FBS (I-A),2009,Buffalo,4,7,11,0.36363636363636365
vs. FCS (I-AA),2009,Buffalo,1,0,1,1.0
vs. FBS Winning,2009,Buffalo,0,6,6,0.0
vs. FBS Non-Winning,2009,Buffalo,4,1,5,0.8
vs. BCS AQ,2009,Buffalo,0,1,1,0.0
vs. BCS non-AQ,2009,Buffalo,4,6,10,0.4
vs. FBS Power 5,2009,Buffalo,0,0,0,
vs. FBS non-Power 5,2009,Buffalo,4,7,11,0.36363636363636365
in August/September,2009,Buffalo,1,3,4,0.25
in October,2009,Buffalo,2,2,4,0.5
in November,2009,Buffalo,2,2,4,0.5
in December/January,2009,Buffalo,0,0,0,
All Games,2010,Buffalo,2,10,12,0.16666666666666666
at Home,2010,Buffalo,1,5,6,0.16666666666666666
on Road/Neutral Site,2010,Buffalo,1,5,6,0.16666666666666666
vs. Conference,2010,Buffalo,1,7,8,0.125
vs. Non-Conference,2010,Buffalo,1,3,4,0.25
vs. Ranked (AP),2010,Buffalo,0,1,1,0.0
vs. Unranked (AP),2010,Buffalo,2,9,11,0.18181818181818182
vs. FBS (I-A),2010,Buffalo,1,10,11,0.09090909090909091
vs. FCS (I-AA),2010,Buffalo,1,0,1,1.0
vs. FBS Winning,2010,Buffalo,0,7,7,0.0
vs. FBS Non-Winning,2010,Buffalo,1,3,4,0.25
vs. BCS AQ,2010,Buffalo,0,2,2,0.0
vs. BCS non-AQ,2010,Buffalo,1,8,9,0.1111111111111111
vs. FBS Power 5,2010,Buffalo,0,1,1,0.0
vs. FBS non-Power 5,2010,Buffalo,1,9,10,0.1
in August/September,2010,Buffalo,1,3,4,0.25
in October,2010,Buffalo,1,3,4,0.25
in November,2010,Buffalo,0,4,4,0.0
in December/January,2010,Buffalo,0,0,0,
All Games,2011,Buffalo,3,9,12,0.25
at Home,2011,Buffalo,3,3,6,0.5
on Road/Neutral Site,2011,Buffalo,0,6,6,0.0
vs. Conference,2011,Buffalo,2,6,8,0.25
vs. Non-Conference,2011,Buffalo,1,3,4,0.25
vs. Ranked (AP),2011,Buffalo,0,0,0,
vs. Unranked (AP),2011,Buffalo,3,9,12,0.25
vs. FBS (I-A),2011,Buffalo,2,9,11,0.18181818181818182
vs. FCS (I-AA),2011,Buffalo,1,0,1,1.0
vs. FBS Winning,2011,Buffalo,1,2,3,0.3333333333333333
vs. FBS Non-Winning,2011,Buffalo,1,7,8,0.125
vs. BCS AQ,2011,Buffalo,0,3,3,0.0
vs. BCS non-AQ,2011,Buffalo,2,6,8,0.25
vs. FBS Power 5,2011,Buffalo,0,1,1,0.0
vs. FBS non-Power 5,2011,Buffalo,2,8,10,0.2
in August/September,2011,Buffalo,1,3,4,0.25
in October,2011,Buffalo,1,4,5,0.2
in November,2011,Buffalo,1,2,3,0.3333333333333333
in December/January,2011,Buffalo,0,0,0,
All Games,2012,Buffalo,4,8,12,0.3333333333333333
at Home,2012,Buffalo,3,3,6,0.5
on Road/Neutral Site,2012,Buffalo,1,5,6,0.16666666666666666
vs. Conference,2012,Buffalo,3,5,8,0.375
vs. Non-Conference,2012,Buffalo,1,3,4,0.25
vs. Ranked (AP),2012,Buffalo,0,2,2,0.0
vs. Unranked (AP),2012,Buffalo,4,6,10,0.4
vs. FBS (I-A),2012,Buffalo,3,8,11,0.2727272727272727
vs. FCS (I-AA),2012,Buffalo,1,0,1,1.0
vs. FBS Winning,2012,Buffalo,0,6,6,0.0
vs. FBS Non-Winning,2012,Buffalo,3,2,5,0.6
vs. BCS AQ,2012,Buffalo,0,3,3,0.0
vs. BCS non-AQ,2012,Buffalo,3,5,8,0.375
vs. FBS Power 5,2012,Buffalo,0,1,1,0.0
vs. FBS non-Power 5,2012,Buffalo,3,7,10,0.3
in August/September,2012,Buffalo,1,3,4,0.25
in October,2012,Buffalo,0,4,4,0.0
in November,2012,Buffalo,3,1,4,0.75
in December/January,2012,Buffalo,0,0,0,
All Games,2013,Buffalo,8,5,13,0.6153846153846154
at Home,2013,Buffalo,5,0,5,1.0
on Road/Neutral Site,2013,Buffalo,3,5,8,0.375
vs. Conference,2013,Buffalo,6,2,8,0.75
vs. Non-Conference,2013,Buffalo,2,3,5,0.4
vs. Ranked (AP),2013,Buffalo,0,2,2,0.0
vs. Unranked (AP),2013,Buffalo,8,3,11,0.7272727272727273
vs. FBS (I-A),2013,Buffalo,7,5,12,0.5833333333333334
vs. FCS (I-AA),2013,Buffalo,1,0,1,1.0
vs. FBS Winning,2013,Buffalo,1,5,6,0.16666666666666666
vs. FBS Non-Winning,2013,Buffalo,6,0,6,1.0
vs. BCS AQ,2013,Buffalo,1,2,3,0.3333333333333333
vs. BCS non-AQ,2013,Buffalo,6,3,9,0.6666666666666666
vs. FBS Power 5,2013,Buffalo,0,2,2,0.0
vs. FBS non-Power 5,2013,Buffalo,7,3,10,0.7
in August/September,2013,Buffalo,2,2,4,0.5
in October,2013,Buffalo,4,0,4,1.0
in November,2013,Buffalo,2,2,4,0.5
in December/January,2013,Buffalo,0,1,1,0.0
All Games,2014,Buffalo,5,6,11,0.45454545454545453
at Home,2014,Buffalo,4,2,6,0.6666666666666666
on Road/Neutral Site,2014,Buffalo,1,4,5,0.2
vs. Conference,2014,Buffalo,3,4,7,0.42857142857142855
vs. Non-Conference,2014,Buffalo,2,2,4,0.5
vs. Ranked (AP),2014,Buffalo,0,1,1,0.0
vs. Unranked (AP),2014,Buffalo,5,5,10,0.5
vs. FBS (I-A),2014,Buffalo,3,6,9,0.3333333333333333
vs. FCS (I-AA),2014,Buffalo,2,0,2,1.0
vs. FBS Winning,2014,Buffalo,0,3,3,0.0
vs. FBS Non-Winning,2014,Buffalo,3,3,6,0.5
vs. BCS AQ,2014,Buffalo,0,1,1,0.0
vs. BCS non-AQ,2014,Buffalo,3,5,8,0.375
vs. FBS Power 5,2014,Buffalo,0,1,1,0.0
vs. FBS non-Power 5,2014,Buffalo,3,5,8,0.375
in August/September,2014,Buffalo,3,2,5,0.6
in October,2014,Buffalo,0,3,3,0.0
in November,2014,Buffalo,2,1,3,0.6666666666666666
in December/January,2014,Buffalo,0,0,0,
All Games,2015,Buffalo,5,7,12,0.4166666666666667
at Home,2015,Buffalo,2,4,6,0.3333333333333333
on Road/Neutral Site,2015,Buffalo,3,3,6,0.5
vs. Conference,2015,Buffalo,3,5,8,0.375
vs. Non-Conference,2015,Buffalo,2,2,4,0.5
vs. Ranked (AP),2015,Buffalo,0,0,0,
vs. Unranked (AP),2015,Buffalo,5,7,12,0.4166666666666667
vs. FBS (I-A),2015,Buffalo,4,7,11,0.36363636363636365
vs. FCS (I-AA),2015,Buffalo,1,0,1,1.0
vs. FBS Winning,2015,Buffalo,1,6,7,0.14285714285714285
vs. FBS Non-Winning,2015,Buffalo,3,1,4,0.75
vs. BCS AQ,2015,Buffalo,0,1,1,0.0
vs. BCS non-AQ,2015,Buffalo,4,6,10,0.4
vs. FBS Power 5,2015,Buffalo,0,1,1,0.0
vs. FBS non-Power 5,2015,Buffalo,4,6,10,0.4
in August/September,2015,Buffalo,2,2,4,0.5
in October,2015,Buffalo,2,2,4,0.5
in November,2015,Buffalo,1,3,4,0.25
in December/January,2015,Buffalo,0,0,0,
All Games,2016,Buffalo,2,10,12,0.16666666666666666
at Home,2016,Buffalo,2,4,6,0.3333333333333333
on Road/Neutral Site,2016,Buffalo,0,6,6,0.0
vs. Conference,2016,Buffalo,1,7,8,0.125
vs. Non-Conference,2016,Buffalo,1,3,4,0.25
vs. Ranked (AP),2016,Buffalo,0,1,1,0.0
vs. Unranked (AP),2016,Buffalo,2,9,11,0.18181818181818182
vs. FBS (I-A),2016,Buffalo,2,9,11,0.18181818181818182
vs. FCS (I-AA),2016,Buffalo,0,1,1,0.0
vs. FBS Winning,2016,Buffalo,1,3,4,0.25
vs. FBS Non-Winning,2016,Buffalo,1,6,7,0.14285714285714285
vs. BCS AQ,2016,Buffalo,0,1,1,0.0
vs. BCS non-AQ,2016,Buffalo,2,8,10,0.2
vs. FBS Power 5,2016,Buffalo,0,1,1,0.0
vs. FBS non-Power 5,2016,Buffalo,2,8,10,0.2
in August/September,2016,Buffalo,1,2,3,0.3333333333333333
in October,2016,Buffalo,1,4,5,0.2
in November,2016,Buffalo,0,4,4,0.0
in December/January,2016,Buffalo,0,0,0,
All Games,2017,Buffalo,6,6,12,0.5
at Home,2017,Buffalo,4,2,6,0.6666666666666666
on Road/Neutral Site,2017,Buffalo,2,4,6,0.3333333333333333
vs. Conference,2017,Buffalo,4,4,8,0.5
vs. Non-Conference,2017,Buffalo,2,2,4,0.5
vs. Ranked (AP),2017,Buffalo,0,0,0,
vs. Unranked (AP),2017,Buffalo,6,6,12,0.5
vs. FBS (I-A),2017,Buffalo,5,6,11,0.45454545454545453
vs. FCS (I-AA),2017,Buffalo,1,0,1,1.0
vs. FBS Winning,2017,Buffalo,2,2,4,0.5
vs. FBS Non-Winning,2017,Buffalo,3,4,7,0.42857142857142855
vs. BCS AQ,2017,Buffalo,0,1,1,0.0
vs. BCS non-AQ,2017,Buffalo,5,5,10,0.5
vs. FBS Power 5,2017,Buffalo,0,1,1,0.0
vs. FBS non-Power 5,2017,Buffalo,5,5,10,0.5
in August/September,2017,Buffalo,3,2,5,0.6
in October,2017,Buffalo,0,4,4,0.0
in November,2017,Buffalo,3,0,3,1.0
in December/January,2017,Buffalo,0,0,0,
All Games,2018,Buffalo,10,4,14,0.7142857142857143
at Home,2018,Buffalo,5,1,6,0.8333333333333334
on Road/Neutral Site,2018,Buffalo,5,3,8,0.625
vs. Conference,2018,Buffalo,7,2,9,0.7777777777777778
vs. Non-Conference,2018,Buffalo,3,2,5,0.6
vs. Ranked (AP),2018,Buffalo,0,1,1,0.0
vs. Unranked (AP),2018,Buffalo,10,3,13,0.7692307692307693
vs. FBS (I-A),2018,Buffalo,9,4,13,0.6923076923076923
vs. FCS (I-AA),2018,Buffalo,1,0,1,1.0
vs. FBS Winning,2018,Buffalo,3,4,7,0.42857142857142855
vs. FBS Non-Winning,2018,Buffalo,6,0,6,1.0
vs. BCS AQ,2018,Buffalo,2,0,2,1.0
vs. BCS non-AQ,2018,Buffalo,7,4,11,0.6363636363636364
vs. FBS Power 5,2018,Buffalo,1,0,1,1.0
vs. FBS non-Power 5,2018,Buffalo,8,4,12,0.6666666666666666
in August/September,2018,Buffalo,4,1,5,0.8
in October,2018,Buffalo,4,0,4,1.0
in November,2018,Buffalo,2,2,4,0.5
in December/January,2018,Buffalo,0,1,1,0.0
All Games,2019,Buffalo,8,5,13,0.6153846153846154
at Home,2019,Buffalo,5,1,6,0.8333333333333334
on Road/Neutral Site,2019,Buffalo,3,4,7,0.42857142857142855
vs. Conference,2019,Buffalo,5,3,8,0.625
vs. Non-Conference,2019,Buffalo,3,2,5,0.6
vs. Ranked (AP),2019,Buffalo,0,1,1,0.0
vs. Unranked (AP),2019,Buffalo,8,4,12,0.6666666666666666
vs. FBS (I-A),2019,Buffalo,7,5,12,0.5833333333333334
vs. FCS (I-AA),2019,Buffalo,1,0,1,1.0
vs. FBS Winning,2019,Buffalo,3,5,8,0.375
vs. FBS Non-Winning,2019,Buffalo,4,0,4,1.0
vs. BCS AQ,2019,Buffalo,1,1,2,0.5
vs. BCS non-AQ,2019,Buffalo,6,4,10,0.6
vs. FBS Power 5,2019,Buffalo,0,1,1,0.0
vs. FBS non-Power 5,2019,Buffalo,7,4,11,0.6363636363636364
in August/September,2019,Buffalo,2,3,5,0.4
in October,2019,Buffalo,2,1,3,0.6666666666666666
in November,2019,Buffalo,3,1,4,0.75
in December/January,2019,Buffalo,1,0,1,1.0
All Games,2020,Buffalo,6,1,7,0.8571428571428571
at Home,2020,Buffalo,3,0,3,1.0
on Road/Neutral Site,2020,Buffalo,3,1,4,0.75
vs. Conference,2020,Buffalo,5,1,6,0.8333333333333334
vs. Non-Conference,2020,Buffalo,1,0,1,1.0
vs. Ranked (AP),2020,Buffalo,0,0,0,
vs. Unranked (AP),2020,Buffalo,6,1,7,0.8571428571428571
vs. FBS (I-A),2020,Buffalo,6,1,7,0.8571428571428571
vs. FCS (I-AA),2020,Buffalo,0,0,0,
vs. FBS Winning,2020,Buffalo,3,1,4,0.75
vs. FBS Non-Winning,2020,Buffalo,3,0,3,1.0
vs. BCS AQ,2020,Buffalo,0,0,0,
vs. BCS non-AQ,2020,Buffalo,6,1,7,0.8571428571428571
vs. FBS Power 5,2020,Buffalo,0,0,0,
vs. FBS non-Power 5,2020,Buffalo,6,1,7,0.8571428571428571
in August/September,2020,Buffalo,0,0,0,
in October,2020,Buffalo,0,0,0,
in November,2020,Buffalo,4,0,4,1.0
in December/January,2020,Buffalo,2,1,3,0.6666666666666666
All Games,2021,Buffalo,4,8,12,0.3333333333333333
at Home,2021,Buffalo,2,4,6,0.3333333333333333
on Road/Neutral Site,2021,Buffalo,2,4,6,0.3333333333333333
vs. Conference,2021,Buffalo,2,6,8,0.25
vs. Non-Conference,2021,Buffalo,2,2,4,0.5
vs. Ranked (AP),2021,Buffalo,0,0,0,
vs. Unranked (AP),2021,Buffalo,4,8,12,0.3333333333333333
vs. FBS (I-A),2021,Buffalo,3,8,11,0.2727272727272727
vs. FCS (I-AA),2021,Buffalo,1,0,1,1.0
vs. FBS Winning,2021,Buffalo,0,4,4,0.0
vs. FBS Non-Winning,2021,Buffalo,3,4,7,0.42857142857142855
vs. BCS AQ,2021,Buffalo,0,1,1,0.0
vs. BCS non-AQ,2021,Buffalo,3,7,10,0.3
vs. FBS Power 5,2021,Buffalo,0,1,1,0.0
vs. FBS non-Power 5,2021,Buffalo,3,7,10,0.3
in August/September,2021,Buffalo,2,2,4,0.5
in October,2021,Buffalo,2,3,5,0.4
in November,2021,Buffalo,0,3,3,0.0
in December/January,2021,Buffalo,0,0,0,
All Games,2022,Buffalo,7,6,13,0.5384615384615384
at Home,2022,Buffalo,3,2,5,0.6
on Road/Neutral Site,2022,Buffalo,4,4,8,0.5
vs. Conference,2022,Buffalo,5,3,8,0.625
vs. Non-Conference,2022,Buffalo,2,3,5,0.4
vs. Ranked (AP),2022,Buffalo,0,0,0,
vs. Unranked (AP),2022,Buffalo,7,6,13,0.5384615384615384
vs. FBS (I-A),2022,Buffalo,7,5,12,0.5833333333333334
vs. FCS (I-AA),2022,Buffalo,0,1,1,0.0
vs. FBS Winning,2022,Buffalo,2,3,5,0.4
vs. FBS Non-Winning,2022,Buffalo,5,2,7,0.7142857142857143
vs. BCS AQ,2022,Buffalo,0,1,1,0.0
vs. BCS non-AQ,2022,Buffalo,7,4,11,0.6363636363636364
vs. FBS Power 5,2022,Buffalo,0,1,1,0.0
vs. FBS non-Power 5,2022,Buffalo,7,4,11,0.6363636363636364
in August/September,2022,Buffalo,1,3,4,0.25
in October,2022,Buffalo,4,0,4,1.0
in November,2022,Buffalo,0,3,3,0.0
in December/January,2022,Buffalo,2,0,2,1.0
All Games,2009,California,8,5,13,0.6153846153846154
at Home,2009,California,4,2,6,0.6666666666666666
on Road/Neutral Site,2009,California,4,3,7,0.5714285714285714
vs. Conference,2009,California,5,4,9,0.5555555555555556
vs. Non-Conference,2009,California,3,1,4,0.75
vs. Ranked (AP),2009,California,0,3,3,0.0
vs. Unranked (AP),2009,California,8,2,10,0.8
vs. FBS (I-A),2009,California,7,5,12,0.5833333333333334
vs. FCS (I-AA),2009,California,1,0,1,1.0
vs. FBS Winning,2009,California,3,4,7,0.42857142857142855
vs. FBS Non-Winning,2009,California,4,1,5,0.8
vs. BCS AQ,2009,California,7,4,11,0.6363636363636364
vs. BCS non-AQ,2009,California,0,1,1,0.0
vs. FBS Power 5,2009,California,7,4,11,0.6363636363636364
vs. FBS non-Power 5,2009,California,0,1,1,0.0
in August/September,2009,California,3,1,4,0.75
in October,2009,California,3,1,4,0.75
in November,2009,California,2,1,3,0.6666666666666666
in December/January,2009,California,0,2,2,0.0
All Games,2010,California,5,7,12,0.4166666666666667
at Home,2010,California,4,3,7,0.5714285714285714
on Road/Neutral Site,2010,California,1,4,5,0.2
vs. Conference,2010,California,3,6,9,0.3333333333333333
vs. Non-Conference,2010,California,2,1,3,0.6666666666666666
vs. Ranked (AP),2010,California,0,3,3,0.0
vs. Unranked (AP),2010,California,5,4,9,0.5555555555555556
vs. FBS (I-A),2010,California,4,7,11,0.36363636363636365
vs. FCS (I-AA),2010,California,1,0,1,1.0
vs. FBS Winning,2010,California,0,6,6,0.0
vs. FBS Non-Winning,2010,California,4,1,5,0.8
vs. BCS AQ,2010,California,4,6,10,0.4
vs. BCS non-AQ,2010,California,0,1,1,0.0
vs. FBS Power 5,2010,California,4,6,10,0.4
vs. FBS non-Power 5,2010,California,0,1,1,0.0
in August/September,2010,California,2,2,4,0.5
in October,2010,California,2,2,4,0.5
in November,2010,California,1,3,4,0.25
in December/January,2010,California,0,0,0,
All Games,2011,California,7,6,13,0.5384615384615384
at Home,2011,California,4,1,5,0.8
on Road/Neutral Site,2011,California,3,5,8,0.375
vs. Conference,2011,California,5,5,10,0.5
vs. Non-Conference,2011,California,2,1,3,0.6666666666666666
vs. Ranked (AP),2011,California,0,3,3,0.0
vs. Unranked (AP),2011,California,7,3,10,0.7
vs. FBS (I-A),2011,California,6,6,12,0.5
vs. FCS (I-AA),2011,California,1,0,1,1.0
vs. FBS Winning,2011,California,1,5,6,0.16666666666666666
vs. FBS Non-Winning,2011,California,5,1,6,0.8333333333333334
vs. BCS AQ,2011,California,5,6,11,0.45454545454545453
vs. BCS non-AQ,2011,California,1,0,1,1.0
vs. FBS Power 5,2011,California,5,6,11,0.45454545454545453
vs. FBS non-Power 5,2011,California,1,0,1,1.0
in August/September,2011,California,3,1,4,0.75
in October,2011,California,1,3,4,0.25
in November,2011,California,3,1,4,0.75
in December/January,2011,California,0,1,1,0.0
All Games,2012,California,3,9,12,0.25
at Home,2012,California,2,5,7,0.2857142857142857
on Road/Neutral Site,2012,California,1,4,5,0.2
vs. Conference,2012,California,2,7,9,0.2222222222222222
vs. Non-Conference,2012,California,1,2,3,0.3333333333333333
vs. Ranked (AP),2012,California,0,4,4,0.0
vs. Unranked (AP),2012,California,3,5,8,0.375
vs. FBS (I-A),2012,California,2,9,11,0.18181818181818182
vs. FCS (I-AA),2012,California,1,0,1,1.0
vs. FBS Winning,2012,California,1,8,9,0.1111111111111111
vs. FBS Non-Winning,2012,California,1,1,2,0.5
vs. BCS AQ,2012,California,2,8,10,0.2
vs. BCS non-AQ,2012,California,0,1,1,0.0
vs. FBS Power 5,2012,California,2,8,10,0.2
vs. FBS non-Power 5,2012,California,0,1,1,0.0
in August/September,2012,California,1,4,5,0.2
in October,2012,California,2,2,4,0.5
in November,2012,California,0,3,3,0.0
in December/January,2012,California,0,0,0,
All Games,2013,California,1,11,12,0.08333333333333333
at Home,2013,California,1,6,7,0.14285714285714285
on Road/Neutral Site,2013,California,0,5,5,0.0
vs. Conference,2013,California,0,9,9,0.0
vs. Non-Conference,2013,California,1,2,3,0.3333333333333333
vs. Ranked (AP),2013,California,0,6,6,0.0
vs. Unranked (AP),2013,California,1,5,6,0.16666666666666666
vs. FBS (I-A),2013,California,0,11,11,0.0
vs. FCS (I-AA),2013,California,1,0,1,1.0
vs. FBS Winning,2013,California,0,8,8,0.0
vs. FBS Non-Winning,2013,California,0,3,3,0.0
vs. BCS AQ,2013,California,0,11,11,0.0
vs. BCS non-AQ,2013,California,0,0,0,
vs. FBS Power 5,2013,California,0,11,11,0.0
vs. FBS non-Power 5,2013,California,0,0,0,
in August/September,2013,California,1,3,4,0.25
in October,2013,California,0,4,4,0.0
in November,2013,California,0,4,4,0.0
in December/January,2013,California,0,0,0,
All Games,2014,California,5,7,12,0.4166666666666667
at Home,2014,California,2,4,6,0.3333333333333333
on Road/Neutral Site,2014,California,3,3,6,0.5
vs. Conference,2014,California,3,6,9,0.3333333333333333
vs. Non-Conference,2014,California,2,1,3,0.6666666666666666
vs. Ranked (AP),2014,California,0,4,4,0.0
vs. Unranked (AP),2014,California,5,3,8,0.625
vs. FBS (I-A),2014,California,4,7,11,0.36363636363636365
vs. FCS (I-AA),2014,California,1,0,1,1.0
vs. FBS Winning,2014,California,0,7,7,0.0
vs. FBS Non-Winning,2014,California,4,0,4,1.0
vs. BCS AQ,2014,California,4,6,10,0.4
vs. BCS non-AQ,2014,California,0,1,1,0.0
vs. FBS Power 5,2014,California,4,6,10,0.4
vs. FBS non-Power 5,2014,California,0,1,1,0.0
in August/September,2014,California,3,1,4,0.75
in October,2014,California,1,3,4,0.25
in November,2014,California,1,3,4,0.25
in December/January,2014,California,0,0,0,
All Games,2015,California,8,5,13,0.6153846153846154
at Home,2015,California,5,1,6,0.8333333333333334
on Road/Neutral Site,2015,California,3,4,7,0.42857142857142855
vs. Conference,2015,California,4,5,9,0.4444444444444444
vs. Non-Conference,2015,California,4,0,4,1.0
vs. Ranked (AP),2015,California,0,3,3,0.0
vs. Unranked (AP),2015,California,8,2,10,0.8
vs. FBS (I-A),2015,California,7,5,12,0.5833333333333334
vs. FCS (I-AA),2015,California,1,0,1,1.0
vs. FBS Winning,2015,California,4,5,9,0.4444444444444444
vs. FBS Non-Winning,2015,California,3,0,3,1.0
vs. BCS AQ,2015,California,5,5,10,0.5
vs. BCS non-AQ,2015,California,2,0,2,1.0
vs. FBS Power 5,2015,California,5,5,10,0.5
vs. FBS non-Power 5,2015,California,2,0,2,1.0
in August/September,2015,California,4,0,4,1.0
in October,2015,California,1,3,4,0.25
in November,2015,California,2,2,4,0.5
in December/January,2015,California,1,0,1,1.0
All Games,2016,California,5,7,12,0.4166666666666667
at Home,2016,California,4,2,6,0.6666666666666666
on Road/Neutral Site,2016,California,1,5,6,0.16666666666666666
vs. Conference,2016,California,3,6,9,0.3333333333333333
vs. Non-Conference,2016,California,2,1,3,0.6666666666666666
vs. Ranked (AP),2016,California,0,3,3,0.0
vs. Unranked (AP),2016,California,5,4,9,0.5555555555555556
vs. FBS (I-A),2016,California,5,7,12,0.4166666666666667
vs. FCS (I-AA),2016,California,0,0,0,
vs. FBS Winning,2016,California,1,5,6,0.16666666666666666
vs. FBS Non-Winning,2016,California,4,2,6,0.6666666666666666
vs. BCS AQ,2016,California,4,6,10,0.4
vs. BCS non-AQ,2016,California,1,1,2,0.5
vs. FBS Power 5,2016,California,4,6,10,0.4
vs. FBS non-Power 5,2016,California,1,1,2,0.5
in August/September,2016,California,2,2,4,0.5
in October,2016,California,2,2,4,0.5
in November,2016,California,1,3,4,0.25
in December/January,2016,California,0,0,0,
All Games,2017,California,5,7,12,0.4166666666666667
at Home,2017,California,4,2,6,0.6666666666666666
on Road/Neutral Site,2017,California,1,5,6,0.16666666666666666
vs. Conference,2017,California,2,7,9,0.2222222222222222
vs. Non-Conference,2017,California,3,0,3,1.0
vs. Ranked (AP),2017,California,0,3,3,0.0
vs. Unranked (AP),2017,California,5,4,9,0.5555555555555556
vs. FBS (I-A),2017,California,4,7,11,0.36363636363636365
vs. FCS (I-AA),2017,California,1,0,1,1.0
vs. FBS Winning,2017,California,1,5,6,0.16666666666666666
vs. FBS Non-Winning,2017,California,3,2,5,0.6
vs. BCS AQ,2017,California,4,7,11,0.36363636363636365
vs. BCS non-AQ,2017,California,0,0,0,
vs. FBS Power 5,2017,California,4,7,11,0.36363636363636365
vs. FBS non-Power 5,2017,California,0,0,0,
in August/September,2017,California,3,2,5,0.6
in October,2017,California,1,3,4,0.25
in November,2017,California,1,2,3,0.3333333333333333
in December/January,2017,California,0,0,0,
All Games,2018,California,7,6,13,0.5384615384615384
at Home,2018,California,4,3,7,0.5714285714285714
on Road/Neutral Site,2018,California,3,3,6,0.5
vs. Conference,2018,California,4,5,9,0.4444444444444444
vs. Non-Conference,2018,California,3,1,4,0.75
vs. Ranked (AP),2018,California,1,1,2,0.5
vs. Unranked (AP),2018,California,6,5,11,0.5454545454545454
vs. FBS (I-A),2018,California,6,6,12,0.5
vs. FCS (I-AA),2018,California,1,0,1,1.0
vs. FBS Winning,2018,California,2,4,6,0.3333333333333333
vs. FBS Non-Winning,2018,California,4,2,6,0.6666666666666666
vs. BCS AQ,2018,California,5,6,11,0.45454545454545453
vs. BCS non-AQ,2018,California,1,0,1,1.0
vs. FBS Power 5,2018,California,5,6,11,0.45454545454545453
vs. FBS non-Power 5,2018,California,1,0,1,1.0
in August/September,2018,California,3,1,4,0.75
in October,2018,California,2,2,4,0.5
in November,2018,California,2,1,3,0.6666666666666666
in December/January,2018,California,0,2,2,0.0
All Games,2019,California,8,5,13,0.6153846153846154
at Home,2019,California,3,3,6,0.5
on Road/Neutral Site,2019,California,5,2,7,0.7142857142857143
vs. Conference,2019,California,4,5,9,0.4444444444444444
vs. Non-Conference,2019,California,4,0,4,1.0
vs. Ranked (AP),2019,California,0,2,2,0.0
vs. Unranked (AP),2019,California,8,3,11,0.7272727272727273
vs. FBS (I-A),2019,California,7,5,12,0.5833333333333334
vs. FCS (I-AA),2019,California,1,0,1,1.0
vs. FBS Winning,2019,California,1,4,5,0.2
vs. FBS Non-Winning,2019,California,6,1,7,0.8571428571428571
vs. BCS AQ,2019,California,6,5,11,0.5454545454545454
vs. BCS non-AQ,2019,California,1,0,1,1.0
vs. FBS Power 5,2019,California,6,5,11,0.5454545454545454
vs. FBS non-Power 5,2019,California,1,0,1,1.0
in August/September,2019,California,4,1,5,0.8
in October,2019,California,0,3,3,0.0
in November,2019,California,3,1,4,0.75
in December/January,2019,California,1,0,1,1.0
All Games,2020,California,1,3,4,0.25
at Home,2020,California,1,1,2,0.5
on Road/Neutral Site,2020,California,0,2,2,0.0
vs. Conference,2020,California,1,3,4,0.25
vs. Non-Conference,2020,California,0,0,0,
vs. Ranked (AP),2020,California,1,0,1,1.0
vs. Unranked (AP),2020,California,0,3,3,0.0
vs. FBS (I-A),2020,California,1,3,4,0.25
vs. FCS (I-AA),2020,California,0,0,0,
vs. FBS Winning,2020,California,1,1,2,0.5
vs. FBS Non-Winning,2020,California,0,2,2,0.0
vs. BCS AQ,2020,California,1,3,4,0.25
vs. BCS non-AQ,2020,California,0,0,0,
vs. FBS Power 5,2020,California,1,3,4,0.25
vs. FBS non-Power 5,2020,California,0,0,0,
in August/September,2020,California,0,0,0,
in October,2020,California,0,0,0,
in November,2020,California,0,3,3,0.0
in December/January,2020,California,1,0,1,1.0
All Games,2021,California,5,7,12,0.4166666666666667
at Home,2021,California,4,2,6,0.6666666666666666
on Road/Neutral Site,2021,California,1,5,6,0.16666666666666666
vs. Conference,2021,California,4,5,9,0.4444444444444444
vs. Non-Conference,2021,California,1,2,3,0.3333333333333333
vs. Ranked (AP),2021,California,0,1,1,0.0
vs. Unranked (AP),2021,California,5,6,11,0.45454545454545453
vs. FBS (I-A),2021,California,4,7,11,0.36363636363636365
vs. FCS (I-AA),2021,California,1,0,1,1.0
vs. FBS Winning,2021,California,1,4,5,0.2
vs. FBS Non-Winning,2021,California,3,3,6,0.5
vs. BCS AQ,2021,California,4,6,10,0.4
vs. BCS non-AQ,2021,California,0,1,1,0.0
vs. FBS Power 5,2021,California,4,6,10,0.4
vs. FBS non-Power 5,2021,California,0,1,1,0.0
in August/September,2021,California,1,3,4,0.25
in October,2021,California,2,2,4,0.5
in November,2021,California,1,2,3,0.3333333333333333
in December/January,2021,California,1,0,1,1.0
All Games,2022,California,4,8,12,0.3333333333333333
at Home,2022,California,4,3,7,0.5714285714285714
on Road/Neutral Site,2022,California,0,5,5,0.0
vs. Conference,2022,California,2,7,9,0.2222222222222222
vs. Non-Conference,2022,California,2,1,3,0.6666666666666666
vs. Ranked (AP),2022,California,0,6,6,0.0
vs. Unranked (AP),2022,California,4,2,6,0.6666666666666666
vs. FBS (I-A),2022,California,3,8,11,0.2727272727272727
vs. FCS (I-AA),2022,California,1,0,1,1.0
vs. FBS Winning,2022,California,0,7,7,0.0
vs. FBS Non-Winning,2022,California,3,1,4,0.75
vs. BCS AQ,2022,California,2,8,10,0.2
vs. BCS non-AQ,2022,California,1,0,1,1.0
vs. FBS Power 5,2022,California,2,7,9,0.2222222222222222
vs. FBS non-Power 5,2022,California,1,1,2,0.5
in August/September,2022,California,3,1,4,0.75
in October,2022,California,0,4,4,0.0
in November,2022,California,1,3,4,0.25
in December/January,2022,California,0,0,0,
All Games,2009,Central Michigan,12,2,14,0.8571428571428571
at Home,2009,Central Michigan,5,0,5,1.0
on Road/Neutral Site,2009,Central Michigan,7,2,9,0.7777777777777778
vs. Conference,2009,Central Michigan,9,0,9,1.0
vs. Non-Conference,2009,Central Michigan,3,2,5,0.6
vs. Ranked (AP),2009,Central Michigan,0,0,0,
vs. Unranked (AP),2009,Central Michigan,12,2,14,0.8571428571428571
vs. FBS (I-A),2009,Central Michigan,11,2,13,0.8461538461538461
vs. FCS (I-AA),2009,Central Michigan,1,0,1,1.0
vs. FBS Winning,2009,Central Michigan,4,2,6,0.6666666666666666
vs. FBS Non-Winning,2009,Central Michigan,7,0,7,1.0
vs. BCS AQ,2009,Central Michigan,1,2,3,0.3333333333333333
vs. BCS non-AQ,2009,Central Michigan,10,0,10,1.0
vs. FBS Power 5,2009,Central Michigan,1,2,3,0.3333333333333333
vs. FBS non-Power 5,2009,Central Michigan,10,0,10,1.0
in August/September,2009,Central Michigan,3,1,4,0.75
in October,2009,Central Michigan,4,1,5,0.8
in November,2009,Central Michigan,3,0,3,1.0
in December/January,2009,Central Michigan,2,0,2,1.0
All Games,2010,Central Michigan,3,9,12,0.25
at Home,2010,Central Michigan,2,3,5,0.4
on Road/Neutral Site,2010,Central Michigan,1,6,7,0.14285714285714285
vs. Conference,2010,Central Michigan,2,6,8,0.25
vs. Non-Conference,2010,Central Michigan,1,3,4,0.25
vs. Ranked (AP),2010,Central Michigan,0,1,1,0.0
vs. Unranked (AP),2010,Central Michigan,3,8,11,0.2727272727272727
vs. FBS (I-A),2010,Central Michigan,2,9,11,0.18181818181818182
vs. FCS (I-AA),2010,Central Michigan,1,0,1,1.0
vs. FBS Winning,2010,Central Michigan,0,7,7,0.0
vs. FBS Non-Winning,2010,Central Michigan,2,2,4,0.5
vs. BCS AQ,2010,Central Michigan,0,2,2,0.0
vs. BCS non-AQ,2010,Central Michigan,2,7,9,0.2222222222222222
vs. FBS Power 5,2010,Central Michigan,0,2,2,0.0
vs. FBS non-Power 5,2010,Central Michigan,2,7,9,0.2222222222222222
in August/September,2010,Central Michigan,2,2,4,0.5
in October,2010,Central Michigan,0,5,5,0.0
in November,2010,Central Michigan,1,2,3,0.3333333333333333
in December/January,2010,Central Michigan,0,0,0,
All Games,2011,Central Michigan,3,9,12,0.25
at Home,2011,Central Michigan,2,3,5,0.4
on Road/Neutral Site,2011,Central Michigan,1,6,7,0.14285714285714285
vs. Conference,2011,Central Michigan,2,6,8,0.25
vs. Non-Conference,2011,Central Michigan,1,3,4,0.25
vs. Ranked (AP),2011,Central Michigan,0,1,1,0.0
vs. Unranked (AP),2011,Central Michigan,3,8,11,0.2727272727272727
vs. FBS (I-A),2011,Central Michigan,2,9,11,0.18181818181818182
vs. FCS (I-AA),2011,Central Michigan,1,0,1,1.0
vs. FBS Winning,2011,Central Michigan,1,5,6,0.16666666666666666
vs. FBS Non-Winning,2011,Central Michigan,1,4,5,0.2
vs. BCS AQ,2011,Central Michigan,0,3,3,0.0
vs. BCS non-AQ,2011,Central Michigan,2,6,8,0.25
vs. FBS Power 5,2011,Central Michigan,0,3,3,0.0
vs. FBS non-Power 5,2011,Central Michigan,2,6,8,0.25
in August/September,2011,Central Michigan,1,3,4,0.25
in October,2011,Central Michigan,2,3,5,0.4
in November,2011,Central Michigan,0,3,3,0.0
in December/January,2011,Central Michigan,0,0,0,
All Games,2012,Central Michigan,7,6,13,0.5384615384615384
at Home,2012,Central Michigan,3,4,7,0.42857142857142855
on Road/Neutral Site,2012,Central Michigan,4,2,6,0.6666666666666666
vs. Conference,2012,Central Michigan,4,4,8,0.5
vs. Non-Conference,2012,Central Michigan,3,2,5,0.6
vs. Ranked (AP),2012,Central Michigan,0,1,1,0.0
vs. Unranked (AP),2012,Central Michigan,7,5,12,0.5833333333333334
vs. FBS (I-A),2012,Central Michigan,6,6,12,0.5
vs. FCS (I-AA),2012,Central Michigan,1,0,1,1.0
vs. FBS Winning,2012,Central Michigan,1,5,6,0.16666666666666666
vs. FBS Non-Winning,2012,Central Michigan,5,1,6,0.8333333333333334
vs. BCS AQ,2012,Central Michigan,1,1,2,0.5
vs. BCS non-AQ,2012,Central Michigan,5,5,10,0.5
vs. FBS Power 5,2012,Central Michigan,1,1,2,0.5
vs. FBS non-Power 5,2012,Central Michigan,5,5,10,0.5
in August/September,2012,Central Michigan,2,2,4,0.5
in October,2012,Central Michigan,1,3,4,0.25
in November,2012,Central Michigan,3,1,4,0.75
in December/January,2012,Central Michigan,1,0,1,1.0
All Games,2013,Central Michigan,6,6,12,0.5
at Home,2013,Central Michigan,3,2,5,0.6
on Road/Neutral Site,2013,Central Michigan,3,4,7,0.42857142857142855
vs. Conference,2013,Central Michigan,5,3,8,0.625
vs. Non-Conference,2013,Central Michigan,1,3,4,0.25
vs. Ranked (AP),2013,Central Michigan,0,0,0,
vs. Unranked (AP),2013,Central Michigan,6,6,12,0.5
vs. FBS (I-A),2013,Central Michigan,5,6,11,0.45454545454545453
vs. FCS (I-AA),2013,Central Michigan,1,0,1,1.0
vs. FBS Winning,2013,Central Michigan,1,5,6,0.16666666666666666
vs. FBS Non-Winning,2013,Central Michigan,4,1,5,0.8
vs. BCS AQ,2013,Central Michigan,0,2,2,0.0
vs. BCS non-AQ,2013,Central Michigan,5,4,9,0.5555555555555556
vs. FBS Power 5,2013,Central Michigan,0,2,2,0.0
vs. FBS non-Power 5,2013,Central Michigan,5,4,9,0.5555555555555556
in August/September,2013,Central Michigan,1,4,5,0.2
in October,2013,Central Michigan,2,1,3,0.6666666666666666
in November,2013,Central Michigan,3,1,4,0.75
in December/January,2013,Central Michigan,0,0,0,
All Games,2014,Central Michigan,7,6,13,0.5384615384615384
at Home,2014,Central Michigan,3,3,6,0.5
on Road/Neutral Site,2014,Central Michigan,4,3,7,0.5714285714285714
vs. Conference,2014,Central Michigan,5,3,8,0.625
vs. Non-Conference,2014,Central Michigan,2,3,5,0.4
vs. Ranked (AP),2014,Central Michigan,0,0,0,
vs. Unranked (AP),2014,Central Michigan,7,6,13,0.5384615384615384
vs. FBS (I-A),2014,Central Michigan,6,6,12,0.5
vs. FCS (I-AA),2014,Central Michigan,1,0,1,1.0
vs. FBS Winning,2014,Central Michigan,1,3,4,0.25
vs. FBS Non-Winning,2014,Central Michigan,5,3,8,0.625
vs. BCS AQ,2014,Central Michigan,1,2,3,0.3333333333333333
vs. BCS non-AQ,2014,Central Michigan,5,4,9,0.5555555555555556
vs. FBS Power 5,2014,Central Michigan,1,2,3,0.3333333333333333
vs. FBS non-Power 5,2014,Central Michigan,5,4,9,0.5555555555555556
in August/September,2014,Central Michigan,2,3,5,0.4
in October,2014,Central Michigan,3,1,4,0.75
in November,2014,Central Michigan,2,1,3,0.6666666666666666
in December/January,2014,Central Michigan,0,1,1,0.0
All Games,2015,Central Michigan,7,6,13,0.5384615384615384
at Home,2015,Central Michigan,4,2,6,0.6666666666666666
on Road/Neutral Site,2015,Central Michigan,3,4,7,0.42857142857142855
vs. Conference,2015,Central Michigan,6,2,8,0.75
vs. Non-Conference,2015,Central Michigan,1,4,5,0.2
vs. Ranked (AP),2015,Central Michigan,0,2,2,0.0
vs. Unranked (AP),2015,Central Michigan,7,4,11,0.6363636363636364
vs. FBS (I-A),2015,Central Michigan,6,6,12,0.5
vs. FCS (I-AA),2015,Central Michigan,1,0,1,1.0
vs. FBS Winning,2015,Central Michigan,2,4,6,0.3333333333333333
vs. FBS Non-Winning,2015,Central Michigan,4,2,6,0.6666666666666666
vs. BCS AQ,2015,Central Michigan,0,4,4,0.0
vs. BCS non-AQ,2015,Central Michigan,6,2,8,0.75
vs. FBS Power 5,2015,Central Michigan,0,4,4,0.0
vs. FBS non-Power 5,2015,Central Michigan,6,2,8,0.75
in August/September,2015,Central Michigan,1,3,4,0.25
in October,2015,Central Michigan,4,1,5,0.8
in November,2015,Central Michigan,2,1,3,0.6666666666666666
in December/January,2015,Central Michigan,0,1,1,0.0
All Games,2016,Central Michigan,6,7,13,0.46153846153846156
at Home,2016,Central Michigan,4,2,6,0.6666666666666666
on Road/Neutral Site,2016,Central Michigan,2,5,7,0.2857142857142857
vs. Conference,2016,Central Michigan,3,5,8,0.375
vs. Non-Conference,2016,Central Michigan,3,2,5,0.6
vs. Ranked (AP),2016,Central Michigan,1,1,2,0.5
vs. Unranked (AP),2016,Central Michigan,5,6,11,0.45454545454545453
vs. FBS (I-A),2016,Central Michigan,5,7,12,0.4166666666666667
vs. FCS (I-AA),2016,Central Michigan,1,0,1,1.0
vs. FBS Winning,2016,Central Michigan,2,4,6,0.3333333333333333
vs. FBS Non-Winning,2016,Central Michigan,3,3,6,0.5
vs. BCS AQ,2016,Central Michigan,1,2,3,0.3333333333333333
vs. BCS non-AQ,2016,Central Michigan,4,5,9,0.4444444444444444
vs. FBS Power 5,2016,Central Michigan,1,1,2,0.5
vs. FBS non-Power 5,2016,Central Michigan,4,6,10,0.4
in August/September,2016,Central Michigan,3,1,4,0.75
in October,2016,Central Michigan,2,3,5,0.4
in November,2016,Central Michigan,1,2,3,0.3333333333333333
in December/January,2016,Central Michigan,0,1,1,0.0
All Games,2017,Central Michigan,8,5,13,0.6153846153846154
at Home,2017,Central Michigan,3,2,5,0.6
on Road/Neutral Site,2017,Central Michigan,5,3,8,0.625
vs. Conference,2017,Central Michigan,6,2,8,0.75
vs. Non-Conference,2017,Central Michigan,2,3,5,0.4
vs. Ranked (AP),2017,Central Michigan,0,0,0,
vs. Unranked (AP),2017,Central Michigan,8,5,13,0.6153846153846154
vs. FBS (I-A),2017,Central Michigan,7,5,12,0.5833333333333334
vs. FCS (I-AA),2017,Central Michigan,1,0,1,1.0
vs. FBS Winning,2017,Central Michigan,2,3,5,0.4
vs. FBS Non-Winning,2017,Central Michigan,5,2,7,0.7142857142857143
vs. BCS AQ,2017,Central Michigan,1,2,3,0.3333333333333333
vs. BCS non-AQ,2017,Central Michigan,6,3,9,0.6666666666666666
vs. FBS Power 5,2017,Central Michigan,1,2,3,0.3333333333333333
vs. FBS non-Power 5,2017,Central Michigan,6,3,9,0.6666666666666666
in August/September,2017,Central Michigan,2,3,5,0.4
in October,2017,Central Michigan,2,1,3,0.6666666666666666
in November,2017,Central Michigan,4,0,4,1.0
in December/January,2017,Central Michigan,0,1,1,0.0
All Games,2018,Central Michigan,1,11,12,0.08333333333333333
at Home,2018,Central Michigan,1,5,6,0.16666666666666666
on Road/Neutral Site,2018,Central Michigan,0,6,6,0.0
vs. Conference,2018,Central Michigan,0,8,8,0.0
vs. Non-Conference,2018,Central Michigan,1,3,4,0.25
vs. Ranked (AP),2018,Central Michigan,0,1,1,0.0
vs. Unranked (AP),2018,Central Michigan,1,10,11,0.09090909090909091
vs. FBS (I-A),2018,Central Michigan,0,11,11,0.0
vs. FCS (I-AA),2018,Central Michigan,1,0,1,1.0
vs. FBS Winning,2018,Central Michigan,0,7,7,0.0
vs. FBS Non-Winning,2018,Central Michigan,0,4,4,0.0
vs. BCS AQ,2018,Central Michigan,0,3,3,0.0
vs. BCS non-AQ,2018,Central Michigan,0,8,8,0.0
vs. FBS Power 5,2018,Central Michigan,0,3,3,0.0
vs. FBS non-Power 5,2018,Central Michigan,0,8,8,0.0
in August/September,2018,Central Michigan,1,4,5,0.2
in October,2018,Central Michigan,0,4,4,0.0
in November,2018,Central Michigan,0,3,3,0.0
in December/January,2018,Central Michigan,0,0,0,
All Games,2019,Central Michigan,8,6,14,0.5714285714285714
at Home,2019,Central Michigan,6,0,6,1.0
on Road/Neutral Site,2019,Central Michigan,2,6,8,0.25
vs. Conference,2019,Central Michigan,6,3,9,0.6666666666666666
vs. Non-Conference,2019,Central Michigan,2,3,5,0.4
vs. Ranked (AP),2019,Central Michigan,0,1,1,0.0
vs. Unranked (AP),2019,Central Michigan,8,5,13,0.6153846153846154
vs. FBS (I-A),2019,Central Michigan,7,6,13,0.5384615384615384
vs. FCS (I-AA),2019,Central Michigan,1,0,1,1.0
vs. FBS Winning,2019,Central Michigan,0,5,5,0.0
vs. FBS Non-Winning,2019,Central Michigan,7,1,8,0.875
vs. BCS AQ,2019,Central Michigan,0,2,2,0.0
vs. BCS non-AQ,2019,Central Michigan,7,4,11,0.6363636363636364
vs. FBS Power 5,2019,Central Michigan,0,2,2,0.0
vs. FBS non-Power 5,2019,Central Michigan,7,4,11,0.6363636363636364
in August/September,2019,Central Michigan,2,3,5,0.4
in October,2019,Central Michigan,3,1,4,0.75
in November,2019,Central Michigan,3,0,3,1.0
in December/January,2019,Central Michigan,0,2,2,0.0
All Games,2020,Central Michigan,3,3,6,0.5
at Home,2020,Central Michigan,1,2,3,0.3333333333333333
on Road/Neutral Site,2020,Central Michigan,2,1,3,0.6666666666666666
vs. Conference,2020,Central Michigan,3,3,6,0.5
vs. Non-Conference,2020,Central Michigan,0,0,0,
vs. Ranked (AP),2020,Central Michigan,0,0,0,
vs. Unranked (AP),2020,Central Michigan,3,3,6,0.5
vs. FBS (I-A),2020,Central Michigan,3,3,6,0.5
vs. FCS (I-AA),2020,Central Michigan,0,0,0,
vs. FBS Winning,2020,Central Michigan,1,3,4,0.25
vs. FBS Non-Winning,2020,Central Michigan,2,0,2,1.0
vs. BCS AQ,2020,Central Michigan,0,0,0,
vs. BCS non-AQ,2020,Central Michigan,3,3,6,0.5
vs. FBS Power 5,2020,Central Michigan,0,0,0,
vs. FBS non-Power 5,2020,Central Michigan,3,3,6,0.5
in August/September,2020,Central Michigan,0,0,0,
in October,2020,Central Michigan,0,0,0,
in November,2020,Central Michigan,3,1,4,0.75
in December/January,2020,Central Michigan,0,2,2,0.0
All Games,2021,Central Michigan,9,4,13,0.6923076923076923
at Home,2021,Central Michigan,5,1,6,0.8333333333333334
on Road/Neutral Site,2021,Central Michigan,4,3,7,0.5714285714285714
vs. Conference,2021,Central Michigan,6,2,8,0.75
vs. Non-Conference,2021,Central Michigan,3,2,5,0.6
vs. Ranked (AP),2021,Central Michigan,0,0,0,
vs. Unranked (AP),2021,Central Michigan,9,4,13,0.6923076923076923
vs. FBS (I-A),2021,Central Michigan,8,4,12,0.6666666666666666
vs. FCS (I-AA),2021,Central Michigan,1,0,1,1.0
vs. FBS Winning,2021,Central Michigan,4,2,6,0.6666666666666666
vs. FBS Non-Winning,2021,Central Michigan,4,2,6,0.6666666666666666
vs. BCS AQ,2021,Central Michigan,1,2,3,0.3333333333333333
vs. BCS non-AQ,2021,Central Michigan,7,2,9,0.7777777777777778
vs. FBS Power 5,2021,Central Michigan,1,2,3,0.3333333333333333
vs. FBS non-Power 5,2021,Central Michigan,7,2,9,0.7777777777777778
in August/September,2021,Central Michigan,2,2,4,0.5
in October,2021,Central Michigan,2,2,4,0.5
in November,2021,Central Michigan,4,0,4,1.0
in December/January,2021,Central Michigan,1,0,1,1.0
All Games,2022,Central Michigan,4,8,12,0.3333333333333333
at Home,2022,Central Michigan,2,4,6,0.3333333333333333
on Road/Neutral Site,2022,Central Michigan,2,4,6,0.3333333333333333
vs. Conference,2022,Central Michigan,3,5,8,0.375
vs. Non-Conference,2022,Central Michigan,1,3,4,0.25
vs. Ranked (AP),2022,Central Michigan,0,1,1,0.0
vs. Unranked (AP),2022,Central Michigan,4,7,11,0.36363636363636365
vs. FBS (I-A),2022,Central Michigan,3,8,11,0.2727272727272727
vs. FCS (I-AA),2022,Central Michigan,1,0,1,1.0
vs. FBS Winning,2022,Central Michigan,1,5,6,0.16666666666666666
vs. FBS Non-Winning,2022,Central Michigan,2,3,5,0.4
vs. BCS AQ,2022,Central Michigan,0,2,2,0.0
vs. BCS non-AQ,2022,Central Michigan,3,6,9,0.3333333333333333
vs. FBS Power 5,2022,Central Michigan,0,2,2,0.0
vs. FBS non-Power 5,2022,Central Michigan,3,6,9,0.3333333333333333
in August/September,2022,Central Michigan,1,3,4,0.25
in October,2022,Central Michigan,1,3,4,0.25
in November,2022,Central Michigan,2,2,4,0.5
in December/January,2022,Central Michigan,0,0,0,
All Games,2015,Charlotte,2,10,12,0.16666666666666666
at Home,2015,Charlotte,1,5,6,0.16666666666666666
on Road/Neutral Site,2015,Charlotte,1,5,6,0.16666666666666666
vs. Conference,2015,Charlotte,0,8,8,0.0
vs. Non-Conference,2015,Charlotte,2,2,4,0.5
vs. Ranked (AP),2015,Charlotte,0,0,0,
vs. Unranked (AP),2015,Charlotte,2,10,12,0.16666666666666666
vs. FBS (I-A),2015,Charlotte,1,10,11,0.09090909090909091
vs. FCS (I-AA),2015,Charlotte,1,0,1,1.0
vs. FBS Winning,2015,Charlotte,0,4,4,0.0
vs. FBS Non-Winning,2015,Charlotte,1,6,7,0.14285714285714285
vs. BCS AQ,2015,Charlotte,0,2,2,0.0
vs. BCS non-AQ,2015,Charlotte,1,8,9,0.1111111111111111
vs. FBS Power 5,2015,Charlotte,0,1,1,0.0
vs. FBS non-Power 5,2015,Charlotte,1,9,10,0.1
in August/September,2015,Charlotte,2,2,4,0.5
in October,2015,Charlotte,0,4,4,0.0
in November,2015,Charlotte,0,4,4,0.0
in December/January,2015,Charlotte,0,0,0,
All Games,2016,Charlotte,4,8,12,0.3333333333333333
at Home,2016,Charlotte,1,5,6,0.16666666666666666
on Road/Neutral Site,2016,Charlotte,3,3,6,0.5
vs. Conference,2016,Charlotte,3,5,8,0.375
vs. Non-Conference,2016,Charlotte,1,3,4,0.25
vs. Ranked (AP),2016,Charlotte,0,2,2,0.0
vs. Unranked (AP),2016,Charlotte,4,6,10,0.4
vs. FBS (I-A),2016,Charlotte,3,8,11,0.2727272727272727
vs. FCS (I-AA),2016,Charlotte,1,0,1,1.0
vs. FBS Winning,2016,Charlotte,1,5,6,0.16666666666666666
vs. FBS Non-Winning,2016,Charlotte,2,3,5,0.4
vs. BCS AQ,2016,Charlotte,0,2,2,0.0
vs. BCS non-AQ,2016,Charlotte,3,6,9,0.3333333333333333
vs. FBS Power 5,2016,Charlotte,0,1,1,0.0
vs. FBS non-Power 5,2016,Charlotte,3,7,10,0.3
in August/September,2016,Charlotte,1,3,4,0.25
in October,2016,Charlotte,2,2,4,0.5
in November,2016,Charlotte,1,3,4,0.25
in December/January,2016,Charlotte,0,0,0,
All Games,2017,Charlotte,1,11,12,0.08333333333333333
at Home,2017,Charlotte,1,5,6,0.16666666666666666
on Road/Neutral Site,2017,Charlotte,0,6,6,0.0
vs. Conference,2017,Charlotte,1,7,8,0.125
vs. Non-Conference,2017,Charlotte,0,4,4,0.0
vs. Ranked (AP),2017,Charlotte,0,0,0,
vs. Unranked (AP),2017,Charlotte,1,11,12,0.08333333333333333
vs. FBS (I-A),2017,Charlotte,1,10,11,0.09090909090909091
vs. FCS (I-AA),2017,Charlotte,0,1,1,0.0
vs. FBS Winning,2017,Charlotte,1,7,8,0.125
vs. FBS Non-Winning,2017,Charlotte,0,3,3,0.0
vs. BCS AQ,2017,Charlotte,0,1,1,0.0
vs. BCS non-AQ,2017,Charlotte,1,9,10,0.1
vs. FBS Power 5,2017,Charlotte,0,1,1,0.0
vs. FBS non-Power 5,2017,Charlotte,1,9,10,0.1
in August/September,2017,Charlotte,0,5,5,0.0
in October,2017,Charlotte,1,2,3,0.3333333333333333
in November,2017,Charlotte,0,4,4,0.0
in December/January,2017,Charlotte,0,0,0,
All Games,2018,Charlotte,5,7,12,0.4166666666666667
at Home,2018,Charlotte,4,2,6,0.6666666666666666
on Road/Neutral Site,2018,Charlotte,1,5,6,0.16666666666666666
vs. Conference,2018,Charlotte,4,4,8,0.5
vs. Non-Conference,2018,Charlotte,1,3,4,0.25
vs. Ranked (AP),2018,Charlotte,0,0,0,
vs. Unranked (AP),2018,Charlotte,5,7,12,0.4166666666666667
vs. FBS (I-A),2018,Charlotte,4,7,11,0.36363636363636365
vs. FCS (I-AA),2018,Charlotte,1,0,1,1.0
vs. FBS Winning,2018,Charlotte,1,5,6,0.16666666666666666
vs. FBS Non-Winning,2018,Charlotte,3,2,5,0.6
vs. BCS AQ,2018,Charlotte,0,1,1,0.0
vs. BCS non-AQ,2018,Charlotte,4,6,10,0.4
vs. FBS Power 5,2018,Charlotte,0,1,1,0.0
vs. FBS non-Power 5,2018,Charlotte,4,6,10,0.4
in August/September,2018,Charlotte,2,3,5,0.4
in October,2018,Charlotte,2,1,3,0.6666666666666666
in November,2018,Charlotte,1,3,4,0.25
in December/January,2018,Charlotte,0,0,0,
All Games,2019,Charlotte,7,6,13,0.5384615384615384
at Home,2019,Charlotte,5,1,6,0.8333333333333334
on Road/Neutral Site,2019,Charlotte,2,5,7,0.2857142857142857
vs. Conference,2019,Charlotte,5,3,8,0.625
vs. Non-Conference,2019,Charlotte,2,3,5,0.4
vs. Ranked (AP),2019,Charlotte,0,2,2,0.0
vs. Unranked (AP),2019,Charlotte,7,4,11,0.6363636363636364
vs. FBS (I-A),2019,Charlotte,6,6,12,0.5
vs. FCS (I-AA),2019,Charlotte,1,0,1,1.0
vs. FBS Winning,2019,Charlotte,1,5,6,0.16666666666666666
vs. FBS Non-Winning,2019,Charlotte,5,1,6,0.8333333333333334
vs. BCS AQ,2019,Charlotte,0,1,1,0.0
vs. BCS non-AQ,2019,Charlotte,6,5,11,0.5454545454545454
vs. FBS Power 5,2019,Charlotte,0,1,1,0.0
vs. FBS non-Power 5,2019,Charlotte,6,5,11,0.5454545454545454
in August/September,2019,Charlotte,2,3,5,0.4
in October,2019,Charlotte,1,2,3,0.3333333333333333
in November,2019,Charlotte,4,0,4,1.0
in December/January,2019,Charlotte,0,1,1,0.0
All Games,2020,Charlotte,2,4,6,0.3333333333333333
at Home,2020,Charlotte,1,1,2,0.5
on Road/Neutral Site,2020,Charlotte,1,3,4,0.25
vs. Conference,2020,Charlotte,2,2,4,0.5
vs. Non-Conference,2020,Charlotte,0,2,2,0.0
vs. Ranked (AP),2020,Charlotte,0,0,0,
vs. Unranked (AP),2020,Charlotte,2,4,6,0.3333333333333333
vs. FBS (I-A),2020,Charlotte,2,4,6,0.3333333333333333
vs. FCS (I-AA),2020,Charlotte,0,0,0,
vs. FBS Winning,2020,Charlotte,0,2,2,0.0
vs. FBS Non-Winning,2020,Charlotte,2,2,4,0.5
vs. BCS AQ,2020,Charlotte,0,1,1,0.0
vs. BCS non-AQ,2020,Charlotte,2,3,5,0.4
vs. FBS Power 5,2020,Charlotte,0,1,1,0.0
vs. FBS non-Power 5,2020,Charlotte,2,3,5,0.4
in August/September,2020,Charlotte,0,1,1,0.0
in October,2020,Charlotte,2,2,4,0.5
in November,2020,Charlotte,0,0,0,
in December/January,2020,Charlotte,0,1,1,0.0
All Games,2021,Charlotte,5,7,12,0.4166666666666667
at Home,2021,Charlotte,4,2,6,0.6666666666666666
on Road/Neutral Site,2021,Charlotte,1,5,6,0.16666666666666666
vs. Conference,2021,Charlotte,3,5,8,0.375
vs. Non-Conference,2021,Charlotte,2,2,4,0.5
vs. Ranked (AP),2021,Charlotte,0,0,0,
vs. Unranked (AP),2021,Charlotte,5,7,12,0.4166666666666667
vs. FBS (I-A),2021,Charlotte,4,7,11,0.36363636363636365
vs. FCS (I-AA),2021,Charlotte,1,0,1,1.0
vs. FBS Winning,2021,Charlotte,1,3,4,0.25
vs. FBS Non-Winning,2021,Charlotte,3,4,7,0.42857142857142855
vs. BCS AQ,2021,Charlotte,1,1,2,0.5
vs. BCS non-AQ,2021,Charlotte,3,6,9,0.3333333333333333
vs. FBS Power 5,2021,Charlotte,1,1,2,0.5
vs. FBS non-Power 5,2021,Charlotte,3,6,9,0.3333333333333333
in August/September,2021,Charlotte,3,1,4,0.75
in October,2021,Charlotte,1,3,4,0.25
in November,2021,Charlotte,1,3,4,0.25
in December/January,2021,Charlotte,0,0,0,
All Games,2022,Charlotte,3,9,12,0.25
at Home,2022,Charlotte,1,5,6,0.16666666666666666
on Road/Neutral Site,2022,Charlotte,2,4,6,0.3333333333333333
vs. Conference,2022,Charlotte,2,6,8,0.25
vs. Non-Conference,2022,Charlotte,1,3,4,0.25
vs. Ranked (AP),2022,Charlotte,0,1,1,0.0
vs. Unranked (AP),2022,Charlotte,3,8,11,0.2727272727272727
vs. FBS (I-A),2022,Charlotte,3,8,11,0.2727272727272727
vs. FCS (I-AA),2022,Charlotte,0,1,1,0.0
vs. FBS Winning,2022,Charlotte,0,5,5,0.0
vs. FBS Non-Winning,2022,Charlotte,3,3,6,0.5
vs. BCS AQ,2022,Charlotte,0,2,2,0.0
vs. BCS non-AQ,2022,Charlotte,3,6,9,0.3333333333333333
vs. FBS Power 5,2022,Charlotte,0,2,2,0.0
vs. FBS non-Power 5,2022,Charlotte,3,6,9,0.3333333333333333
in August/September,2022,Charlotte,1,4,5,0.2
in October,2022,Charlotte,1,3,4,0.25
in November,2022,Charlotte,1,2,3,0.3333333333333333
in December/January,2022,Charlotte,0,0,0,
All Games,2009,Cincinnati,12,1,13,0.9230769230769231
at Home,2009,Cincinnati,6,0,6,1.0
on Road/Neutral Site,2009,Cincinnati,6,1,7,0.8571428571428571
vs. Conference,2009,Cincinnati,7,0,7,1.0
vs. Non-Conference,2009,Cincinnati,5,1,6,0.8333333333333334
vs. Ranked (AP),2009,Cincinnati,2,1,3,0.6666666666666666
vs. Unranked (AP),2009,Cincinnati,10,0,10,1.0
vs. FBS (I-A),2009,Cincinnati,11,1,12,0.9166666666666666
vs. FCS (I-AA),2009,Cincinnati,1,0,1,1.0
vs. FBS Winning,2009,Cincinnati,7,1,8,0.875
vs. FBS Non-Winning,2009,Cincinnati,4,0,4,1.0
vs. BCS AQ,2009,Cincinnati,9,1,10,0.9
vs. BCS non-AQ,2009,Cincinnati,2,0,2,1.0
vs. FBS Power 5,2009,Cincinnati,2,1,3,0.6666666666666666
vs. FBS non-Power 5,2009,Cincinnati,9,0,9,1.0
in August/September,2009,Cincinnati,4,0,4,1.0
in October,2009,Cincinnati,4,0,4,1.0
in November,2009,Cincinnati,3,0,3,1.0
in December/January,2009,Cincinnati,1,1,2,0.5
All Games,2010,Cincinnati,4,8,12,0.3333333333333333
at Home,2010,Cincinnati,3,4,7,0.42857142857142855
on Road/Neutral Site,2010,Cincinnati,1,4,5,0.2
vs. Conference,2010,Cincinnati,2,5,7,0.2857142857142857
vs. Non-Conference,2010,Cincinnati,2,3,5,0.4
vs. Ranked (AP),2010,Cincinnati,0,2,2,0.0
vs. Unranked (AP),2010,Cincinnati,4,6,10,0.4
vs. FBS (I-A),2010,Cincinnati,3,8,11,0.2727272727272727
vs. FCS (I-AA),2010,Cincinnati,1,0,1,1.0
vs. FBS Winning,2010,Cincinnati,2,8,10,0.2
vs. FBS Non-Winning,2010,Cincinnati,1,0,1,1.0
vs. BCS AQ,2010,Cincinnati,2,7,9,0.2222222222222222
vs. BCS non-AQ,2010,Cincinnati,1,1,2,0.5
vs. FBS Power 5,2010,Cincinnati,0,2,2,0.0
vs. FBS non-Power 5,2010,Cincinnati,3,6,9,0.3333333333333333
in August/September,2010,Cincinnati,1,3,4,0.25
in October,2010,Cincinnati,2,2,4,0.5
in November,2010,Cincinnati,1,2,3,0.3333333333333333
in December/January,2010,Cincinnati,0,1,1,0.0
All Games,2011,Cincinnati,10,3,13,0.7692307692307693
at Home,2011,Cincinnati,5,1,6,0.8333333333333334
on Road/Neutral Site,2011,Cincinnati,5,2,7,0.7142857142857143
vs. Conference,2011,Cincinnati,5,2,7,0.7142857142857143
vs. Non-Conference,2011,Cincinnati,5,1,6,0.8333333333333334
vs. Ranked (AP),2011,Cincinnati,0,1,1,0.0
vs. Unranked (AP),2011,Cincinnati,10,2,12,0.8333333333333334
vs. FBS (I-A),2011,Cincinnati,9,3,12,0.75
vs. FCS (I-AA),2011,Cincinnati,1,0,1,1.0
vs. FBS Winning,2011,Cincinnati,2,2,4,0.5
vs. FBS Non-Winning,2011,Cincinnati,7,1,8,0.875
vs. BCS AQ,2011,Cincinnati,7,3,10,0.7
vs. BCS non-AQ,2011,Cincinnati,2,0,2,1.0
vs. FBS Power 5,2011,Cincinnati,2,1,3,0.6666666666666666
vs. FBS non-Power 5,2011,Cincinnati,7,2,9,0.7777777777777778
in August/September,2011,Cincinnati,3,1,4,0.75
in October,2011,Cincinnati,3,0,3,1.0
in November,2011,Cincinnati,2,2,4,0.5
in December/January,2011,Cincinnati,2,0,2,1.0
All Games,2012,Cincinnati,10,3,13,0.7692307692307693
at Home,2012,Cincinnati,6,1,7,0.8571428571428571
on Road/Neutral Site,2012,Cincinnati,4,2,6,0.6666666666666666
vs. Conference,2012,Cincinnati,5,2,7,0.7142857142857143
vs. Non-Conference,2012,Cincinnati,5,1,6,0.8333333333333334
vs. Ranked (AP),2012,Cincinnati,0,1,1,0.0
vs. Unranked (AP),2012,Cincinnati,10,2,12,0.8333333333333334
vs. FBS (I-A),2012,Cincinnati,8,3,11,0.7272727272727273
vs. FCS (I-AA),2012,Cincinnati,2,0,2,1.0
vs. FBS Winning,2012,Cincinnati,2,3,5,0.4
vs. FBS Non-Winning,2012,Cincinnati,6,0,6,1.0
vs. BCS AQ,2012,Cincinnati,7,2,9,0.7777777777777778
vs. BCS non-AQ,2012,Cincinnati,1,1,2,0.5
vs. FBS Power 5,2012,Cincinnati,2,0,2,1.0
vs. FBS non-Power 5,2012,Cincinnati,6,3,9,0.6666666666666666
in August/September,2012,Cincinnati,3,0,3,1.0
in October,2012,Cincinnati,2,2,4,0.5
in November,2012,Cincinnati,3,1,4,0.75
in December/January,2012,Cincinnati,2,0,2,1.0
All Games,2013,Cincinnati,9,4,13,0.6923076923076923
at Home,2013,Cincinnati,5,1,6,0.8333333333333334
on Road/Neutral Site,2013,Cincinnati,4,3,7,0.5714285714285714
vs. Conference,2013,Cincinnati,6,2,8,0.75
vs. Non-Conference,2013,Cincinnati,3,2,5,0.6
vs. Ranked (AP),2013,Cincinnati,0,1,1,0.0
vs. Unranked (AP),2013,Cincinnati,9,3,12,0.75
vs. FBS (I-A),2013,Cincinnati,8,4,12,0.6666666666666666
vs. FCS (I-AA),2013,Cincinnati,1,0,1,1.0
vs. FBS Winning,2013,Cincinnati,1,2,3,0.3333333333333333
vs. FBS Non-Winning,2013,Cincinnati,7,2,9,0.7777777777777778
vs. BCS AQ,2013,Cincinnati,7,4,11,0.6363636363636364
vs. BCS non-AQ,2013,Cincinnati,1,0,1,1.0
vs. FBS Power 5,2013,Cincinnati,1,2,3,0.3333333333333333
vs. FBS non-Power 5,2013,Cincinnati,7,2,9,0.7777777777777778
in August/September,2013,Cincinnati,3,1,4,0.75
in October,2013,Cincinnati,3,1,4,0.75
in November,2013,Cincinnati,3,0,3,1.0
in December/January,2013,Cincinnati,0,2,2,0.0
All Games,2014,Cincinnati,9,4,13,0.6923076923076923
at Home,2014,Cincinnati,5,1,6,0.8333333333333334
on Road/Neutral Site,2014,Cincinnati,4,3,7,0.5714285714285714
vs. Conference,2014,Cincinnati,7,1,8,0.875
vs. Non-Conference,2014,Cincinnati,2,3,5,0.4
vs. Ranked (AP),2014,Cincinnati,0,2,2,0.0
vs. Unranked (AP),2014,Cincinnati,9,2,11,0.8181818181818182
vs. FBS (I-A),2014,Cincinnati,9,4,13,0.6923076923076923
vs. FCS (I-AA),2014,Cincinnati,0,0,0,
vs. FBS Winning,2014,Cincinnati,3,3,6,0.5
vs. FBS Non-Winning,2014,Cincinnati,6,1,7,0.8571428571428571
vs. BCS AQ,2014,Cincinnati,7,4,11,0.6363636363636364
vs. BCS non-AQ,2014,Cincinnati,2,0,2,1.0
vs. FBS Power 5,2014,Cincinnati,0,3,3,0.0
vs. FBS non-Power 5,2014,Cincinnati,9,1,10,0.9
in August/September,2014,Cincinnati,2,1,3,0.6666666666666666
in October,2014,Cincinnati,3,2,5,0.6
in November,2014,Cincinnati,3,0,3,1.0
in December/January,2014,Cincinnati,1,1,2,0.5
All Games,2015,Cincinnati,7,6,13,0.5384615384615384
at Home,2015,Cincinnati,5,1,6,0.8333333333333334
on Road/Neutral Site,2015,Cincinnati,2,5,7,0.2857142857142857
vs. Conference,2015,Cincinnati,4,4,8,0.5
vs. Non-Conference,2015,Cincinnati,3,2,5,0.6
vs. Ranked (AP),2015,Cincinnati,0,1,1,0.0
vs. Unranked (AP),2015,Cincinnati,7,5,12,0.5833333333333334
vs. FBS (I-A),2015,Cincinnati,6,6,12,0.5
vs. FCS (I-AA),2015,Cincinnati,1,0,1,1.0
vs. FBS Winning,2015,Cincinnati,1,6,7,0.14285714285714285
vs. FBS Non-Winning,2015,Cincinnati,5,0,5,1.0
vs. BCS AQ,2015,Cincinnati,5,4,9,0.5555555555555556
vs. BCS non-AQ,2015,Cincinnati,1,2,3,0.3333333333333333
vs. FBS Power 5,2015,Cincinnati,1,0,1,1.0
vs. FBS non-Power 5,2015,Cincinnati,5,6,11,0.45454545454545453
in August/September,2015,Cincinnati,2,2,4,0.5
in October,2015,Cincinnati,3,1,4,0.75
in November,2015,Cincinnati,2,2,4,0.5
in December/January,2015,Cincinnati,0,1,1,0.0
All Games,2016,Cincinnati,4,8,12,0.3333333333333333
at Home,2016,Cincinnati,3,4,7,0.42857142857142855
on Road/Neutral Site,2016,Cincinnati,1,4,5,0.2
vs. Conference,2016,Cincinnati,1,7,8,0.125
vs. Non-Conference,2016,Cincinnati,3,1,4,0.75
vs. Ranked (AP),2016,Cincinnati,0,2,2,0.0
vs. Unranked (AP),2016,Cincinnati,4,6,10,0.4
vs. FBS (I-A),2016,Cincinnati,3,8,11,0.2727272727272727
vs. FCS (I-AA),2016,Cincinnati,1,0,1,1.0
vs. FBS Winning,2016,Cincinnati,0,6,6,0.0
vs. FBS Non-Winning,2016,Cincinnati,3,2,5,0.6
vs. BCS AQ,2016,Cincinnati,2,7,9,0.2222222222222222
vs. BCS non-AQ,2016,Cincinnati,1,1,2,0.5
vs. FBS Power 5,2016,Cincinnati,1,0,1,1.0
vs. FBS non-Power 5,2016,Cincinnati,2,8,10,0.2
in August/September,2016,Cincinnati,3,1,4,0.75
in October,2016,Cincinnati,1,3,4,0.25
in November,2016,Cincinnati,0,4,4,0.0
in December/January,2016,Cincinnati,0,0,0,
All Games,2017,Cincinnati,4,8,12,0.3333333333333333
at Home,2017,Cincinnati,2,4,6,0.3333333333333333
on Road/Neutral Site,2017,Cincinnati,2,4,6,0.3333333333333333
vs. Conference,2017,Cincinnati,2,6,8,0.25
vs. Non-Conference,2017,Cincinnati,2,2,4,0.5
vs. Ranked (AP),2017,Cincinnati,0,2,2,0.0
vs. Unranked (AP),2017,Cincinnati,4,6,10,0.4
vs. FBS (I-A),2017,Cincinnati,3,8,11,0.2727272727272727
vs. FCS (I-AA),2017,Cincinnati,1,0,1,1.0
vs. FBS Winning,2017,Cincinnati,0,7,7,0.0
vs. FBS Non-Winning,2017,Cincinnati,3,1,4,0.75
vs. BCS AQ,2017,Cincinnati,2,7,9,0.2222222222222222
vs. BCS non-AQ,2017,Cincinnati,1,1,2,0.5
vs. FBS Power 5,2017,Cincinnati,0,1,1,0.0
vs. FBS non-Power 5,2017,Cincinnati,3,7,10,0.3
in August/September,2017,Cincinnati,2,3,5,0.4
in October,2017,Cincinnati,0,3,3,0.0
in November,2017,Cincinnati,2,2,4,0.5
in December/January,2017,Cincinnati,0,0,0,
All Games,2018,Cincinnati,11,2,13,0.8461538461538461
at Home,2018,Cincinnati,6,0,6,1.0
on Road/Neutral Site,2018,Cincinnati,5,2,7,0.7142857142857143
vs. Conference,2018,Cincinnati,6,2,8,0.75
vs. Non-Conference,2018,Cincinnati,5,0,5,1.0
vs. Ranked (AP),2018,Cincinnati,0,1,1,0.0
vs. Unranked (AP),2018,Cincinnati,11,1,12,0.9166666666666666
vs. FBS (I-A),2018,Cincinnati,10,2,12,0.8333333333333334
vs. FCS (I-AA),2018,Cincinnati,1,0,1,1.0
vs. FBS Winning,2018,Cincinnati,3,2,5,0.6
vs. FBS Non-Winning,2018,Cincinnati,7,0,7,1.0
vs. BCS AQ,2018,Cincinnati,8,2,10,0.8
vs. BCS non-AQ,2018,Cincinnati,2,0,2,1.0
vs. FBS Power 5,2018,Cincinnati,2,0,2,1.0
vs. FBS non-Power 5,2018,Cincinnati,8,2,10,0.8
in August/September,2018,Cincinnati,5,0,5,1.0
in October,2018,Cincinnati,2,1,3,0.6666666666666666
in November,2018,Cincinnati,3,1,4,0.75
in December/January,2018,Cincinnati,1,0,1,1.0
All Games,2019,Cincinnati,11,3,14,0.7857142857142857
at Home,2019,Cincinnati,6,0,6,1.0
on Road/Neutral Site,2019,Cincinnati,5,3,8,0.625
vs. Conference,2019,Cincinnati,7,2,9,0.7777777777777778
vs. Non-Conference,2019,Cincinnati,4,1,5,0.8
vs. Ranked (AP),2019,Cincinnati,1,3,4,0.25
vs. Unranked (AP),2019,Cincinnati,10,0,10,1.0
vs. FBS (I-A),2019,Cincinnati,11,3,14,0.7857142857142857
vs. FCS (I-AA),2019,Cincinnati,0,0,0,
vs. FBS Winning,2019,Cincinnati,4,3,7,0.5714285714285714
vs. FBS Non-Winning,2019,Cincinnati,7,0,7,1.0
vs. BCS AQ,2019,Cincinnati,9,3,12,0.75
vs. BCS non-AQ,2019,Cincinnati,2,0,2,1.0
vs. FBS Power 5,2019,Cincinnati,2,1,3,0.6666666666666666
vs. FBS non-Power 5,2019,Cincinnati,9,2,11,0.8181818181818182
in August/September,2019,Cincinnati,3,1,4,0.75
in October,2019,Cincinnati,3,0,3,1.0
in November,2019,Cincinnati,4,1,5,0.8
in December/January,2019,Cincinnati,1,1,2,0.5
All Games,2020,Cincinnati,9,1,10,0.9
at Home,2020,Cincinnati,7,0,7,1.0
on Road/Neutral Site,2020,Cincinnati,2,1,3,0.6666666666666666
vs. Conference,2020,Cincinnati,7,0,7,1.0
vs. Non-Conference,2020,Cincinnati,2,1,3,0.6666666666666666
vs. Ranked (AP),2020,Cincinnati,1,1,2,0.5
vs. Unranked (AP),2020,Cincinnati,8,0,8,1.0
vs. FBS (I-A),2020,Cincinnati,8,1,9,0.8888888888888888
vs. FCS (I-AA),2020,Cincinnati,1,0,1,1.0
vs. FBS Winning,2020,Cincinnati,5,1,6,0.8333333333333334
vs. FBS Non-Winning,2020,Cincinnati,3,0,3,1.0
vs. BCS AQ,2020,Cincinnati,7,1,8,0.875
vs. BCS non-AQ,2020,Cincinnati,1,0,1,1.0
vs. FBS Power 5,2020,Cincinnati,0,1,1,0.0
vs. FBS non-Power 5,2020,Cincinnati,8,0,8,1.0
in August/September,2020,Cincinnati,2,0,2,1.0
in October,2020,Cincinnati,3,0,3,1.0
in November,2020,Cincinnati,3,0,3,1.0
in December/January,2020,Cincinnati,1,1,2,0.5
All Games,2021,Cincinnati,13,1,14,0.9285714285714286
at Home,2021,Cincinnati,7,0,7,1.0
on Road/Neutral Site,2021,Cincinnati,6,1,7,0.8571428571428571
vs. Conference,2021,Cincinnati,9,0,9,1.0
vs. Non-Conference,2021,Cincinnati,4,1,5,0.8
vs. Ranked (AP),2021,Cincinnati,2,1,3,0.6666666666666666
vs. Unranked (AP),2021,Cincinnati,11,0,11,1.0
vs. FBS (I-A),2021,Cincinnati,12,1,13,0.9230769230769231
vs. FCS (I-AA),2021,Cincinnati,1,0,1,1.0
vs. FBS Winning,2021,Cincinnati,7,1,8,0.875
vs. FBS Non-Winning,2021,Cincinnati,5,0,5,1.0
vs. BCS AQ,2021,Cincinnati,11,1,12,0.9166666666666666
vs. BCS non-AQ,2021,Cincinnati,1,0,1,1.0
vs. FBS Power 5,2021,Cincinnati,1,1,2,0.5
vs. FBS non-Power 5,2021,Cincinnati,11,0,11,1.0
in August/September,2021,Cincinnati,3,0,3,1.0
in October,2021,Cincinnati,5,0,5,1.0
in November,2021,Cincinnati,4,0,4,1.0
in December/January,2021,Cincinnati,1,1,2,0.5
All Games,2022,Cincinnati,9,4,13,0.6923076923076923
at Home,2022,Cincinnati,5,1,6,0.8333333333333334
on Road/Neutral Site,2022,Cincinnati,4,3,7,0.5714285714285714
vs. Conference,2022,Cincinnati,6,2,8,0.75
vs. Non-Conference,2022,Cincinnati,3,2,5,0.6
vs. Ranked (AP),2022,Cincinnati,0,1,1,0.0
vs. Unranked (AP),2022,Cincinnati,9,3,12,0.75
vs. FBS (I-A),2022,Cincinnati,8,4,12,0.6666666666666666
vs. FCS (I-AA),2022,Cincinnati,1,0,1,1.0
vs. FBS Winning,2022,Cincinnati,2,4,6,0.3333333333333333
vs. FBS Non-Winning,2022,Cincinnati,6,0,6,1.0
vs. BCS AQ,2022,Cincinnati,7,4,11,0.6363636363636364
vs. BCS non-AQ,2022,Cincinnati,1,0,1,1.0
vs. FBS Power 5,2022,Cincinnati,1,2,3,0.3333333333333333
vs. FBS non-Power 5,2022,Cincinnati,7,2,9,0.7777777777777778
in August/September,2022,Cincinnati,3,1,4,0.75
in October,2022,Cincinnati,3,1,4,0.75
in November,2022,Cincinnati,3,1,4,0.75
in December/January,2022,Cincinnati,0,1,1,0.0
All Games,2009,Clemson,9,5,14,0.6428571428571429
at Home,2009,Clemson,6,1,7,0.8571428571428571
on Road/Neutral Site,2009,Clemson,3,4,7,0.42857142857142855
vs. Conference,2009,Clemson,6,3,9,0.6666666666666666
vs. Non-Conference,2009,Clemson,3,2,5,0.6
vs. Ranked (AP),2009,Clemson,1,3,4,0.25
vs. Unranked (AP),2009,Clemson,8,2,10,0.8
vs. FBS (I-A),2009,Clemson,8,5,13,0.6153846153846154
vs. FCS (I-AA),2009,Clemson,1,0,1,1.0
vs. FBS Winning,2009,Clemson,5,4,9,0.5555555555555556
vs. FBS Non-Winning,2009,Clemson,3,1,4,0.75
vs. BCS AQ,2009,Clemson,7,4,11,0.6363636363636364
vs. BCS non-AQ,2009,Clemson,1,1,2,0.5
vs. FBS Power 5,2009,Clemson,7,4,11,0.6363636363636364
vs. FBS non-Power 5,2009,Clemson,1,1,2,0.5
in August/September,2009,Clemson,2,2,4,0.5
in October,2009,Clemson,3,1,4,0.75
in November,2009,Clemson,3,1,4,0.75
in December/January,2009,Clemson,1,1,2,0.5
All Games,2010,Clemson,6,7,13,0.46153846153846156
at Home,2010,Clemson,5,2,7,0.7142857142857143
on Road/Neutral Site,2010,Clemson,1,5,6,0.16666666666666666
vs. Conference,2010,Clemson,4,4,8,0.5
vs. Non-Conference,2010,Clemson,2,3,5,0.4
vs. Ranked (AP),2010,Clemson,2,3,5,0.4
vs. Unranked (AP),2010,Clemson,4,4,8,0.5
vs. FBS (I-A),2010,Clemson,5,7,12,0.4166666666666667
vs. FCS (I-AA),2010,Clemson,1,0,1,1.0
vs. FBS Winning,2010,Clemson,2,7,9,0.2222222222222222
vs. FBS Non-Winning,2010,Clemson,3,0,3,1.0
vs. BCS AQ,2010,Clemson,4,7,11,0.36363636363636365
vs. BCS non-AQ,2010,Clemson,1,0,1,1.0
vs. FBS Power 5,2010,Clemson,4,6,10,0.4
vs. FBS non-Power 5,2010,Clemson,1,1,2,0.5
in August/September,2010,Clemson,2,1,3,0.6666666666666666
in October,2010,Clemson,2,3,5,0.4
in November,2010,Clemson,2,2,4,0.5
in December/January,2010,Clemson,0,1,1,0.0
All Games,2011,Clemson,10,4,14,0.7142857142857143
at Home,2011,Clemson,7,0,7,1.0
on Road/Neutral Site,2011,Clemson,3,4,7,0.42857142857142855
vs. Conference,2011,Clemson,7,2,9,0.7777777777777778
vs. Non-Conference,2011,Clemson,3,2,5,0.6
vs. Ranked (AP),2011,Clemson,3,2,5,0.6
vs. Unranked (AP),2011,Clemson,7,2,9,0.7777777777777778
vs. FBS (I-A),2011,Clemson,9,4,13,0.6923076923076923
vs. FCS (I-AA),2011,Clemson,1,0,1,1.0
vs. FBS Winning,2011,Clemson,5,4,9,0.5555555555555556
vs. FBS Non-Winning,2011,Clemson,4,0,4,1.0
vs. BCS AQ,2011,Clemson,8,4,12,0.6666666666666666
vs. BCS non-AQ,2011,Clemson,1,0,1,1.0
vs. FBS Power 5,2011,Clemson,8,3,11,0.7272727272727273
vs. FBS non-Power 5,2011,Clemson,1,1,2,0.5
in August/September,2011,Clemson,4,0,4,1.0
in October,2011,Clemson,4,1,5,0.8
in November,2011,Clemson,1,2,3,0.3333333333333333
in December/January,2011,Clemson,1,1,2,0.5
All Games,2012,Clemson,11,2,13,0.8461538461538461
at Home,2012,Clemson,6,1,7,0.8571428571428571
on Road/Neutral Site,2012,Clemson,5,1,6,0.8333333333333334
vs. Conference,2012,Clemson,7,1,8,0.875
vs. Non-Conference,2012,Clemson,4,1,5,0.8
vs. Ranked (AP),2012,Clemson,1,2,3,0.3333333333333333
vs. Unranked (AP),2012,Clemson,10,0,10,1.0
vs. FBS (I-A),2012,Clemson,10,2,12,0.8333333333333334
vs. FCS (I-AA),2012,Clemson,1,0,1,1.0
vs. FBS Winning,2012,Clemson,4,2,6,0.6666666666666666
vs. FBS Non-Winning,2012,Clemson,6,0,6,1.0
vs. BCS AQ,2012,Clemson,9,2,11,0.8181818181818182
vs. BCS non-AQ,2012,Clemson,1,0,1,1.0
vs. FBS Power 5,2012,Clemson,9,2,11,0.8181818181818182
vs. FBS non-Power 5,2012,Clemson,1,0,1,1.0
in August/September,2012,Clemson,4,1,5,0.8
in October,2012,Clemson,3,0,3,1.0
in November,2012,Clemson,3,1,4,0.75
in December/January,2012,Clemson,1,0,1,1.0
All Games,2013,Clemson,11,2,13,0.8461538461538461
at Home,2013,Clemson,6,1,7,0.8571428571428571
on Road/Neutral Site,2013,Clemson,5,1,6,0.8333333333333334
vs. Conference,2013,Clemson,7,1,8,0.875
vs. Non-Conference,2013,Clemson,4,1,5,0.8
vs. Ranked (AP),2013,Clemson,1,2,3,0.3333333333333333
vs. Unranked (AP),2013,Clemson,10,0,10,1.0
vs. FBS (I-A),2013,Clemson,9,2,11,0.8181818181818182
vs. FCS (I-AA),2013,Clemson,2,0,2,1.0
vs. FBS Winning,2013,Clemson,6,2,8,0.75
vs. FBS Non-Winning,2013,Clemson,3,0,3,1.0
vs. BCS AQ,2013,Clemson,9,2,11,0.8181818181818182
vs. BCS non-AQ,2013,Clemson,0,0,0,
vs. FBS Power 5,2013,Clemson,9,2,11,0.8181818181818182
vs. FBS non-Power 5,2013,Clemson,0,0,0,
in August/September,2013,Clemson,4,0,4,1.0
in October,2013,Clemson,3,1,4,0.75
in November,2013,Clemson,3,1,4,0.75
in December/January,2013,Clemson,1,0,1,1.0
All Games,2014,Clemson,10,3,13,0.7692307692307693
at Home,2014,Clemson,7,0,7,1.0
on Road/Neutral Site,2014,Clemson,3,3,6,0.5
vs. Conference,2014,Clemson,6,2,8,0.75
vs. Non-Conference,2014,Clemson,4,1,5,0.8
vs. Ranked (AP),2014,Clemson,1,3,4,0.25
vs. Unranked (AP),2014,Clemson,9,0,9,1.0
vs. FBS (I-A),2014,Clemson,9,3,12,0.75
vs. FCS (I-AA),2014,Clemson,1,0,1,1.0
vs. FBS Winning,2014,Clemson,5,3,8,0.625
vs. FBS Non-Winning,2014,Clemson,4,0,4,1.0
vs. BCS AQ,2014,Clemson,8,3,11,0.7272727272727273
vs. BCS non-AQ,2014,Clemson,1,0,1,1.0
vs. FBS Power 5,2014,Clemson,8,3,11,0.7272727272727273
vs. FBS non-Power 5,2014,Clemson,1,0,1,1.0
in August/September,2014,Clemson,2,2,4,0.5
in October,2014,Clemson,4,0,4,1.0
in November,2014,Clemson,3,1,4,0.75
in December/January,2014,Clemson,1,0,1,1.0
All Games,2015,Clemson,14,1,15,0.9333333333333333
at Home,2015,Clemson,7,0,7,1.0
on Road/Neutral Site,2015,Clemson,7,1,8,0.875
vs. Conference,2015,Clemson,9,0,9,1.0
vs. Non-Conference,2015,Clemson,5,1,6,0.8333333333333334
vs. Ranked (AP),2015,Clemson,4,1,5,0.8
vs. Unranked (AP),2015,Clemson,10,0,10,1.0
vs. FBS (I-A),2015,Clemson,13,1,14,0.9285714285714286
vs. FCS (I-AA),2015,Clemson,1,0,1,1.0
vs. FBS Winning,2015,Clemson,8,1,9,0.8888888888888888
vs. FBS Non-Winning,2015,Clemson,5,0,5,1.0
vs. BCS AQ,2015,Clemson,12,1,13,0.9230769230769231
vs. BCS non-AQ,2015,Clemson,1,0,1,1.0
vs. FBS Power 5,2015,Clemson,11,1,12,0.9166666666666666
vs. FBS non-Power 5,2015,Clemson,2,0,2,1.0
in August/September,2015,Clemson,3,0,3,1.0
in October,2015,Clemson,5,0,5,1.0
in November,2015,Clemson,4,0,4,1.0
in December/January,2015,Clemson,2,1,3,0.6666666666666666
All Games,2016,Clemson,14,1,15,0.9333333333333333
at Home,2016,Clemson,6,1,7,0.8571428571428571
on Road/Neutral Site,2016,Clemson,8,0,8,1.0
vs. Conference,2016,Clemson,8,1,9,0.8888888888888888
vs. Non-Conference,2016,Clemson,6,0,6,1.0
vs. Ranked (AP),2016,Clemson,6,1,7,0.8571428571428571
vs. Unranked (AP),2016,Clemson,8,0,8,1.0
vs. FBS (I-A),2016,Clemson,13,1,14,0.9285714285714286
vs. FCS (I-AA),2016,Clemson,1,0,1,1.0
vs. FBS Winning,2016,Clemson,11,1,12,0.9166666666666666
vs. FBS Non-Winning,2016,Clemson,2,0,2,1.0
vs. BCS AQ,2016,Clemson,12,1,13,0.9230769230769231
vs. BCS non-AQ,2016,Clemson,1,0,1,1.0
vs. FBS Power 5,2016,Clemson,12,1,13,0.9230769230769231
vs. FBS non-Power 5,2016,Clemson,1,0,1,1.0
in August/September,2016,Clemson,4,0,4,1.0
in October,2016,Clemson,4,0,4,1.0
in November,2016,Clemson,3,1,4,0.75
in December/January,2016,Clemson,3,0,3,1.0
All Games,2017,Clemson,12,2,14,0.8571428571428571
at Home,2017,Clemson,7,0,7,1.0
on Road/Neutral Site,2017,Clemson,5,2,7,0.7142857142857143
vs. Conference,2017,Clemson,8,1,9,0.8888888888888888
vs. Non-Conference,2017,Clemson,4,1,5,0.8
vs. Ranked (AP),2017,Clemson,4,1,5,0.8
vs. Unranked (AP),2017,Clemson,8,1,9,0.8888888888888888
vs. FBS (I-A),2017,Clemson,11,2,13,0.8461538461538461
vs. FCS (I-AA),2017,Clemson,1,0,1,1.0
vs. FBS Winning,2017,Clemson,9,1,10,0.9
vs. FBS Non-Winning,2017,Clemson,2,1,3,0.6666666666666666
vs. BCS AQ,2017,Clemson,10,2,12,0.8333333333333334
vs. BCS non-AQ,2017,Clemson,1,0,1,1.0
vs. FBS Power 5,2017,Clemson,10,2,12,0.8333333333333334
vs. FBS non-Power 5,2017,Clemson,1,0,1,1.0
in August/September,2017,Clemson,5,0,5,1.0
in October,2017,Clemson,2,1,3,0.6666666666666666
in November,2017,Clemson,4,0,4,1.0
in December/January,2017,Clemson,1,1,2,0.5
All Games,2018,Clemson,15,0,15,1.0
at Home,2018,Clemson,7,0,7,1.0
on Road/Neutral Site,2018,Clemson,8,0,8,1.0
vs. Conference,2018,Clemson,9,0,9,1.0
vs. Non-Conference,2018,Clemson,6,0,6,1.0
vs. Ranked (AP),2018,Clemson,4,0,4,1.0
vs. Unranked (AP),2018,Clemson,11,0,11,1.0
vs. FBS (I-A),2018,Clemson,14,0,14,1.0
vs. FCS (I-AA),2018,Clemson,1,0,1,1.0
vs. FBS Winning,2018,Clemson,11,0,11,1.0
vs. FBS Non-Winning,2018,Clemson,3,0,3,1.0
vs. BCS AQ,2018,Clemson,13,0,13,1.0
vs. BCS non-AQ,2018,Clemson,1,0,1,1.0
vs. FBS Power 5,2018,Clemson,12,0,12,1.0
vs. FBS non-Power 5,2018,Clemson,2,0,2,1.0
in August/September,2018,Clemson,5,0,5,1.0
in October,2018,Clemson,3,0,3,1.0
in November,2018,Clemson,4,0,4,1.0
in December/January,2018,Clemson,3,0,3,1.0
All Games,2019,Clemson,14,1,15,0.9333333333333333
at Home,2019,Clemson,7,0,7,1.0
on Road/Neutral Site,2019,Clemson,7,1,8,0.875
vs. Conference,2019,Clemson,9,0,9,1.0
vs. Non-Conference,2019,Clemson,5,1,6,0.8333333333333334
vs. Ranked (AP),2019,Clemson,1,1,2,0.5
vs. Unranked (AP),2019,Clemson,13,0,13,1.0
vs. FBS (I-A),2019,Clemson,13,1,14,0.9285714285714286
vs. FCS (I-AA),2019,Clemson,1,0,1,1.0
vs. FBS Winning,2019,Clemson,7,1,8,0.875
vs. FBS Non-Winning,2019,Clemson,6,0,6,1.0
vs. BCS AQ,2019,Clemson,12,1,13,0.9230769230769231
vs. BCS non-AQ,2019,Clemson,1,0,1,1.0
vs. FBS Power 5,2019,Clemson,12,1,13,0.9230769230769231
vs. FBS non-Power 5,2019,Clemson,1,0,1,1.0
in August/September,2019,Clemson,5,0,5,1.0
in October,2019,Clemson,3,0,3,1.0
in November,2019,Clemson,4,0,4,1.0
in December/January,2019,Clemson,2,1,3,0.6666666666666666
All Games,2020,Clemson,10,2,12,0.8333333333333334
at Home,2020,Clemson,6,0,6,1.0
on Road/Neutral Site,2020,Clemson,4,2,6,0.6666666666666666
vs. Conference,2020,Clemson,9,1,10,0.9
vs. Non-Conference,2020,Clemson,1,1,2,0.5
vs. Ranked (AP),2020,Clemson,2,2,4,0.5
vs. Unranked (AP),2020,Clemson,8,0,8,1.0
vs. FBS (I-A),2020,Clemson,9,2,11,0.8181818181818182
vs. FCS (I-AA),2020,Clemson,1,0,1,1.0
vs. FBS Winning,2020,Clemson,4,2,6,0.6666666666666666
vs. FBS Non-Winning,2020,Clemson,5,0,5,1.0
vs. BCS AQ,2020,Clemson,9,2,11,0.8181818181818182
vs. BCS non-AQ,2020,Clemson,0,0,0,
vs. FBS Power 5,2020,Clemson,9,2,11,0.8181818181818182
vs. FBS non-Power 5,2020,Clemson,0,0,0,
in August/September,2020,Clemson,2,0,2,1.0
in October,2020,Clemson,5,0,5,1.0
in November,2020,Clemson,1,1,2,0.5
in December/January,2020,Clemson,2,1,3,0.6666666666666666
All Games,2021,Clemson,10,3,13,0.7692307692307693
at Home,2021,Clemson,6,0,6,1.0
on Road/Neutral Site,2021,Clemson,4,3,7,0.5714285714285714
vs. Conference,2021,Clemson,6,2,8,0.75
vs. Non-Conference,2021,Clemson,4,1,5,0.8
vs. Ranked (AP),2021,Clemson,1,3,4,0.25
vs. Unranked (AP),2021,Clemson,9,0,9,1.0
vs. FBS (I-A),2021,Clemson,9,3,12,0.75
vs. FCS (I-AA),2021,Clemson,1,0,1,1.0
vs. FBS Winning,2021,Clemson,3,3,6,0.5
vs. FBS Non-Winning,2021,Clemson,6,0,6,1.0
vs. BCS AQ,2021,Clemson,8,3,11,0.7272727272727273
vs. BCS non-AQ,2021,Clemson,1,0,1,1.0
vs. FBS Power 5,2021,Clemson,8,3,11,0.7272727272727273
vs. FBS non-Power 5,2021,Clemson,1,0,1,1.0
in August/September,2021,Clemson,2,2,4,0.5
in October,2021,Clemson,3,1,4,0.75
in November,2021,Clemson,4,0,4,1.0
in December/January,2021,Clemson,1,0,1,1.0
All Games,2022,Clemson,11,3,14,0.7857142857142857
at Home,2022,Clemson,6,1,7,0.8571428571428571
on Road/Neutral Site,2022,Clemson,5,2,7,0.7142857142857143
vs. Conference,2022,Clemson,9,0,9,1.0
vs. Non-Conference,2022,Clemson,2,3,5,0.4
vs. Ranked (AP),2022,Clemson,1,3,4,0.25
vs. Unranked (AP),2022,Clemson,10,0,10,1.0
vs. FBS (I-A),2022,Clemson,10,3,13,0.7692307692307693
vs. FCS (I-AA),2022,Clemson,1,0,1,1.0
vs. FBS Winning,2022,Clemson,6,3,9,0.6666666666666666
vs. FBS Non-Winning,2022,Clemson,4,0,4,1.0
vs. BCS AQ,2022,Clemson,9,3,12,0.75
vs. BCS non-AQ,2022,Clemson,1,0,1,1.0
vs. FBS Power 5,2022,Clemson,9,2,11,0.8181818181818182
vs. FBS non-Power 5,2022,Clemson,1,1,2,0.5
in August/September,2022,Clemson,4,0,4,1.0
in October,2022,Clemson,4,0,4,1.0
in November,2022,Clemson,2,2,4,0.5
in December/January,2022,Clemson,1,1,2,0.5
All Games,2017,Coastal Carolina,3,9,12,0.25
at Home,2017,Coastal Carolina,2,4,6,0.3333333333333333
on Road/Neutral Site,2017,Coastal Carolina,1,5,6,0.16666666666666666
vs. Conference,2017,Coastal Carolina,2,6,8,0.25
vs. Non-Conference,2017,Coastal Carolina,1,3,4,0.25
vs. Ranked (AP),2017,Coastal Carolina,0,0,0,
vs. Unranked (AP),2017,Coastal Carolina,3,9,12,0.25
vs. FBS (I-A),2017,Coastal Carolina,3,8,11,0.2727272727272727
vs. FCS (I-AA),2017,Coastal Carolina,0,1,1,0.0
vs. FBS Winning,2017,Coastal Carolina,0,5,5,0.0
vs. FBS Non-Winning,2017,Coastal Carolina,3,3,6,0.5
vs. BCS AQ,2017,Coastal Carolina,0,1,1,0.0
vs. BCS non-AQ,2017,Coastal Carolina,3,7,10,0.3
vs. FBS Power 5,2017,Coastal Carolina,0,1,1,0.0
vs. FBS non-Power 5,2017,Coastal Carolina,3,7,10,0.3
in August/September,2017,Coastal Carolina,1,3,4,0.25
in October,2017,Coastal Carolina,0,4,4,0.0
in November,2017,Coastal Carolina,1,2,3,0.3333333333333333
in December/January,2017,Coastal Carolina,1,0,1,1.0
All Games,2018,Coastal Carolina,5,7,12,0.4166666666666667
at Home,2018,Coastal Carolina,1,4,5,0.2
on Road/Neutral Site,2018,Coastal Carolina,4,3,7,0.5714285714285714
vs. Conference,2018,Coastal Carolina,2,6,8,0.25
vs. Non-Conference,2018,Coastal Carolina,3,1,4,0.75
vs. Ranked (AP),2018,Coastal Carolina,0,0,0,
vs. Unranked (AP),2018,Coastal Carolina,5,7,12,0.4166666666666667
vs. FBS (I-A),2018,Coastal Carolina,4,7,11,0.36363636363636365
vs. FCS (I-AA),2018,Coastal Carolina,1,0,1,1.0
vs. FBS Winning,2018,Coastal Carolina,1,5,6,0.16666666666666666
vs. FBS Non-Winning,2018,Coastal Carolina,3,2,5,0.6
vs. BCS AQ,2018,Coastal Carolina,0,1,1,0.0
vs. BCS non-AQ,2018,Coastal Carolina,4,6,10,0.4
vs. FBS Power 5,2018,Coastal Carolina,0,1,1,0.0
vs. FBS non-Power 5,2018,Coastal Carolina,4,6,10,0.4
in August/September,2018,Coastal Carolina,3,2,5,0.6
in October,2018,Coastal Carolina,2,1,3,0.6666666666666666
in November,2018,Coastal Carolina,0,4,4,0.0
in December/January,2018,Coastal Carolina,0,0,0,
All Games,2019,Coastal Carolina,5,7,12,0.4166666666666667
at Home,2019,Coastal Carolina,3,3,6,0.5
on Road/Neutral Site,2019,Coastal Carolina,2,4,6,0.3333333333333333
vs. Conference,2019,Coastal Carolina,2,6,8,0.25
vs. Non-Conference,2019,Coastal Carolina,3,1,4,0.75
vs. Ranked (AP),2019,Coastal Carolina,0,1,1,0.0
vs. Unranked (AP),2019,Coastal Carolina,5,6,11,0.45454545454545453
vs. FBS (I-A),2019,Coastal Carolina,4,7,11,0.36363636363636365
vs. FCS (I-AA),2019,Coastal Carolina,1,0,1,1.0
vs. FBS Winning,2019,Coastal Carolina,0,5,5,0.0
vs. FBS Non-Winning,2019,Coastal Carolina,4,2,6,0.6666666666666666
vs. BCS AQ,2019,Coastal Carolina,1,0,1,1.0
vs. BCS non-AQ,2019,Coastal Carolina,3,7,10,0.3
vs. FBS Power 5,2019,Coastal Carolina,1,0,1,1.0
vs. FBS non-Power 5,2019,Coastal Carolina,3,7,10,0.3
in August/September,2019,Coastal Carolina,3,2,5,0.6
in October,2019,Coastal Carolina,0,2,2,0.0
in November,2019,Coastal Carolina,2,3,5,0.4
in December/January,2019,Coastal Carolina,0,0,0,
All Games,2020,Coastal Carolina,11,1,12,0.9166666666666666
at Home,2020,Coastal Carolina,6,0,6,1.0
on Road/Neutral Site,2020,Coastal Carolina,5,1,6,0.8333333333333334
vs. Conference,2020,Coastal Carolina,8,0,8,1.0
vs. Non-Conference,2020,Coastal Carolina,3,1,4,0.75
vs. Ranked (AP),2020,Coastal Carolina,2,1,3,0.6666666666666666
vs. Unranked (AP),2020,Coastal Carolina,9,0,9,1.0
vs. FBS (I-A),2020,Coastal Carolina,10,1,11,0.9090909090909091
vs. FCS (I-AA),2020,Coastal Carolina,1,0,1,1.0
vs. FBS Winning,2020,Coastal Carolina,5,1,6,0.8333333333333334
vs. FBS Non-Winning,2020,Coastal Carolina,5,0,5,1.0
vs. BCS AQ,2020,Coastal Carolina,1,0,1,1.0
vs. BCS non-AQ,2020,Coastal Carolina,9,1,10,0.9
vs. FBS Power 5,2020,Coastal Carolina,1,0,1,1.0
vs. FBS non-Power 5,2020,Coastal Carolina,9,1,10,0.9
in August/September,2020,Coastal Carolina,2,0,2,1.0
in October,2020,Coastal Carolina,4,0,4,1.0
in November,2020,Coastal Carolina,3,0,3,1.0
in December/January,2020,Coastal Carolina,2,1,3,0.6666666666666666
All Games,2021,Coastal Carolina,11,2,13,0.8461538461538461
at Home,2021,Coastal Carolina,6,1,7,0.8571428571428571
on Road/Neutral Site,2021,Coastal Carolina,5,1,6,0.8333333333333334
vs. Conference,2021,Coastal Carolina,6,2,8,0.75
vs. Non-Conference,2021,Coastal Carolina,5,0,5,1.0
vs. Ranked (AP),2021,Coastal Carolina,0,0,0,
vs. Unranked (AP),2021,Coastal Carolina,11,2,13,0.8461538461538461
vs. FBS (I-A),2021,Coastal Carolina,10,2,12,0.8333333333333334
vs. FCS (I-AA),2021,Coastal Carolina,1,0,1,1.0
vs. FBS Winning,2021,Coastal Carolina,1,2,3,0.3333333333333333
vs. FBS Non-Winning,2021,Coastal Carolina,9,0,9,1.0
vs. BCS AQ,2021,Coastal Carolina,1,0,1,1.0
vs. BCS non-AQ,2021,Coastal Carolina,9,2,11,0.8181818181818182
vs. FBS Power 5,2021,Coastal Carolina,1,0,1,1.0
vs. FBS non-Power 5,2021,Coastal Carolina,9,2,11,0.8181818181818182
in August/September,2021,Coastal Carolina,4,0,4,1.0
in October,2021,Coastal Carolina,3,1,4,0.75
in November,2021,Coastal Carolina,3,1,4,0.75
in December/January,2021,Coastal Carolina,1,0,1,1.0
All Games,2022,Coastal Carolina,9,4,13,0.6923076923076923
at Home,2022,Coastal Carolina,6,1,7,0.8571428571428571
on Road/Neutral Site,2022,Coastal Carolina,3,3,6,0.5
vs. Conference,2022,Coastal Carolina,6,3,9,0.6666666666666666
vs. Non-Conference,2022,Coastal Carolina,3,1,4,0.75
vs. Ranked (AP),2022,Coastal Carolina,0,1,1,0.0
vs. Unranked (AP),2022,Coastal Carolina,9,3,12,0.75
vs. FBS (I-A),2022,Coastal Carolina,8,4,12,0.6666666666666666
vs. FCS (I-AA),2022,Coastal Carolina,1,0,1,1.0
vs. FBS Winning,2022,Coastal Carolina,3,3,6,0.5
vs. FBS Non-Winning,2022,Coastal Carolina,5,1,6,0.8333333333333334
vs. BCS AQ,2022,Coastal Carolina,0,1,1,0.0
vs. BCS non-AQ,2022,Coastal Carolina,8,3,11,0.7272727272727273
vs. FBS Power 5,2022,Coastal Carolina,0,0,0,
vs. FBS non-Power 5,2022,Coastal Carolina,8,4,12,0.6666666666666666
in August/September,2022,Coastal Carolina,4,0,4,1.0
in October,2022,Coastal Carolina,3,1,4,0.75
in November,2022,Coastal Carolina,2,1,3,0.6666666666666666
in December/January,2022,Coastal Carolina,0,2,2,0.0
All Games,2009,Colorado,3,9,12,0.25
at Home,2009,Colorado,3,3,6,0.5
on Road/Neutral Site,2009,Colorado,0,6,6,0.0
vs. Conference,2009,Colorado,2,6,8,0.25
vs. Non-Conference,2009,Colorado,1,3,4,0.25
vs. Ranked (AP),2009,Colorado,0,3,3,0.0
vs. Unranked (AP),2009,Colorado,3,6,9,0.3333333333333333
vs. FBS (I-A),2009,Colorado,3,9,12,0.25
vs. FCS (I-AA),2009,Colorado,0,0,0,
vs. FBS Winning,2009,Colorado,1,6,7,0.14285714285714285
vs. FBS Non-Winning,2009,Colorado,2,3,5,0.4
vs. BCS AQ,2009,Colorado,2,7,9,0.2222222222222222
vs. BCS non-AQ,2009,Colorado,1,2,3,0.3333333333333333
vs. FBS Power 5,2009,Colorado,2,6,8,0.25
vs. FBS non-Power 5,2009,Colorado,1,3,4,0.25
in August/September,2009,Colorado,1,2,3,0.3333333333333333
in October,2009,Colorado,1,4,5,0.2
in November,2009,Colorado,1,3,4,0.25
in December/January,2009,Colorado,0,0,0,
All Games,2010,Colorado,5,7,12,0.4166666666666667
at Home,2010,Colorado,4,2,6,0.6666666666666666
on Road/Neutral Site,2010,Colorado,1,5,6,0.16666666666666666
vs. Conference,2010,Colorado,2,6,8,0.25
vs. Non-Conference,2010,Colorado,3,1,4,0.75
vs. Ranked (AP),2010,Colorado,0,3,3,0.0
vs. Unranked (AP),2010,Colorado,5,4,9,0.5555555555555556
vs. FBS (I-A),2010,Colorado,5,7,12,0.4166666666666667
vs. FCS (I-AA),2010,Colorado,0,0,0,
vs. FBS Winning,2010,Colorado,2,5,7,0.2857142857142857
vs. FBS Non-Winning,2010,Colorado,3,2,5,0.6
vs. BCS AQ,2010,Colorado,3,7,10,0.3
vs. BCS non-AQ,2010,Colorado,2,0,2,1.0
vs. FBS Power 5,2010,Colorado,3,7,10,0.3
vs. FBS non-Power 5,2010,Colorado,2,0,2,1.0
in August/September,2010,Colorado,2,1,3,0.6666666666666666
in October,2010,Colorado,1,4,5,0.2
in November,2010,Colorado,2,2,4,0.5
in December/January,2010,Colorado,0,0,0,
All Games,2011,Colorado,3,10,13,0.23076923076923078
at Home,2011,Colorado,1,4,5,0.2
on Road/Neutral Site,2011,Colorado,2,6,8,0.25
vs. Conference,2011,Colorado,2,8,10,0.2
vs. Non-Conference,2011,Colorado,1,2,3,0.3333333333333333
vs. Ranked (AP),2011,Colorado,0,3,3,0.0
vs. Unranked (AP),2011,Colorado,3,7,10,0.3
vs. FBS (I-A),2011,Colorado,3,10,13,0.23076923076923078
vs. FCS (I-AA),2011,Colorado,0,0,0,
vs. FBS Winning,2011,Colorado,1,5,6,0.16666666666666666
vs. FBS Non-Winning,2011,Colorado,2,5,7,0.2857142857142857
vs. BCS AQ,2011,Colorado,2,9,11,0.18181818181818182
vs. BCS non-AQ,2011,Colorado,1,1,2,0.5
vs. FBS Power 5,2011,Colorado,2,9,11,0.18181818181818182
vs. FBS non-Power 5,2011,Colorado,1,1,2,0.5
in August/September,2011,Colorado,1,3,4,0.25
in October,2011,Colorado,0,5,5,0.0
in November,2011,Colorado,2,2,4,0.5
in December/January,2011,Colorado,0,0,0,
All Games,2012,Colorado,1,11,12,0.08333333333333333
at Home,2012,Colorado,0,6,6,0.0
on Road/Neutral Site,2012,Colorado,1,5,6,0.16666666666666666
vs. Conference,2012,Colorado,1,8,9,0.1111111111111111
vs. Non-Conference,2012,Colorado,0,3,3,0.0
vs. Ranked (AP),2012,Colorado,0,2,2,0.0
vs. Unranked (AP),2012,Colorado,1,9,10,0.1
vs. FBS (I-A),2012,Colorado,1,10,11,0.09090909090909091
vs. FCS (I-AA),2012,Colorado,0,1,1,0.0
vs. FBS Winning,2012,Colorado,0,8,8,0.0
vs. FBS Non-Winning,2012,Colorado,1,2,3,0.3333333333333333
vs. BCS AQ,2012,Colorado,1,8,9,0.1111111111111111
vs. BCS non-AQ,2012,Colorado,0,2,2,0.0
vs. FBS Power 5,2012,Colorado,1,8,9,0.1111111111111111
vs. FBS non-Power 5,2012,Colorado,0,2,2,0.0
in August/September,2012,Colorado,1,4,5,0.2
in October,2012,Colorado,0,3,3,0.0
in November,2012,Colorado,0,4,4,0.0
in December/January,2012,Colorado,0,0,0,
All Games,2013,Colorado,4,8,12,0.3333333333333333
at Home,2013,Colorado,3,3,6,0.5
on Road/Neutral Site,2013,Colorado,1,5,6,0.16666666666666666
vs. Conference,2013,Colorado,1,8,9,0.1111111111111111
vs. Non-Conference,2013,Colorado,3,0,3,1.0
vs. Ranked (AP),2013,Colorado,0,5,5,0.0
vs. Unranked (AP),2013,Colorado,4,3,7,0.5714285714285714
vs. FBS (I-A),2013,Colorado,2,8,10,0.2
vs. FCS (I-AA),2013,Colorado,2,0,2,1.0
vs. FBS Winning,2013,Colorado,1,7,8,0.125
vs. FBS Non-Winning,2013,Colorado,1,1,2,0.5
vs. BCS AQ,2013,Colorado,1,8,9,0.1111111111111111
vs. BCS non-AQ,2013,Colorado,1,0,1,1.0
vs. FBS Power 5,2013,Colorado,1,8,9,0.1111111111111111
vs. FBS non-Power 5,2013,Colorado,1,0,1,1.0
in August/September,2013,Colorado,2,1,3,0.6666666666666666
in October,2013,Colorado,1,3,4,0.25
in November,2013,Colorado,1,4,5,0.2
in December/January,2013,Colorado,0,0,0,
All Games,2014,Colorado,2,10,12,0.16666666666666666
at Home,2014,Colorado,1,5,6,0.16666666666666666
on Road/Neutral Site,2014,Colorado,1,5,6,0.16666666666666666
vs. Conference,2014,Colorado,0,9,9,0.0
vs. Non-Conference,2014,Colorado,2,1,3,0.6666666666666666
vs. Ranked (AP),2014,Colorado,0,6,6,0.0
vs. Unranked (AP),2014,Colorado,2,4,6,0.3333333333333333
vs. FBS (I-A),2014,Colorado,2,10,12,0.16666666666666666
vs. FCS (I-AA),2014,Colorado,0,0,0,
vs. FBS Winning,2014,Colorado,0,8,8,0.0
vs. FBS Non-Winning,2014,Colorado,2,2,4,0.5
vs. BCS AQ,2014,Colorado,0,9,9,0.0
vs. BCS non-AQ,2014,Colorado,2,1,3,0.6666666666666666
vs. FBS Power 5,2014,Colorado,0,9,9,0.0
vs. FBS non-Power 5,2014,Colorado,2,1,3,0.6666666666666666
in August/September,2014,Colorado,2,3,5,0.4
in October,2014,Colorado,0,3,3,0.0
in November,2014,Colorado,0,4,4,0.0
in December/January,2014,Colorado,0,0,0,
All Games,2015,Colorado,4,9,13,0.3076923076923077
at Home,2015,Colorado,2,4,6,0.3333333333333333
on Road/Neutral Site,2015,Colorado,2,5,7,0.2857142857142857
vs. Conference,2015,Colorado,1,8,9,0.1111111111111111
vs. Non-Conference,2015,Colorado,3,1,4,0.75
vs. Ranked (AP),2015,Colorado,0,3,3,0.0
vs. Unranked (AP),2015,Colorado,4,6,10,0.4
vs. FBS (I-A),2015,Colorado,3,9,12,0.25
vs. FCS (I-AA),2015,Colorado,1,0,1,1.0
vs. FBS Winning,2015,Colorado,1,7,8,0.125
vs. FBS Non-Winning,2015,Colorado,2,2,4,0.5
vs. BCS AQ,2015,Colorado,1,8,9,0.1111111111111111
vs. BCS non-AQ,2015,Colorado,2,1,3,0.6666666666666666
vs. FBS Power 5,2015,Colorado,1,8,9,0.1111111111111111
vs. FBS non-Power 5,2015,Colorado,2,1,3,0.6666666666666666
in August/September,2015,Colorado,3,1,4,0.75
in October,2015,Colorado,1,4,5,0.2
in November,2015,Colorado,0,4,4,0.0
in December/January,2015,Colorado,0,0,0,
All Games,2016,Colorado,10,4,14,0.7142857142857143
at Home,2016,Colorado,6,0,6,1.0
on Road/Neutral Site,2016,Colorado,4,4,8,0.5
vs. Conference,2016,Colorado,8,2,10,0.8
vs. Non-Conference,2016,Colorado,2,2,4,0.5
vs. Ranked (AP),2016,Colorado,1,4,5,0.2
vs. Unranked (AP),2016,Colorado,9,0,9,1.0
vs. FBS (I-A),2016,Colorado,9,4,13,0.6923076923076923
vs. FCS (I-AA),2016,Colorado,1,0,1,1.0
vs. FBS Winning,2016,Colorado,4,4,8,0.5
vs. FBS Non-Winning,2016,Colorado,5,0,5,1.0
vs. BCS AQ,2016,Colorado,8,4,12,0.6666666666666666
vs. BCS non-AQ,2016,Colorado,1,0,1,1.0
vs. FBS Power 5,2016,Colorado,8,4,12,0.6666666666666666
vs. FBS non-Power 5,2016,Colorado,1,0,1,1.0
in August/September,2016,Colorado,3,1,4,0.75
in October,2016,Colorado,3,1,4,0.75
in November,2016,Colorado,4,0,4,1.0
in December/January,2016,Colorado,0,2,2,0.0
All Games,2017,Colorado,5,7,12,0.4166666666666667
at Home,2017,Colorado,3,3,6,0.5
on Road/Neutral Site,2017,Colorado,2,4,6,0.3333333333333333
vs. Conference,2017,Colorado,2,7,9,0.2222222222222222
vs. Non-Conference,2017,Colorado,3,0,3,1.0
vs. Ranked (AP),2017,Colorado,0,2,2,0.0
vs. Unranked (AP),2017,Colorado,5,5,10,0.5
vs. FBS (I-A),2017,Colorado,4,7,11,0.36363636363636365
vs. FCS (I-AA),2017,Colorado,1,0,1,1.0
vs. FBS Winning,2017,Colorado,1,6,7,0.14285714285714285
vs. FBS Non-Winning,2017,Colorado,3,1,4,0.75
vs. BCS AQ,2017,Colorado,2,7,9,0.2222222222222222
vs. BCS non-AQ,2017,Colorado,2,0,2,1.0
vs. FBS Power 5,2017,Colorado,2,7,9,0.2222222222222222
vs. FBS non-Power 5,2017,Colorado,2,0,2,1.0
in August/September,2017,Colorado,3,2,5,0.6
in October,2017,Colorado,2,2,4,0.5
in November,2017,Colorado,0,3,3,0.0
in December/January,2017,Colorado,0,0,0,
All Games,2018,Colorado,5,7,12,0.4166666666666667
at Home,2018,Colorado,3,3,6,0.5
on Road/Neutral Site,2018,Colorado,2,4,6,0.3333333333333333
vs. Conference,2018,Colorado,2,7,9,0.2222222222222222
vs. Non-Conference,2018,Colorado,3,0,3,1.0
vs. Ranked (AP),2018,Colorado,0,2,2,0.0
vs. Unranked (AP),2018,Colorado,5,5,10,0.5
vs. FBS (I-A),2018,Colorado,4,7,11,0.36363636363636365
vs. FCS (I-AA),2018,Colorado,1,0,1,1.0
vs. FBS Winning,2018,Colorado,1,4,5,0.2
vs. FBS Non-Winning,2018,Colorado,3,3,6,0.5
vs. BCS AQ,2018,Colorado,3,7,10,0.3
vs. BCS non-AQ,2018,Colorado,1,0,1,1.0
vs. FBS Power 5,2018,Colorado,3,7,10,0.3
vs. FBS non-Power 5,2018,Colorado,1,0,1,1.0
in August/September,2018,Colorado,4,0,4,1.0
in October,2018,Colorado,1,3,4,0.25
in November,2018,Colorado,0,4,4,0.0
in December/January,2018,Colorado,0,0,0,
All Games,2019,Colorado,5,7,12,0.4166666666666667
at Home,2019,Colorado,3,3,6,0.5
on Road/Neutral Site,2019,Colorado,2,4,6,0.3333333333333333
vs. Conference,2019,Colorado,3,6,9,0.3333333333333333
vs. Non-Conference,2019,Colorado,2,1,3,0.6666666666666666
vs. Ranked (AP),2019,Colorado,0,3,3,0.0
vs. Unranked (AP),2019,Colorado,5,4,9,0.5555555555555556
vs. FBS (I-A),2019,Colorado,5,7,12,0.4166666666666667
vs. FCS (I-AA),2019,Colorado,0,0,0,
vs. FBS Winning,2019,Colorado,2,4,6,0.3333333333333333
vs. FBS Non-Winning,2019,Colorado,3,3,6,0.5
vs. BCS AQ,2019,Colorado,4,6,10,0.4
vs. BCS non-AQ,2019,Colorado,1,1,2,0.5
vs. FBS Power 5,2019,Colorado,4,6,10,0.4
vs. FBS non-Power 5,2019,Colorado,1,1,2,0.5
in August/September,2019,Colorado,3,1,4,0.75
in October,2019,Colorado,0,4,4,0.0
in November,2019,Colorado,2,2,4,0.5
in December/January,2019,Colorado,0,0,0,
All Games,2020,Colorado,4,2,6,0.6666666666666666
at Home,2020,Colorado,2,1,3,0.6666666666666666
on Road/Neutral Site,2020,Colorado,2,1,3,0.6666666666666666
vs. Conference,2020,Colorado,3,1,4,0.75
vs. Non-Conference,2020,Colorado,1,1,2,0.5
vs. Ranked (AP),2020,Colorado,0,1,1,0.0
vs. Unranked (AP),2020,Colorado,4,1,5,0.8
vs. FBS (I-A),2020,Colorado,4,2,6,0.6666666666666666
vs. FCS (I-AA),2020,Colorado,0,0,0,
vs. FBS Winning,2020,Colorado,1,2,3,0.3333333333333333
vs. FBS Non-Winning,2020,Colorado,3,0,3,1.0
vs. BCS AQ,2020,Colorado,3,2,5,0.6
vs. BCS non-AQ,2020,Colorado,1,0,1,1.0
vs. FBS Power 5,2020,Colorado,3,2,5,0.6
vs. FBS non-Power 5,2020,Colorado,1,0,1,1.0
in August/September,2020,Colorado,0,0,0,
in October,2020,Colorado,0,0,0,
in November,2020,Colorado,3,0,3,1.0
in December/January,2020,Colorado,1,2,3,0.3333333333333333
All Games,2021,Colorado,4,8,12,0.3333333333333333
at Home,2021,Colorado,4,2,6,0.6666666666666666
on Road/Neutral Site,2021,Colorado,0,6,6,0.0
vs. Conference,2021,Colorado,3,6,9,0.3333333333333333
vs. Non-Conference,2021,Colorado,1,2,3,0.3333333333333333
vs. Ranked (AP),2021,Colorado,0,2,2,0.0
vs. Unranked (AP),2021,Colorado,4,6,10,0.4
vs. FBS (I-A),2021,Colorado,3,8,11,0.2727272727272727
vs. FCS (I-AA),2021,Colorado,1,0,1,1.0
vs. FBS Winning,2021,Colorado,1,6,7,0.14285714285714285
vs. FBS Non-Winning,2021,Colorado,2,2,4,0.5
vs. BCS AQ,2021,Colorado,3,8,11,0.2727272727272727
vs. BCS non-AQ,2021,Colorado,0,0,0,
vs. FBS Power 5,2021,Colorado,3,8,11,0.2727272727272727
vs. FBS non-Power 5,2021,Colorado,0,0,0,
in August/September,2021,Colorado,1,3,4,0.25
in October,2021,Colorado,1,3,4,0.25
in November,2021,Colorado,2,2,4,0.5
in December/January,2021,Colorado,0,0,0,
All Games,2022,Colorado,1,11,12,0.08333333333333333
at Home,2022,Colorado,1,5,6,0.16666666666666666
on Road/Neutral Site,2022,Colorado,0,6,6,0.0
vs. Conference,2022,Colorado,1,8,9,0.1111111111111111
vs. Non-Conference,2022,Colorado,0,3,3,0.0
vs. Ranked (AP),2022,Colorado,0,7,7,0.0
vs. Unranked (AP),2022,Colorado,1,4,5,0.2
vs. FBS (I-A),2022,Colorado,1,11,12,0.08333333333333333
vs. FCS (I-AA),2022,Colorado,0,0,0,
vs. FBS Winning,2022,Colorado,0,9,9,0.0
vs. FBS Non-Winning,2022,Colorado,1,2,3,0.3333333333333333
vs. BCS AQ,2022,Colorado,1,10,11,0.09090909090909091
vs. BCS non-AQ,2022,Colorado,0,1,1,0.0
vs. FBS Power 5,2022,Colorado,1,10,11,0.09090909090909091
vs. FBS non-Power 5,2022,Colorado,0,1,1,0.0
in August/September,2022,Colorado,0,4,4,0.0
in October,2022,Colorado,1,3,4,0.25
in November,2022,Colorado,0,4,4,0.0
in December/January,2022,Colorado,0,0,0,
All Games,2009,Colorado State,3,9,12,0.25
at Home,2009,Colorado State,2,4,6,0.3333333333333333
on Road/Neutral Site,2009,Colorado State,1,5,6,0.16666666666666666
vs. Conference,2009,Colorado State,0,8,8,0.0
vs. Non-Conference,2009,Colorado State,3,1,4,0.75
vs. Ranked (AP),2009,Colorado State,0,3,3,0.0
vs. Unranked (AP),2009,Colorado State,3,6,9,0.3333333333333333
vs. FBS (I-A),2009,Colorado State,2,9,11,0.18181818181818182
vs. FCS (I-AA),2009,Colorado State,1,0,1,1.0
vs. FBS Winning,2009,Colorado State,1,6,7,0.14285714285714285
vs. FBS Non-Winning,2009,Colorado State,1,3,4,0.25
vs. BCS AQ,2009,Colorado State,1,0,1,1.0
vs. BCS non-AQ,2009,Colorado State,1,9,10,0.1
vs. FBS Power 5,2009,Colorado State,1,0,1,1.0
vs. FBS non-Power 5,2009,Colorado State,1,9,10,0.1
in August/September,2009,Colorado State,3,1,4,0.75
in October,2009,Colorado State,0,5,5,0.0
in November,2009,Colorado State,0,3,3,0.0
in December/January,2009,Colorado State,0,0,0,
All Games,2010,Colorado State,3,9,12,0.25
at Home,2010,Colorado State,3,2,5,0.6
on Road/Neutral Site,2010,Colorado State,0,7,7,0.0
vs. Conference,2010,Colorado State,2,6,8,0.25
vs. Non-Conference,2010,Colorado State,1,3,4,0.25
vs. Ranked (AP),2010,Colorado State,0,2,2,0.0
vs. Unranked (AP),2010,Colorado State,3,7,10,0.3
vs. FBS (I-A),2010,Colorado State,3,9,12,0.25
vs. FCS (I-AA),2010,Colorado State,0,0,0,
vs. FBS Winning,2010,Colorado State,0,7,7,0.0
vs. FBS Non-Winning,2010,Colorado State,3,2,5,0.6
vs. BCS AQ,2010,Colorado State,0,1,1,0.0
vs. BCS non-AQ,2010,Colorado State,3,8,11,0.2727272727272727
vs. FBS Power 5,2010,Colorado State,0,1,1,0.0
vs. FBS non-Power 5,2010,Colorado State,3,8,11,0.2727272727272727
in August/September,2010,Colorado State,1,3,4,0.25
in October,2010,Colorado State,2,3,5,0.4
in November,2010,Colorado State,0,3,3,0.0
in December/January,2010,Colorado State,0,0,0,
All Games,2011,Colorado State,3,9,12,0.25
at Home,2011,Colorado State,1,5,6,0.16666666666666666
on Road/Neutral Site,2011,Colorado State,2,4,6,0.3333333333333333
vs. Conference,2011,Colorado State,1,6,7,0.14285714285714285
vs. Non-Conference,2011,Colorado State,2,3,5,0.4
vs. Ranked (AP),2011,Colorado State,0,2,2,0.0
vs. Unranked (AP),2011,Colorado State,3,7,10,0.3
vs. FBS (I-A),2011,Colorado State,2,9,11,0.18181818181818182
vs. FCS (I-AA),2011,Colorado State,1,0,1,1.0
vs. FBS Winning,2011,Colorado State,1,5,6,0.16666666666666666
vs. FBS Non-Winning,2011,Colorado State,1,4,5,0.2
vs. BCS AQ,2011,Colorado State,0,1,1,0.0
vs. BCS non-AQ,2011,Colorado State,2,8,10,0.2
vs. FBS Power 5,2011,Colorado State,0,1,1,0.0
vs. FBS non-Power 5,2011,Colorado State,2,8,10,0.2
in August/September,2011,Colorado State,3,1,4,0.75
in October,2011,Colorado State,0,4,4,0.0
in November,2011,Colorado State,0,3,3,0.0
in December/January,2011,Colorado State,0,1,1,0.0
All Games,2012,Colorado State,4,8,12,0.3333333333333333
at Home,2012,Colorado State,3,3,6,0.5
on Road/Neutral Site,2012,Colorado State,1,5,6,0.16666666666666666
vs. Conference,2012,Colorado State,3,5,8,0.375
vs. Non-Conference,2012,Colorado State,1,3,4,0.25
vs. Ranked (AP),2012,Colorado State,0,3,3,0.0
vs. Unranked (AP),2012,Colorado State,4,5,9,0.4444444444444444
vs. FBS (I-A),2012,Colorado State,4,7,11,0.36363636363636365
vs. FCS (I-AA),2012,Colorado State,0,1,1,0.0
vs. FBS Winning,2012,Colorado State,0,5,5,0.0
vs. FBS Non-Winning,2012,Colorado State,4,2,6,0.6666666666666666
vs. BCS AQ,2012,Colorado State,1,0,1,1.0
vs. BCS non-AQ,2012,Colorado State,3,7,10,0.3
vs. FBS Power 5,2012,Colorado State,1,0,1,1.0
vs. FBS non-Power 5,2012,Colorado State,3,7,10,0.3
in August/September,2012,Colorado State,1,4,5,0.2
in October,2012,Colorado State,1,2,3,0.3333333333333333
in November,2012,Colorado State,2,2,4,0.5
in December/January,2012,Colorado State,0,0,0,
All Games,2013,Colorado State,8,6,14,0.5714285714285714
at Home,2013,Colorado State,4,2,6,0.6666666666666666
on Road/Neutral Site,2013,Colorado State,4,4,8,0.5
vs. Conference,2013,Colorado State,5,3,8,0.625
vs. Non-Conference,2013,Colorado State,3,3,6,0.5
vs. Ranked (AP),2013,Colorado State,0,1,1,0.0
vs. Unranked (AP),2013,Colorado State,8,5,13,0.6153846153846154
vs. FBS (I-A),2013,Colorado State,7,6,13,0.5384615384615384
vs. FCS (I-AA),2013,Colorado State,1,0,1,1.0
vs. FBS Winning,2013,Colorado State,0,3,3,0.0
vs. FBS Non-Winning,2013,Colorado State,7,3,10,0.7
vs. BCS AQ,2013,Colorado State,1,2,3,0.3333333333333333
vs. BCS non-AQ,2013,Colorado State,6,4,10,0.6
vs. FBS Power 5,2013,Colorado State,1,2,3,0.3333333333333333
vs. FBS non-Power 5,2013,Colorado State,6,4,10,0.6
in August/September,2013,Colorado State,2,3,5,0.4
in October,2013,Colorado State,2,1,3,0.6666666666666666
in November,2013,Colorado State,3,2,5,0.6
in December/January,2013,Colorado State,1,0,1,1.0
All Games,2014,Colorado State,10,3,13,0.7692307692307693
at Home,2014,Colorado State,6,0,6,1.0
on Road/Neutral Site,2014,Colorado State,4,3,7,0.5714285714285714
vs. Conference,2014,Colorado State,6,2,8,0.75
vs. Non-Conference,2014,Colorado State,4,1,5,0.8
vs. Ranked (AP),2014,Colorado State,0,2,2,0.0
vs. Unranked (AP),2014,Colorado State,10,1,11,0.9090909090909091
vs. FBS (I-A),2014,Colorado State,9,3,12,0.75
vs. FCS (I-AA),2014,Colorado State,1,0,1,1.0
vs. FBS Winning,2014,Colorado State,3,3,6,0.5
vs. FBS Non-Winning,2014,Colorado State,6,0,6,1.0
vs. BCS AQ,2014,Colorado State,3,1,4,0.75
vs. BCS non-AQ,2014,Colorado State,6,2,8,0.75
vs. FBS Power 5,2014,Colorado State,2,1,3,0.6666666666666666
vs. FBS non-Power 5,2014,Colorado State,7,2,9,0.7777777777777778
in August/September,2014,Colorado State,3,1,4,0.75
in October,2014,Colorado State,4,0,4,1.0
in November,2014,Colorado State,3,1,4,0.75
in December/January,2014,Colorado State,0,1,1,0.0
All Games,2015,Colorado State,7,6,13,0.5384615384615384
at Home,2015,Colorado State,3,3,6,0.5
on Road/Neutral Site,2015,Colorado State,4,3,7,0.5714285714285714
vs. Conference,2015,Colorado State,5,4,9,0.5555555555555556
vs. Non-Conference,2015,Colorado State,2,2,4,0.5
vs. Ranked (AP),2015,Colorado State,0,0,0,
vs. Unranked (AP),2015,Colorado State,7,6,13,0.5384615384615384
vs. FBS (I-A),2015,Colorado State,6,6,12,0.5
vs. FCS (I-AA),2015,Colorado State,1,0,1,1.0
vs. FBS Winning,2015,Colorado State,2,3,5,0.4
vs. FBS Non-Winning,2015,Colorado State,4,3,7,0.5714285714285714
vs. BCS AQ,2015,Colorado State,0,2,2,0.0
vs. BCS non-AQ,2015,Colorado State,6,4,10,0.6
vs. FBS Power 5,2015,Colorado State,0,2,2,0.0
vs. FBS non-Power 5,2015,Colorado State,6,4,10,0.6
in August/September,2015,Colorado State,2,2,4,0.5
in October,2015,Colorado State,1,3,4,0.25
in November,2015,Colorado State,4,0,4,1.0
in December/January,2015,Colorado State,0,1,1,0.0
All Games,2016,Colorado State,7,6,13,0.5384615384615384
at Home,2016,Colorado State,5,1,6,0.8333333333333334
on Road/Neutral Site,2016,Colorado State,2,5,7,0.2857142857142857
vs. Conference,2016,Colorado State,5,3,8,0.625
vs. Non-Conference,2016,Colorado State,2,3,5,0.4
vs. Ranked (AP),2016,Colorado State,0,1,1,0.0
vs. Unranked (AP),2016,Colorado State,7,5,12,0.5833333333333334
vs. FBS (I-A),2016,Colorado State,6,6,12,0.5
vs. FCS (I-AA),2016,Colorado State,1,0,1,1.0
vs. FBS Winning,2016,Colorado State,2,6,8,0.25
vs. FBS Non-Winning,2016,Colorado State,4,0,4,1.0
vs. BCS AQ,2016,Colorado State,0,2,2,0.0
vs. BCS non-AQ,2016,Colorado State,6,4,10,0.6
vs. FBS Power 5,2016,Colorado State,0,2,2,0.0
vs. FBS non-Power 5,2016,Colorado State,6,4,10,0.6
in August/September,2016,Colorado State,2,2,4,0.5
in October,2016,Colorado State,2,2,4,0.5
in November,2016,Colorado State,3,1,4,0.75
in December/January,2016,Colorado State,0,1,1,0.0
All Games,2017,Colorado State,7,6,13,0.5384615384615384
at Home,2017,Colorado State,4,2,6,0.6666666666666666
on Road/Neutral Site,2017,Colorado State,3,4,7,0.42857142857142855
vs. Conference,2017,Colorado State,5,3,8,0.625
vs. Non-Conference,2017,Colorado State,2,3,5,0.4
vs. Ranked (AP),2017,Colorado State,0,2,2,0.0
vs. Unranked (AP),2017,Colorado State,7,4,11,0.6363636363636364
vs. FBS (I-A),2017,Colorado State,6,6,12,0.5
vs. FCS (I-AA),2017,Colorado State,1,0,1,1.0
vs. FBS Winning,2017,Colorado State,0,4,4,0.0
vs. FBS Non-Winning,2017,Colorado State,6,2,8,0.75
vs. BCS AQ,2017,Colorado State,1,2,3,0.3333333333333333
vs. BCS non-AQ,2017,Colorado State,5,4,9,0.5555555555555556
vs. FBS Power 5,2017,Colorado State,1,2,3,0.3333333333333333
vs. FBS non-Power 5,2017,Colorado State,5,4,9,0.5555555555555556
in August/September,2017,Colorado State,3,2,5,0.6
in October,2017,Colorado State,3,1,4,0.75
in November,2017,Colorado State,1,2,3,0.3333333333333333
in December/January,2017,Colorado State,0,1,1,0.0
All Games,2018,Colorado State,3,9,12,0.25
at Home,2018,Colorado State,2,4,6,0.3333333333333333
on Road/Neutral Site,2018,Colorado State,1,5,6,0.16666666666666666
vs. Conference,2018,Colorado State,2,6,8,0.25
vs. Non-Conference,2018,Colorado State,1,3,4,0.25
vs. Ranked (AP),2018,Colorado State,0,3,3,0.0
vs. Unranked (AP),2018,Colorado State,3,6,9,0.3333333333333333
vs. FBS (I-A),2018,Colorado State,3,8,11,0.2727272727272727
vs. FCS (I-AA),2018,Colorado State,0,1,1,0.0
vs. FBS Winning,2018,Colorado State,0,5,5,0.0
vs. FBS Non-Winning,2018,Colorado State,3,3,6,0.5
vs. BCS AQ,2018,Colorado State,1,2,3,0.3333333333333333
vs. BCS non-AQ,2018,Colorado State,2,6,8,0.25
vs. FBS Power 5,2018,Colorado State,1,2,3,0.3333333333333333
vs. FBS non-Power 5,2018,Colorado State,2,6,8,0.25
in August/September,2018,Colorado State,1,4,5,0.2
in October,2018,Colorado State,2,2,4,0.5
in November,2018,Colorado State,0,3,3,0.0
in December/January,2018,Colorado State,0,0,0,
All Games,2019,Colorado State,4,8,12,0.3333333333333333
at Home,2019,Colorado State,2,4,6,0.3333333333333333
on Road/Neutral Site,2019,Colorado State,2,4,6,0.3333333333333333
vs. Conference,2019,Colorado State,3,5,8,0.375
vs. Non-Conference,2019,Colorado State,1,3,4,0.25
vs. Ranked (AP),2019,Colorado State,0,2,2,0.0
vs. Unranked (AP),2019,Colorado State,4,6,10,0.4
vs. FBS (I-A),2019,Colorado State,3,8,11,0.2727272727272727
vs. FCS (I-AA),2019,Colorado State,1,0,1,1.0
vs. FBS Winning,2019,Colorado State,0,5,5,0.0
vs. FBS Non-Winning,2019,Colorado State,3,3,6,0.5
vs. BCS AQ,2019,Colorado State,0,2,2,0.0
vs. BCS non-AQ,2019,Colorado State,3,6,9,0.3333333333333333
vs. FBS Power 5,2019,Colorado State,0,2,2,0.0
vs. FBS non-Power 5,2019,Colorado State,3,6,9,0.3333333333333333
in August/September,2019,Colorado State,1,4,5,0.2
in October,2019,Colorado State,2,1,3,0.6666666666666666
in November,2019,Colorado State,1,3,4,0.25
in December/January,2019,Colorado State,0,0,0,
All Games,2020,Colorado State,1,3,4,0.25
at Home,2020,Colorado State,1,0,1,1.0
on Road/Neutral Site,2020,Colorado State,0,3,3,0.0
vs. Conference,2020,Colorado State,1,3,4,0.25
vs. Non-Conference,2020,Colorado State,0,0,0,
vs. Ranked (AP),2020,Colorado State,0,0,0,
vs. Unranked (AP),2020,Colorado State,1,3,4,0.25
vs. FBS (I-A),2020,Colorado State,1,3,4,0.25
vs. FCS (I-AA),2020,Colorado State,0,0,0,
vs. FBS Winning,2020,Colorado State,0,1,1,0.0
vs. FBS Non-Winning,2020,Colorado State,1,2,3,0.3333333333333333
vs. BCS AQ,2020,Colorado State,0,0,0,
vs. BCS non-AQ,2020,Colorado State,1,3,4,0.25
vs. FBS Power 5,2020,Colorado State,0,0,0,
vs. FBS non-Power 5,2020,Colorado State,1,3,4,0.25
in August/September,2020,Colorado State,0,0,0,
in October,2020,Colorado State,0,1,1,0.0
in November,2020,Colorado State,1,1,2,0.5
in December/January,2020,Colorado State,0,1,1,0.0
All Games,2021,Colorado State,3,9,12,0.25
at Home,2021,Colorado State,1,5,6,0.16666666666666666
on Road/Neutral Site,2021,Colorado State,2,4,6,0.3333333333333333
vs. Conference,2021,Colorado State,2,6,8,0.25
vs. Non-Conference,2021,Colorado State,1,3,4,0.25
vs. Ranked (AP),2021,Colorado State,0,2,2,0.0
vs. Unranked (AP),2021,Colorado State,3,7,10,0.3
vs. FBS (I-A),2021,Colorado State,3,8,11,0.2727272727272727
vs. FCS (I-AA),2021,Colorado State,0,1,1,0.0
vs. FBS Winning,2021,Colorado State,1,6,7,0.14285714285714285
vs. FBS Non-Winning,2021,Colorado State,2,2,4,0.5
vs. BCS AQ,2021,Colorado State,0,2,2,0.0
vs. BCS non-AQ,2021,Colorado State,3,6,9,0.3333333333333333
vs. FBS Power 5,2021,Colorado State,0,2,2,0.0
vs. FBS non-Power 5,2021,Colorado State,3,6,9,0.3333333333333333
in August/September,2021,Colorado State,1,3,4,0.25
in October,2021,Colorado State,2,2,4,0.5
in November,2021,Colorado State,0,4,4,0.0
in December/January,2021,Colorado State,0,0,0,
All Games,2022,Colorado State,3,9,12,0.25
at Home,2022,Colorado State,2,4,6,0.3333333333333333
on Road/Neutral Site,2022,Colorado State,1,5,6,0.16666666666666666
vs. Conference,2022,Colorado State,3,5,8,0.375
vs. Non-Conference,2022,Colorado State,0,4,4,0.0
vs. Ranked (AP),2022,Colorado State,0,1,1,0.0
vs. Unranked (AP),2022,Colorado State,3,8,11,0.2727272727272727
vs. FBS (I-A),2022,Colorado State,3,8,11,0.2727272727272727
vs. FCS (I-AA),2022,Colorado State,0,1,1,0.0
vs. FBS Winning,2022,Colorado State,0,7,7,0.0
vs. FBS Non-Winning,2022,Colorado State,3,1,4,0.75
vs. BCS AQ,2022,Colorado State,0,2,2,0.0
vs. BCS non-AQ,2022,Colorado State,3,6,9,0.3333333333333333
vs. FBS Power 5,2022,Colorado State,0,2,2,0.0
vs. FBS non-Power 5,2022,Colorado State,3,6,9,0.3333333333333333
in August/September,2022,Colorado State,0,4,4,0.0
in October,2022,Colorado State,2,2,4,0.5
in November,2022,Colorado State,1,3,4,0.25
in December/January,2022,Colorado State,0,0,0,
All Games,2009,Connecticut,8,5,13,0.6153846153846154
at Home,2009,Connecticut,4,2,6,0.6666666666666666
on Road/Neutral Site,2009,Connecticut,4,3,7,0.5714285714285714
vs. Conference,2009,Connecticut,3,4,7,0.42857142857142855
vs. Non-Conference,2009,Connecticut,5,1,6,0.8333333333333334
vs. Ranked (AP),2009,Connecticut,0,3,3,0.0
vs. Unranked (AP),2009,Connecticut,8,2,10,0.8
vs. FBS (I-A),2009,Connecticut,7,5,12,0.5833333333333334
vs. FCS (I-AA),2009,Connecticut,1,0,1,1.0
vs. FBS Winning,2009,Connecticut,3,5,8,0.375
vs. FBS Non-Winning,2009,Connecticut,4,0,4,1.0
vs. BCS AQ,2009,Connecticut,6,5,11,0.5454545454545454
vs. BCS non-AQ,2009,Connecticut,1,0,1,1.0
vs. FBS Power 5,2009,Connecticut,2,1,3,0.6666666666666666
vs. FBS non-Power 5,2009,Connecticut,5,4,9,0.5555555555555556
in August/September,2009,Connecticut,3,1,4,0.75
in October,2009,Connecticut,1,3,4,0.25
in November,2009,Connecticut,2,1,3,0.6666666666666666
in December/January,2009,Connecticut,2,0,2,1.0
All Games,2010,Connecticut,8,5,13,0.6153846153846154
at Home,2010,Connecticut,6,0,6,1.0
on Road/Neutral Site,2010,Connecticut,2,5,7,0.2857142857142857
vs. Conference,2010,Connecticut,5,2,7,0.7142857142857143
vs. Non-Conference,2010,Connecticut,3,3,6,0.5
vs. Ranked (AP),2010,Connecticut,0,1,1,0.0
vs. Unranked (AP),2010,Connecticut,8,4,12,0.6666666666666666
vs. FBS (I-A),2010,Connecticut,7,5,12,0.5833333333333334
vs. FCS (I-AA),2010,Connecticut,1,0,1,1.0
vs. FBS Winning,2010,Connecticut,4,4,8,0.5
vs. FBS Non-Winning,2010,Connecticut,3,1,4,0.75
vs. BCS AQ,2010,Connecticut,6,4,10,0.6
vs. BCS non-AQ,2010,Connecticut,1,1,2,0.5
vs. FBS Power 5,2010,Connecticut,1,2,3,0.3333333333333333
vs. FBS non-Power 5,2010,Connecticut,6,3,9,0.6666666666666666
in August/September,2010,Connecticut,2,2,4,0.5
in October,2010,Connecticut,2,2,4,0.5
in November,2010,Connecticut,3,0,3,1.0
in December/January,2010,Connecticut,1,1,2,0.5
All Games,2011,Connecticut,5,7,12,0.4166666666666667
at Home,2011,Connecticut,4,3,7,0.5714285714285714
on Road/Neutral Site,2011,Connecticut,1,4,5,0.2
vs. Conference,2011,Connecticut,3,4,7,0.42857142857142855
vs. Non-Conference,2011,Connecticut,2,3,5,0.4
vs. Ranked (AP),2011,Connecticut,0,2,2,0.0
vs. Unranked (AP),2011,Connecticut,5,5,10,0.5
vs. FBS (I-A),2011,Connecticut,4,7,11,0.36363636363636365
vs. FCS (I-AA),2011,Connecticut,1,0,1,1.0
vs. FBS Winning,2011,Connecticut,1,4,5,0.2
vs. FBS Non-Winning,2011,Connecticut,3,3,6,0.5
vs. BCS AQ,2011,Connecticut,3,6,9,0.3333333333333333
vs. BCS non-AQ,2011,Connecticut,1,1,2,0.5
vs. FBS Power 5,2011,Connecticut,0,2,2,0.0
vs. FBS non-Power 5,2011,Connecticut,4,5,9,0.4444444444444444
in August/September,2011,Connecticut,2,2,4,0.5
in October,2011,Connecticut,1,3,4,0.25
in November,2011,Connecticut,2,1,3,0.6666666666666666
in December/January,2011,Connecticut,0,1,1,0.0
All Games,2012,Connecticut,5,7,12,0.4166666666666667
at Home,2012,Connecticut,3,3,6,0.5
on Road/Neutral Site,2012,Connecticut,2,4,6,0.3333333333333333
vs. Conference,2012,Connecticut,2,5,7,0.2857142857142857
vs. Non-Conference,2012,Connecticut,3,2,5,0.6
vs. Ranked (AP),2012,Connecticut,1,0,1,1.0
vs. Unranked (AP),2012,Connecticut,4,7,11,0.36363636363636365
vs. FBS (I-A),2012,Connecticut,5,7,12,0.4166666666666667
vs. FCS (I-AA),2012,Connecticut,0,0,0,
vs. FBS Winning,2012,Connecticut,1,4,5,0.2
vs. FBS Non-Winning,2012,Connecticut,4,3,7,0.5714285714285714
vs. BCS AQ,2012,Connecticut,3,6,9,0.3333333333333333
vs. BCS non-AQ,2012,Connecticut,2,1,3,0.6666666666666666
vs. FBS Power 5,2012,Connecticut,1,1,2,0.5
vs. FBS non-Power 5,2012,Connecticut,4,6,10,0.4
in August/September,2012,Connecticut,3,2,5,0.6
in October,2012,Connecticut,0,3,3,0.0
in November,2012,Connecticut,2,1,3,0.6666666666666666
in December/January,2012,Connecticut,0,1,1,0.0
All Games,2013,Connecticut,3,9,12,0.25
at Home,2013,Connecticut,2,5,7,0.2857142857142857
on Road/Neutral Site,2013,Connecticut,1,4,5,0.2
vs. Conference,2013,Connecticut,3,5,8,0.375
vs. Non-Conference,2013,Connecticut,0,4,4,0.0
vs. Ranked (AP),2013,Connecticut,0,2,2,0.0
vs. Unranked (AP),2013,Connecticut,3,7,10,0.3
vs. FBS (I-A),2013,Connecticut,3,8,11,0.2727272727272727
vs. FCS (I-AA),2013,Connecticut,0,1,1,0.0
vs. FBS Winning,2013,Connecticut,0,6,6,0.0
vs. FBS Non-Winning,2013,Connecticut,3,2,5,0.6
vs. BCS AQ,2013,Connecticut,3,7,10,0.3
vs. BCS non-AQ,2013,Connecticut,0,1,1,0.0
vs. FBS Power 5,2013,Connecticut,0,2,2,0.0
vs. FBS non-Power 5,2013,Connecticut,3,6,9,0.3333333333333333
in August/September,2013,Connecticut,0,4,4,0.0
in October,2013,Connecticut,0,3,3,0.0
in November,2013,Connecticut,2,2,4,0.5
in December/January,2013,Connecticut,1,0,1,1.0
All Games,2014,Connecticut,2,10,12,0.16666666666666666
at Home,2014,Connecticut,2,5,7,0.2857142857142857
on Road/Neutral Site,2014,Connecticut,0,5,5,0.0
vs. Conference,2014,Connecticut,1,7,8,0.125
vs. Non-Conference,2014,Connecticut,1,3,4,0.25
vs. Ranked (AP),2014,Connecticut,0,2,2,0.0
vs. Unranked (AP),2014,Connecticut,2,8,10,0.2
vs. FBS (I-A),2014,Connecticut,1,10,11,0.09090909090909091
vs. FCS (I-AA),2014,Connecticut,1,0,1,1.0
vs. FBS Winning,2014,Connecticut,1,5,6,0.16666666666666666
vs. FBS Non-Winning,2014,Connecticut,0,5,5,0.0
vs. BCS AQ,2014,Connecticut,1,7,8,0.125
vs. BCS non-AQ,2014,Connecticut,0,3,3,0.0
vs. FBS Power 5,2014,Connecticut,0,0,0,
vs. FBS non-Power 5,2014,Connecticut,1,10,11,0.09090909090909091
in August/September,2014,Connecticut,1,4,5,0.2
in October,2014,Connecticut,0,2,2,0.0
in November,2014,Connecticut,1,3,4,0.25
in December/January,2014,Connecticut,0,1,1,0.0
All Games,2015,Connecticut,6,7,13,0.46153846153846156
at Home,2015,Connecticut,4,2,6,0.6666666666666666
on Road/Neutral Site,2015,Connecticut,2,5,7,0.2857142857142857
vs. Conference,2015,Connecticut,4,4,8,0.5
vs. Non-Conference,2015,Connecticut,2,3,5,0.4
vs. Ranked (AP),2015,Connecticut,1,1,2,0.5
vs. Unranked (AP),2015,Connecticut,5,6,11,0.45454545454545453
vs. FBS (I-A),2015,Connecticut,5,7,12,0.4166666666666667
vs. FCS (I-AA),2015,Connecticut,1,0,1,1.0
vs. FBS Winning,2015,Connecticut,1,6,7,0.14285714285714285
vs. FBS Non-Winning,2015,Connecticut,4,1,5,0.8
vs. BCS AQ,2015,Connecticut,4,5,9,0.4444444444444444
vs. BCS non-AQ,2015,Connecticut,1,2,3,0.3333333333333333
vs. FBS Power 5,2015,Connecticut,0,1,1,0.0
vs. FBS non-Power 5,2015,Connecticut,5,6,11,0.45454545454545453
in August/September,2015,Connecticut,2,2,4,0.5
in October,2015,Connecticut,2,3,5,0.4
in November,2015,Connecticut,2,1,3,0.6666666666666666
in December/January,2015,Connecticut,0,1,1,0.0
All Games,2016,Connecticut,3,9,12,0.25
at Home,2016,Connecticut,3,4,7,0.42857142857142855
on Road/Neutral Site,2016,Connecticut,0,5,5,0.0
vs. Conference,2016,Connecticut,1,7,8,0.125
vs. Non-Conference,2016,Connecticut,2,2,4,0.5
vs. Ranked (AP),2016,Connecticut,0,2,2,0.0
vs. Unranked (AP),2016,Connecticut,3,7,10,0.3
vs. FBS (I-A),2016,Connecticut,2,9,11,0.18181818181818182
vs. FCS (I-AA),2016,Connecticut,1,0,1,1.0
vs. FBS Winning,2016,Connecticut,0,5,5,0.0
vs. FBS Non-Winning,2016,Connecticut,2,4,6,0.3333333333333333
vs. BCS AQ,2016,Connecticut,2,9,11,0.18181818181818182
vs. BCS non-AQ,2016,Connecticut,0,0,0,
vs. FBS Power 5,2016,Connecticut,1,2,3,0.3333333333333333
vs. FBS non-Power 5,2016,Connecticut,1,7,8,0.125
in August/September,2016,Connecticut,2,3,5,0.4
in October,2016,Connecticut,1,3,4,0.25
in November,2016,Connecticut,0,3,3,0.0
in December/January,2016,Connecticut,0,0,0,
All Games,2017,Connecticut,3,9,12,0.25
at Home,2017,Connecticut,2,4,6,0.3333333333333333
on Road/Neutral Site,2017,Connecticut,1,5,6,0.16666666666666666
vs. Conference,2017,Connecticut,2,6,8,0.25
vs. Non-Conference,2017,Connecticut,1,3,4,0.25
vs. Ranked (AP),2017,Connecticut,0,3,3,0.0
vs. Unranked (AP),2017,Connecticut,3,6,9,0.3333333333333333
vs. FBS (I-A),2017,Connecticut,2,9,11,0.18181818181818182
vs. FCS (I-AA),2017,Connecticut,1,0,1,1.0
vs. FBS Winning,2017,Connecticut,1,6,7,0.14285714285714285
vs. FBS Non-Winning,2017,Connecticut,1,3,4,0.25
vs. BCS AQ,2017,Connecticut,2,9,11,0.18181818181818182
vs. BCS non-AQ,2017,Connecticut,0,0,0,
vs. FBS Power 5,2017,Connecticut,0,3,3,0.0
vs. FBS non-Power 5,2017,Connecticut,2,6,8,0.25
in August/September,2017,Connecticut,1,3,4,0.25
in October,2017,Connecticut,2,2,4,0.5
in November,2017,Connecticut,0,4,4,0.0
in December/January,2017,Connecticut,0,0,0,
All Games,2018,Connecticut,1,11,12,0.08333333333333333
at Home,2018,Connecticut,1,5,6,0.16666666666666666
on Road/Neutral Site,2018,Connecticut,0,6,6,0.0
vs. Conference,2018,Connecticut,0,8,8,0.0
vs. Non-Conference,2018,Connecticut,1,3,4,0.25
vs. Ranked (AP),2018,Connecticut,0,4,4,0.0
vs. Unranked (AP),2018,Connecticut,1,7,8,0.125
vs. FBS (I-A),2018,Connecticut,0,11,11,0.0
vs. FCS (I-AA),2018,Connecticut,1,0,1,1.0
vs. FBS Winning,2018,Connecticut,0,7,7,0.0
vs. FBS Non-Winning,2018,Connecticut,0,4,4,0.0
vs. BCS AQ,2018,Connecticut,0,9,9,0.0
vs. BCS non-AQ,2018,Connecticut,0,2,2,0.0
vs. FBS Power 5,2018,Connecticut,0,1,1,0.0
vs. FBS non-Power 5,2018,Connecticut,0,10,10,0.0
in August/September,2018,Connecticut,1,4,5,0.2
in October,2018,Connecticut,0,3,3,0.0
in November,2018,Connecticut,0,4,4,0.0
in December/January,2018,Connecticut,0,0,0,
All Games,2019,Connecticut,2,10,12,0.16666666666666666
at Home,2019,Connecticut,1,5,6,0.16666666666666666
on Road/Neutral Site,2019,Connecticut,1,5,6,0.16666666666666666
vs. Conference,2019,Connecticut,0,8,8,0.0
vs. Non-Conference,2019,Connecticut,2,2,4,0.5
vs. Ranked (AP),2019,Connecticut,0,3,3,0.0
vs. Unranked (AP),2019,Connecticut,2,7,9,0.2222222222222222
vs. FBS (I-A),2019,Connecticut,1,10,11,0.09090909090909091
vs. FCS (I-AA),2019,Connecticut,1,0,1,1.0
vs. FBS Winning,2019,Connecticut,0,6,6,0.0
vs. FBS Non-Winning,2019,Connecticut,1,4,5,0.2
vs. BCS AQ,2019,Connecticut,0,10,10,0.0
vs. BCS non-AQ,2019,Connecticut,1,0,1,1.0
vs. FBS Power 5,2019,Connecticut,0,2,2,0.0
vs. FBS non-Power 5,2019,Connecticut,1,8,9,0.1111111111111111
in August/September,2019,Connecticut,1,3,4,0.25
in October,2019,Connecticut,1,3,4,0.25
in November,2019,Connecticut,0,4,4,0.0
in December/January,2019,Connecticut,0,0,0,
All Games,2020,Connecticut,0,0,0,
at Home,2020,Connecticut,0,0,0,
on Road/Neutral Site,2020,Connecticut,0,0,0,
vs. Conference,2020,Connecticut,0,0,0,
vs. Non-Conference,2020,Connecticut,0,0,0,
vs. Ranked (AP),2020,Connecticut,0,0,0,
vs. Unranked (AP),2020,Connecticut,0,0,0,
vs. FBS (I-A),2020,Connecticut,0,0,0,
vs. FCS (I-AA),2020,Connecticut,0,0,0,
vs. FBS Winning,2020,Connecticut,0,0,0,
vs. FBS Non-Winning,2020,Connecticut,0,0,0,
vs. BCS AQ,2020,Connecticut,0,0,0,
vs. BCS non-AQ,2020,Connecticut,0,0,0,
vs. FBS Power 5,2020,Connecticut,0,0,0,
vs. FBS non-Power 5,2020,Connecticut,0,0,0,
in August/September,2020,Connecticut,0,0,0,
in October,2020,Connecticut,0,0,0,
in November,2020,Connecticut,0,0,0,
in December/January,2020,Connecticut,0,0,0,
All Games,2021,Connecticut,1,11,12,0.08333333333333333
at Home,2021,Connecticut,1,5,6,0.16666666666666666
on Road/Neutral Site,2021,Connecticut,0,6,6,0.0
vs. Conference,2021,Connecticut,0,2,2,0.0
vs. Non-Conference,2021,Connecticut,1,9,10,0.1
vs. Ranked (AP),2021,Connecticut,0,2,2,0.0
vs. Unranked (AP),2021,Connecticut,1,9,10,0.1
vs. FBS (I-A),2021,Connecticut,0,10,10,0.0
vs. FCS (I-AA),2021,Connecticut,1,1,2,0.5
vs. FBS Winning,2021,Connecticut,0,8,8,0.0
vs. FBS Non-Winning,2021,Connecticut,0,2,2,0.0
vs. BCS AQ,2021,Connecticut,0,5,5,0.0
vs. BCS non-AQ,2021,Connecticut,0,5,5,0.0
vs. FBS Power 5,2021,Connecticut,0,3,3,0.0
vs. FBS non-Power 5,2021,Connecticut,0,7,7,0.0
in August/September,2021,Connecticut,0,5,5,0.0
in October,2021,Connecticut,1,3,4,0.25
in November,2021,Connecticut,0,3,3,0.0
in December/January,2021,Connecticut,0,0,0,
All Games,2022,Connecticut,6,7,13,0.46153846153846156
at Home,2022,Connecticut,5,1,6,0.8333333333333334
on Road/Neutral Site,2022,Connecticut,1,6,7,0.14285714285714285
vs. Conference,2022,Connecticut,2,1,3,0.6666666666666666
vs. Non-Conference,2022,Connecticut,4,6,10,0.4
vs. Ranked (AP),2022,Connecticut,1,1,2,0.5
vs. Unranked (AP),2022,Connecticut,5,6,11,0.45454545454545453
vs. FBS (I-A),2022,Connecticut,5,7,12,0.4166666666666667
vs. FCS (I-AA),2022,Connecticut,1,0,1,1.0
vs. FBS Winning,2022,Connecticut,2,4,6,0.3333333333333333
vs. FBS Non-Winning,2022,Connecticut,3,3,6,0.5
vs. BCS AQ,2022,Connecticut,1,3,4,0.25
vs. BCS non-AQ,2022,Connecticut,4,4,8,0.5
vs. FBS Power 5,2022,Connecticut,1,3,4,0.25
vs. FBS non-Power 5,2022,Connecticut,4,4,8,0.5
in August/September,2022,Connecticut,1,4,5,0.2
in October,2022,Connecticut,3,1,4,0.75
in November,2022,Connecticut,2,1,3,0.6666666666666666
in December/January,2022,Connecticut,0,1,1,0.0
All Games,2009,Duke,5,7,12,0.4166666666666667
at Home,2009,Duke,2,4,6,0.3333333333333333
on Road/Neutral Site,2009,Duke,3,3,6,0.5
vs. Conference,2009,Duke,3,5,8,0.375
vs. Non-Conference,2009,Duke,2,2,4,0.5
vs. Ranked (AP),2009,Duke,0,3,3,0.0
vs. Unranked (AP),2009,Duke,5,4,9,0.5555555555555556
vs. FBS (I-A),2009,Duke,4,6,10,0.4
vs. FCS (I-AA),2009,Duke,1,1,2,0.5
vs. FBS Winning,2009,Duke,0,4,4,0.0
vs. FBS Non-Winning,2009,Duke,4,2,6,0.6666666666666666
vs. BCS AQ,2009,Duke,3,6,9,0.3333333333333333
vs. BCS non-AQ,2009,Duke,1,0,1,1.0
vs. FBS Power 5,2009,Duke,3,6,9,0.3333333333333333
vs. FBS non-Power 5,2009,Duke,1,0,1,1.0
in August/September,2009,Duke,2,2,4,0.5
in October,2009,Duke,3,1,4,0.75
in November,2009,Duke,0,4,4,0.0
in December/January,2009,Duke,0,0,0,
All Games,2010,Duke,3,9,12,0.25
at Home,2010,Duke,2,5,7,0.2857142857142857
on Road/Neutral Site,2010,Duke,1,4,5,0.2
vs. Conference,2010,Duke,1,7,8,0.125
vs. Non-Conference,2010,Duke,2,2,4,0.5
vs. Ranked (AP),2010,Duke,0,3,3,0.0
vs. Unranked (AP),2010,Duke,3,6,9,0.3333333333333333
vs. FBS (I-A),2010,Duke,2,9,11,0.18181818181818182
vs. FCS (I-AA),2010,Duke,1,0,1,1.0
vs. FBS Winning,2010,Duke,1,7,8,0.125
vs. FBS Non-Winning,2010,Duke,1,2,3,0.3333333333333333
vs. BCS AQ,2010,Duke,1,8,9,0.1111111111111111
vs. BCS non-AQ,2010,Duke,1,1,2,0.5
vs. FBS Power 5,2010,Duke,1,8,9,0.1111111111111111
vs. FBS non-Power 5,2010,Duke,1,1,2,0.5
in August/September,2010,Duke,1,3,4,0.25
in October,2010,Duke,1,3,4,0.25
in November,2010,Duke,1,3,4,0.25
in December/January,2010,Duke,0,0,0,
All Games,2011,Duke,3,9,12,0.25
at Home,2011,Duke,1,6,7,0.14285714285714285
on Road/Neutral Site,2011,Duke,2,3,5,0.4
vs. Conference,2011,Duke,1,7,8,0.125
vs. Non-Conference,2011,Duke,2,2,4,0.5
vs. Ranked (AP),2011,Duke,0,3,3,0.0
vs. Unranked (AP),2011,Duke,3,6,9,0.3333333333333333
vs. FBS (I-A),2011,Duke,3,8,11,0.2727272727272727
vs. FCS (I-AA),2011,Duke,0,1,1,0.0
vs. FBS Winning,2011,Duke,1,6,7,0.14285714285714285
vs. FBS Non-Winning,2011,Duke,2,2,4,0.5
vs. BCS AQ,2011,Duke,1,8,9,0.1111111111111111
vs. BCS non-AQ,2011,Duke,2,0,2,1.0
vs. FBS Power 5,2011,Duke,1,8,9,0.1111111111111111
vs. FBS non-Power 5,2011,Duke,2,0,2,1.0
in August/September,2011,Duke,2,2,4,0.5
in October,2011,Duke,1,3,4,0.25
in November,2011,Duke,0,4,4,0.0
in December/January,2011,Duke,0,0,0,
All Games,2012,Duke,6,7,13,0.46153846153846156
at Home,2012,Duke,5,2,7,0.7142857142857143
on Road/Neutral Site,2012,Duke,1,5,6,0.16666666666666666
vs. Conference,2012,Duke,3,5,8,0.375
vs. Non-Conference,2012,Duke,3,2,5,0.6
vs. Ranked (AP),2012,Duke,0,3,3,0.0
vs. Unranked (AP),2012,Duke,6,4,10,0.6
vs. FBS (I-A),2012,Duke,5,7,12,0.4166666666666667
vs. FCS (I-AA),2012,Duke,1,0,1,1.0
vs. FBS Winning,2012,Duke,1,6,7,0.14285714285714285
vs. FBS Non-Winning,2012,Duke,4,1,5,0.8
vs. BCS AQ,2012,Duke,3,7,10,0.3
vs. BCS non-AQ,2012,Duke,2,0,2,1.0
vs. FBS Power 5,2012,Duke,3,6,9,0.3333333333333333
vs. FBS non-Power 5,2012,Duke,2,1,3,0.6666666666666666
in August/September,2012,Duke,4,1,5,0.8
in October,2012,Duke,2,2,4,0.5
in November,2012,Duke,0,3,3,0.0
in December/January,2012,Duke,0,1,1,0.0
All Games,2013,Duke,10,4,14,0.7142857142857143
at Home,2013,Duke,5,2,7,0.7142857142857143
on Road/Neutral Site,2013,Duke,5,2,7,0.7142857142857143
vs. Conference,2013,Duke,6,3,9,0.6666666666666666
vs. Non-Conference,2013,Duke,4,1,5,0.8
vs. Ranked (AP),2013,Duke,0,2,2,0.0
vs. Unranked (AP),2013,Duke,10,2,12,0.8333333333333334
vs. FBS (I-A),2013,Duke,9,4,13,0.6923076923076923
vs. FCS (I-AA),2013,Duke,1,0,1,1.0
vs. FBS Winning,2013,Duke,4,4,8,0.5
vs. FBS Non-Winning,2013,Duke,5,0,5,1.0
vs. BCS AQ,2013,Duke,7,4,11,0.6363636363636364
vs. BCS non-AQ,2013,Duke,2,0,2,1.0
vs. FBS Power 5,2013,Duke,6,4,10,0.6
vs. FBS non-Power 5,2013,Duke,3,0,3,1.0
in August/September,2013,Duke,3,2,5,0.6
in October,2013,Duke,3,0,3,1.0
in November,2013,Duke,4,0,4,1.0
in December/January,2013,Duke,0,2,2,0.0
All Games,2014,Duke,9,4,13,0.6923076923076923
at Home,2014,Duke,5,2,7,0.7142857142857143
on Road/Neutral Site,2014,Duke,4,2,6,0.6666666666666666
vs. Conference,2014,Duke,5,3,8,0.625
vs. Non-Conference,2014,Duke,4,1,5,0.8
vs. Ranked (AP),2014,Duke,1,1,2,0.5
vs. Unranked (AP),2014,Duke,8,3,11,0.7272727272727273
vs. FBS (I-A),2014,Duke,8,4,12,0.6666666666666666
vs. FCS (I-AA),2014,Duke,1,0,1,1.0
vs. FBS Winning,2014,Duke,1,2,3,0.3333333333333333
vs. FBS Non-Winning,2014,Duke,7,2,9,0.7777777777777778
vs. BCS AQ,2014,Duke,7,4,11,0.6363636363636364
vs. BCS non-AQ,2014,Duke,1,0,1,1.0
vs. FBS Power 5,2014,Duke,6,4,10,0.6
vs. FBS non-Power 5,2014,Duke,2,0,2,1.0
in August/September,2014,Duke,4,1,5,0.8
in October,2014,Duke,2,0,2,1.0
in November,2014,Duke,3,2,5,0.6
in December/January,2014,Duke,0,1,1,0.0
All Games,2015,Duke,8,5,13,0.6153846153846154
at Home,2015,Duke,3,3,6,0.5
on Road/Neutral Site,2015,Duke,5,2,7,0.7142857142857143
vs. Conference,2015,Duke,4,4,8,0.5
vs. Non-Conference,2015,Duke,4,1,5,0.8
vs. Ranked (AP),2015,Duke,0,2,2,0.0
vs. Unranked (AP),2015,Duke,8,3,11,0.7272727272727273
vs. FBS (I-A),2015,Duke,7,5,12,0.5833333333333334
vs. FCS (I-AA),2015,Duke,1,0,1,1.0
vs. FBS Winning,2015,Duke,1,4,5,0.2
vs. FBS Non-Winning,2015,Duke,6,1,7,0.8571428571428571
vs. BCS AQ,2015,Duke,6,5,11,0.5454545454545454
vs. BCS non-AQ,2015,Duke,1,0,1,1.0
vs. FBS Power 5,2015,Duke,5,5,10,0.5
vs. FBS non-Power 5,2015,Duke,2,0,2,1.0
in August/September,2015,Duke,3,1,4,0.75
in October,2015,Duke,3,1,4,0.75
in November,2015,Duke,1,3,4,0.25
in December/January,2015,Duke,1,0,1,1.0
All Games,2016,Duke,4,8,12,0.3333333333333333
at Home,2016,Duke,3,3,6,0.5
on Road/Neutral Site,2016,Duke,1,5,6,0.16666666666666666
vs. Conference,2016,Duke,1,7,8,0.125
vs. Non-Conference,2016,Duke,3,1,4,0.75
vs. Ranked (AP),2016,Duke,0,3,3,0.0
vs. Unranked (AP),2016,Duke,4,5,9,0.4444444444444444
vs. FBS (I-A),2016,Duke,3,8,11,0.2727272727272727
vs. FCS (I-AA),2016,Duke,1,0,1,1.0
vs. FBS Winning,2016,Duke,2,7,9,0.2222222222222222
vs. FBS Non-Winning,2016,Duke,1,1,2,0.5
vs. BCS AQ,2016,Duke,2,8,10,0.2
vs. BCS non-AQ,2016,Duke,1,0,1,1.0
vs. FBS Power 5,2016,Duke,1,8,9,0.1111111111111111
vs. FBS non-Power 5,2016,Duke,2,0,2,1.0
in August/September,2016,Duke,2,2,4,0.5
in October,2016,Duke,1,3,4,0.25
in November,2016,Duke,1,3,4,0.25
in December/January,2016,Duke,0,0,0,
All Games,2017,Duke,7,6,13,0.5384615384615384
at Home,2017,Duke,4,3,7,0.5714285714285714
on Road/Neutral Site,2017,Duke,3,3,6,0.5
vs. Conference,2017,Duke,3,5,8,0.375
vs. Non-Conference,2017,Duke,4,1,5,0.8
vs. Ranked (AP),2017,Duke,1,2,3,0.3333333333333333
vs. Unranked (AP),2017,Duke,6,4,10,0.6
vs. FBS (I-A),2017,Duke,6,6,12,0.5
vs. FCS (I-AA),2017,Duke,1,0,1,1.0
vs. FBS Winning,2017,Duke,3,4,7,0.42857142857142855
vs. FBS Non-Winning,2017,Duke,3,2,5,0.6
vs. BCS AQ,2017,Duke,5,5,10,0.5
vs. BCS non-AQ,2017,Duke,1,1,2,0.5
vs. FBS Power 5,2017,Duke,5,5,10,0.5
vs. FBS non-Power 5,2017,Duke,1,1,2,0.5
in August/September,2017,Duke,4,1,5,0.8
in October,2017,Duke,0,4,4,0.0
in November,2017,Duke,2,1,3,0.6666666666666666
in December/January,2017,Duke,1,0,1,1.0
All Games,2018,Duke,8,5,13,0.6153846153846154
at Home,2018,Duke,3,3,6,0.5
on Road/Neutral Site,2018,Duke,5,2,7,0.7142857142857143
vs. Conference,2018,Duke,3,5,8,0.375
vs. Non-Conference,2018,Duke,5,0,5,1.0
vs. Ranked (AP),2018,Duke,2,1,3,0.6666666666666666
vs. Unranked (AP),2018,Duke,6,4,10,0.6
vs. FBS (I-A),2018,Duke,7,5,12,0.5833333333333334
vs. FCS (I-AA),2018,Duke,1,0,1,1.0
vs. FBS Winning,2018,Duke,6,3,9,0.6666666666666666
vs. FBS Non-Winning,2018,Duke,1,2,3,0.3333333333333333
vs. BCS AQ,2018,Duke,6,5,11,0.5454545454545454
vs. BCS non-AQ,2018,Duke,1,0,1,1.0
vs. FBS Power 5,2018,Duke,5,5,10,0.5
vs. FBS non-Power 5,2018,Duke,2,0,2,1.0
in August/September,2018,Duke,4,1,5,0.8
in October,2018,Duke,1,2,3,0.3333333333333333
in November,2018,Duke,2,2,4,0.5
in December/January,2018,Duke,1,0,1,1.0
All Games,2019,Duke,5,7,12,0.4166666666666667
at Home,2019,Duke,3,3,6,0.5
on Road/Neutral Site,2019,Duke,2,4,6,0.3333333333333333
vs. Conference,2019,Duke,3,5,8,0.375
vs. Non-Conference,2019,Duke,2,2,4,0.5
vs. Ranked (AP),2019,Duke,0,2,2,0.0
vs. Unranked (AP),2019,Duke,5,5,10,0.5
vs. FBS (I-A),2019,Duke,4,7,11,0.36363636363636365
vs. FCS (I-AA),2019,Duke,1,0,1,1.0
vs. FBS Winning,2019,Duke,1,6,7,0.14285714285714285
vs. FBS Non-Winning,2019,Duke,3,1,4,0.75
vs. BCS AQ,2019,Duke,3,7,10,0.3
vs. BCS non-AQ,2019,Duke,1,0,1,1.0
vs. FBS Power 5,2019,Duke,3,6,9,0.3333333333333333
vs. FBS non-Power 5,2019,Duke,1,1,2,0.5
in August/September,2019,Duke,3,1,4,0.75
in October,2019,Duke,1,3,4,0.25
in November,2019,Duke,1,3,4,0.25
in December/January,2019,Duke,0,0,0,
All Games,2020,Duke,2,9,11,0.18181818181818182
at Home,2020,Duke,1,4,5,0.2
on Road/Neutral Site,2020,Duke,1,5,6,0.16666666666666666
vs. Conference,2020,Duke,1,9,10,0.1
vs. Non-Conference,2020,Duke,1,0,1,1.0
vs. Ranked (AP),2020,Duke,0,4,4,0.0
vs. Unranked (AP),2020,Duke,2,5,7,0.2857142857142857
vs. FBS (I-A),2020,Duke,2,9,11,0.18181818181818182
vs. FCS (I-AA),2020,Duke,0,0,0,
vs. FBS Winning,2020,Duke,0,5,5,0.0
vs. FBS Non-Winning,2020,Duke,2,4,6,0.3333333333333333
vs. BCS AQ,2020,Duke,1,9,10,0.1
vs. BCS non-AQ,2020,Duke,1,0,1,1.0
vs. FBS Power 5,2020,Duke,1,9,10,0.1
vs. FBS non-Power 5,2020,Duke,1,0,1,1.0
in August/September,2020,Duke,0,3,3,0.0
in October,2020,Duke,2,2,4,0.5
in November,2020,Duke,0,2,2,0.0
in December/January,2020,Duke,0,2,2,0.0
All Games,2021,Duke,3,9,12,0.25
at Home,2021,Duke,3,4,7,0.42857142857142855
on Road/Neutral Site,2021,Duke,0,5,5,0.0
vs. Conference,2021,Duke,0,8,8,0.0
vs. Non-Conference,2021,Duke,3,1,4,0.75
vs. Ranked (AP),2021,Duke,0,2,2,0.0
vs. Unranked (AP),2021,Duke,3,7,10,0.3
vs. FBS (I-A),2021,Duke,2,9,11,0.18181818181818182
vs. FCS (I-AA),2021,Duke,1,0,1,1.0
vs. FBS Winning,2021,Duke,0,3,3,0.0
vs. FBS Non-Winning,2021,Duke,2,6,8,0.25
vs. BCS AQ,2021,Duke,2,8,10,0.2
vs. BCS non-AQ,2021,Duke,0,1,1,0.0
vs. FBS Power 5,2021,Duke,2,8,10,0.2
vs. FBS non-Power 5,2021,Duke,0,1,1,0.0
in August/September,2021,Duke,3,1,4,0.75
in October,2021,Duke,0,4,4,0.0
in November,2021,Duke,0,4,4,0.0
in December/January,2021,Duke,0,0,0,
All Games,2022,Duke,9,4,13,0.6923076923076923
at Home,2022,Duke,5,1,6,0.8333333333333334
on Road/Neutral Site,2022,Duke,4,3,7,0.5714285714285714
vs. Conference,2022,Duke,5,3,8,0.625
vs. Non-Conference,2022,Duke,4,1,5,0.8
vs. Ranked (AP),2022,Duke,0,1,1,0.0
vs. Unranked (AP),2022,Duke,9,3,12,0.75
vs. FBS (I-A),2022,Duke,8,4,12,0.6666666666666666
vs. FCS (I-AA),2022,Duke,1,0,1,1.0
vs. FBS Winning,2022,Duke,2,2,4,0.5
vs. FBS Non-Winning,2022,Duke,6,2,8,0.75
vs. BCS AQ,2022,Duke,8,4,12,0.6666666666666666
vs. BCS non-AQ,2022,Duke,0,0,0,
vs. FBS Power 5,2022,Duke,6,4,10,0.6
vs. FBS non-Power 5,2022,Duke,2,0,2,1.0
in August/September,2022,Duke,3,1,4,0.75
in October,2022,Duke,2,2,4,0.5
in November,2022,Duke,3,1,4,0.75
in December/January,2022,Duke,1,0,1,1.0
All Games,2009,East Carolina,9,5,14,0.6428571428571429
at Home,2009,East Carolina,6,1,7,0.8571428571428571
on Road/Neutral Site,2009,East Carolina,3,4,7,0.42857142857142855
vs. Conference,2009,East Carolina,8,1,9,0.8888888888888888
vs. Non-Conference,2009,East Carolina,1,4,5,0.2
vs. Ranked (AP),2009,East Carolina,0,2,2,0.0
vs. Unranked (AP),2009,East Carolina,9,3,12,0.75
vs. FBS (I-A),2009,East Carolina,8,5,13,0.6153846153846154
vs. FCS (I-AA),2009,East Carolina,1,0,1,1.0
vs. FBS Winning,2009,East Carolina,4,5,9,0.4444444444444444
vs. FBS Non-Winning,2009,East Carolina,4,0,4,1.0
vs. BCS AQ,2009,East Carolina,0,4,4,0.0
vs. BCS non-AQ,2009,East Carolina,8,1,9,0.8888888888888888
vs. FBS Power 5,2009,East Carolina,0,3,3,0.0
vs. FBS non-Power 5,2009,East Carolina,8,2,10,0.8
in August/September,2009,East Carolina,2,2,4,0.5
in October,2009,East Carolina,3,1,4,0.75
in November,2009,East Carolina,3,1,4,0.75
in December/January,2009,East Carolina,1,1,2,0.5
All Games,2010,East Carolina,6,7,13,0.46153846153846156
at Home,2010,East Carolina,4,2,6,0.6666666666666666
on Road/Neutral Site,2010,East Carolina,2,5,7,0.2857142857142857
vs. Conference,2010,East Carolina,5,3,8,0.625
vs. Non-Conference,2010,East Carolina,1,4,5,0.2
vs. Ranked (AP),2010,East Carolina,2,3,5,0.4
vs. Unranked (AP),2010,East Carolina,4,4,8,0.5
vs. FBS (I-A),2010,East Carolina,6,7,13,0.46153846153846156
vs. FCS (I-AA),2010,East Carolina,0,0,0,
vs. FBS Winning,2010,East Carolina,3,5,8,0.375
vs. FBS Non-Winning,2010,East Carolina,3,2,5,0.6
vs. BCS AQ,2010,East Carolina,1,3,4,0.25
vs. BCS non-AQ,2010,East Carolina,5,4,9,0.5555555555555556
vs. FBS Power 5,2010,East Carolina,1,3,4,0.25
vs. FBS non-Power 5,2010,East Carolina,5,4,9,0.5555555555555556
in August/September,2010,East Carolina,2,1,3,0.6666666666666666
in October,2010,East Carolina,3,2,5,0.6
in November,2010,East Carolina,1,3,4,0.25
in December/January,2010,East Carolina,0,1,1,0.0
All Games,2011,East Carolina,5,7,12,0.4166666666666667
at Home,2011,East Carolina,3,3,6,0.5
on Road/Neutral Site,2011,East Carolina,2,4,6,0.3333333333333333
vs. Conference,2011,East Carolina,4,4,8,0.5
vs. Non-Conference,2011,East Carolina,1,3,4,0.25
vs. Ranked (AP),2011,East Carolina,0,4,4,0.0
vs. Unranked (AP),2011,East Carolina,5,3,8,0.625
vs. FBS (I-A),2011,East Carolina,5,7,12,0.4166666666666667
vs. FCS (I-AA),2011,East Carolina,0,0,0,
vs. FBS Winning,2011,East Carolina,0,6,6,0.0
vs. FBS Non-Winning,2011,East Carolina,5,1,6,0.8333333333333334
vs. BCS AQ,2011,East Carolina,0,3,3,0.0
vs. BCS non-AQ,2011,East Carolina,5,4,9,0.5555555555555556
vs. FBS Power 5,2011,East Carolina,0,3,3,0.0
vs. FBS non-Power 5,2011,East Carolina,5,4,9,0.5555555555555556
in August/September,2011,East Carolina,1,2,3,0.3333333333333333
in October,2011,East Carolina,3,2,5,0.6
in November,2011,East Carolina,1,3,4,0.25
in December/January,2011,East Carolina,0,0,0,
All Games,2012,East Carolina,8,5,13,0.6153846153846154
at Home,2012,East Carolina,5,1,6,0.8333333333333334
on Road/Neutral Site,2012,East Carolina,3,4,7,0.42857142857142855
vs. Conference,2012,East Carolina,7,1,8,0.875
vs. Non-Conference,2012,East Carolina,1,4,5,0.2
vs. Ranked (AP),2012,East Carolina,0,1,1,0.0
vs. Unranked (AP),2012,East Carolina,8,4,12,0.6666666666666666
vs. FBS (I-A),2012,East Carolina,7,5,12,0.5833333333333334
vs. FCS (I-AA),2012,East Carolina,1,0,1,1.0
vs. FBS Winning,2012,East Carolina,0,5,5,0.0
vs. FBS Non-Winning,2012,East Carolina,7,0,7,1.0
vs. BCS AQ,2012,East Carolina,0,2,2,0.0
vs. BCS non-AQ,2012,East Carolina,7,3,10,0.7
vs. FBS Power 5,2012,East Carolina,0,2,2,0.0
vs. FBS non-Power 5,2012,East Carolina,7,3,10,0.7
in August/September,2012,East Carolina,3,2,5,0.6
in October,2012,East Carolina,2,2,4,0.5
in November,2012,East Carolina,3,0,3,1.0
in December/January,2012,East Carolina,0,1,1,0.0
All Games,2013,East Carolina,10,3,13,0.7692307692307693
at Home,2013,East Carolina,5,1,6,0.8333333333333334
on Road/Neutral Site,2013,East Carolina,5,2,7,0.7142857142857143
vs. Conference,2013,East Carolina,6,2,8,0.75
vs. Non-Conference,2013,East Carolina,4,1,5,0.8
vs. Ranked (AP),2013,East Carolina,0,0,0,
vs. Unranked (AP),2013,East Carolina,10,3,13,0.7692307692307693
vs. FBS (I-A),2013,East Carolina,9,3,12,0.75
vs. FCS (I-AA),2013,East Carolina,1,0,1,1.0
vs. FBS Winning,2013,East Carolina,3,3,6,0.5
vs. FBS Non-Winning,2013,East Carolina,6,0,6,1.0
vs. BCS AQ,2013,East Carolina,2,1,3,0.6666666666666666
vs. BCS non-AQ,2013,East Carolina,7,2,9,0.7777777777777778
vs. FBS Power 5,2013,East Carolina,2,1,3,0.6666666666666666
vs. FBS non-Power 5,2013,East Carolina,7,2,9,0.7777777777777778
in August/September,2013,East Carolina,3,1,4,0.75
in October,2013,East Carolina,2,1,3,0.6666666666666666
in November,2013,East Carolina,4,1,5,0.8
in December/January,2013,East Carolina,1,0,1,1.0
All Games,2014,East Carolina,8,5,13,0.6153846153846154
at Home,2014,East Carolina,5,1,6,0.8333333333333334
on Road/Neutral Site,2014,East Carolina,3,4,7,0.42857142857142855
vs. Conference,2014,East Carolina,5,3,8,0.625
vs. Non-Conference,2014,East Carolina,3,2,5,0.6
vs. Ranked (AP),2014,East Carolina,0,0,0,
vs. Unranked (AP),2014,East Carolina,8,5,13,0.6153846153846154
vs. FBS (I-A),2014,East Carolina,7,5,12,0.5833333333333334
vs. FCS (I-AA),2014,East Carolina,1,0,1,1.0
vs. FBS Winning,2014,East Carolina,1,4,5,0.2
vs. FBS Non-Winning,2014,East Carolina,6,1,7,0.8571428571428571
vs. BCS AQ,2014,East Carolina,7,5,12,0.5833333333333334
vs. BCS non-AQ,2014,East Carolina,0,0,0,
vs. FBS Power 5,2014,East Carolina,2,2,4,0.5
vs. FBS non-Power 5,2014,East Carolina,5,3,8,0.625
in August/September,2014,East Carolina,3,1,4,0.75
in October,2014,East Carolina,3,0,3,1.0
in November,2014,East Carolina,2,2,4,0.5
in December/January,2014,East Carolina,0,2,2,0.0
All Games,2015,East Carolina,5,7,12,0.4166666666666667
at Home,2015,East Carolina,3,3,6,0.5
on Road/Neutral Site,2015,East Carolina,2,4,6,0.3333333333333333
vs. Conference,2015,East Carolina,3,5,8,0.375
vs. Non-Conference,2015,East Carolina,2,2,4,0.5
vs. Ranked (AP),2015,East Carolina,0,2,2,0.0
vs. Unranked (AP),2015,East Carolina,5,5,10,0.5
vs. FBS (I-A),2015,East Carolina,4,7,11,0.36363636363636365
vs. FCS (I-AA),2015,East Carolina,1,0,1,1.0
vs. FBS Winning,2015,East Carolina,1,6,7,0.14285714285714285
vs. FBS Non-Winning,2015,East Carolina,3,1,4,0.75
vs. BCS AQ,2015,East Carolina,4,6,10,0.4
vs. BCS non-AQ,2015,East Carolina,0,1,1,0.0
vs. FBS Power 5,2015,East Carolina,1,1,2,0.5
vs. FBS non-Power 5,2015,East Carolina,3,6,9,0.3333333333333333
in August/September,2015,East Carolina,2,2,4,0.5
in October,2015,East Carolina,2,3,5,0.4
in November,2015,East Carolina,1,2,3,0.3333333333333333
in December/January,2015,East Carolina,0,0,0,
All Games,2016,East Carolina,3,9,12,0.25
at Home,2016,East Carolina,3,3,6,0.5
on Road/Neutral Site,2016,East Carolina,0,6,6,0.0
vs. Conference,2016,East Carolina,1,7,8,0.125
vs. Non-Conference,2016,East Carolina,2,2,4,0.5
vs. Ranked (AP),2016,East Carolina,0,3,3,0.0
vs. Unranked (AP),2016,East Carolina,3,6,9,0.3333333333333333
vs. FBS (I-A),2016,East Carolina,2,9,11,0.18181818181818182
vs. FCS (I-AA),2016,East Carolina,1,0,1,1.0
vs. FBS Winning,2016,East Carolina,1,5,6,0.16666666666666666
vs. FBS Non-Winning,2016,East Carolina,1,4,5,0.2
vs. BCS AQ,2016,East Carolina,2,9,11,0.18181818181818182
vs. BCS non-AQ,2016,East Carolina,0,0,0,
vs. FBS Power 5,2016,East Carolina,1,2,3,0.3333333333333333
vs. FBS non-Power 5,2016,East Carolina,1,7,8,0.125
in August/September,2016,East Carolina,2,2,4,0.5
in October,2016,East Carolina,1,3,4,0.25
in November,2016,East Carolina,0,4,4,0.0
in December/January,2016,East Carolina,0,0,0,
All Games,2017,East Carolina,3,9,12,0.25
at Home,2017,East Carolina,2,5,7,0.2857142857142857
on Road/Neutral Site,2017,East Carolina,1,4,5,0.2
vs. Conference,2017,East Carolina,2,6,8,0.25
vs. Non-Conference,2017,East Carolina,1,3,4,0.25
vs. Ranked (AP),2017,East Carolina,0,4,4,0.0
vs. Unranked (AP),2017,East Carolina,3,5,8,0.375
vs. FBS (I-A),2017,East Carolina,3,8,11,0.2727272727272727
vs. FCS (I-AA),2017,East Carolina,0,1,1,0.0
vs. FBS Winning,2017,East Carolina,0,7,7,0.0
vs. FBS Non-Winning,2017,East Carolina,3,1,4,0.75
vs. BCS AQ,2017,East Carolina,2,8,10,0.2
vs. BCS non-AQ,2017,East Carolina,1,0,1,1.0
vs. FBS Power 5,2017,East Carolina,0,2,2,0.0
vs. FBS non-Power 5,2017,East Carolina,3,6,9,0.3333333333333333
in August/September,2017,East Carolina,1,4,5,0.2
in October,2017,East Carolina,1,2,3,0.3333333333333333
in November,2017,East Carolina,1,3,4,0.25
in December/January,2017,East Carolina,0,0,0,
All Games,2018,East Carolina,3,9,12,0.25
at Home,2018,East Carolina,3,4,7,0.42857142857142855
on Road/Neutral Site,2018,East Carolina,0,5,5,0.0
vs. Conference,2018,East Carolina,1,7,8,0.125
vs. Non-Conference,2018,East Carolina,2,2,4,0.5
vs. Ranked (AP),2018,East Carolina,0,2,2,0.0
vs. Unranked (AP),2018,East Carolina,3,7,10,0.3
vs. FBS (I-A),2018,East Carolina,3,8,11,0.2727272727272727
vs. FCS (I-AA),2018,East Carolina,0,1,1,0.0
vs. FBS Winning,2018,East Carolina,0,8,8,0.0
vs. FBS Non-Winning,2018,East Carolina,3,0,3,1.0
vs. BCS AQ,2018,East Carolina,2,8,10,0.2
vs. BCS non-AQ,2018,East Carolina,1,0,1,1.0
vs. FBS Power 5,2018,East Carolina,1,1,2,0.5
vs. FBS non-Power 5,2018,East Carolina,2,7,9,0.2222222222222222
in August/September,2018,East Carolina,2,2,4,0.5
in October,2018,East Carolina,0,3,3,0.0
in November,2018,East Carolina,1,3,4,0.25
in December/January,2018,East Carolina,0,1,1,0.0
All Games,2019,East Carolina,4,8,12,0.3333333333333333
at Home,2019,East Carolina,2,4,6,0.3333333333333333
on Road/Neutral Site,2019,East Carolina,2,4,6,0.3333333333333333
vs. Conference,2019,East Carolina,1,7,8,0.125
vs. Non-Conference,2019,East Carolina,3,1,4,0.75
vs. Ranked (AP),2019,East Carolina,0,3,3,0.0
vs. Unranked (AP),2019,East Carolina,4,5,9,0.4444444444444444
vs. FBS (I-A),2019,East Carolina,2,8,10,0.2
vs. FCS (I-AA),2019,East Carolina,2,0,2,1.0
vs. FBS Winning,2019,East Carolina,0,5,5,0.0
vs. FBS Non-Winning,2019,East Carolina,2,3,5,0.4
vs. BCS AQ,2019,East Carolina,1,8,9,0.1111111111111111
vs. BCS non-AQ,2019,East Carolina,1,0,1,1.0
vs. FBS Power 5,2019,East Carolina,0,1,1,0.0
vs. FBS non-Power 5,2019,East Carolina,2,7,9,0.2222222222222222
in August/September,2019,East Carolina,3,2,5,0.6
in October,2019,East Carolina,0,3,3,0.0
in November,2019,East Carolina,1,3,4,0.25
in December/January,2019,East Carolina,0,0,0,
All Games,2020,East Carolina,3,6,9,0.3333333333333333
at Home,2020,East Carolina,1,3,4,0.25
on Road/Neutral Site,2020,East Carolina,2,3,5,0.4
vs. Conference,2020,East Carolina,3,5,8,0.375
vs. Non-Conference,2020,East Carolina,0,1,1,0.0
vs. Ranked (AP),2020,East Carolina,0,2,2,0.0
vs. Unranked (AP),2020,East Carolina,3,4,7,0.42857142857142855
vs. FBS (I-A),2020,East Carolina,3,6,9,0.3333333333333333
vs. FCS (I-AA),2020,East Carolina,0,0,0,
vs. FBS Winning,2020,East Carolina,1,4,5,0.2
vs. FBS Non-Winning,2020,East Carolina,2,2,4,0.5
vs. BCS AQ,2020,East Carolina,3,5,8,0.375
vs. BCS non-AQ,2020,East Carolina,0,1,1,0.0
vs. FBS Power 5,2020,East Carolina,0,0,0,
vs. FBS non-Power 5,2020,East Carolina,3,6,9,0.3333333333333333
in August/September,2020,East Carolina,0,1,1,0.0
in October,2020,East Carolina,1,3,4,0.25
in November,2020,East Carolina,2,2,4,0.5
in December/January,2020,East Carolina,0,0,0,
All Games,2021,East Carolina,7,5,12,0.5833333333333334
at Home,2021,East Carolina,4,2,6,0.6666666666666666
on Road/Neutral Site,2021,East Carolina,3,3,6,0.5
vs. Conference,2021,East Carolina,5,3,8,0.625
vs. Non-Conference,2021,East Carolina,2,2,4,0.5
vs. Ranked (AP),2021,East Carolina,0,2,2,0.0
vs. Unranked (AP),2021,East Carolina,7,3,10,0.7
vs. FBS (I-A),2021,East Carolina,6,5,11,0.5454545454545454
vs. FCS (I-AA),2021,East Carolina,1,0,1,1.0
vs. FBS Winning,2021,East Carolina,1,5,6,0.16666666666666666
vs. FBS Non-Winning,2021,East Carolina,5,0,5,1.0
vs. BCS AQ,2021,East Carolina,5,4,9,0.5555555555555556
vs. BCS non-AQ,2021,East Carolina,1,1,2,0.5
vs. FBS Power 5,2021,East Carolina,0,1,1,0.0
vs. FBS non-Power 5,2021,East Carolina,6,4,10,0.6
in August/September,2021,East Carolina,2,2,4,0.5
in October,2021,East Carolina,2,2,4,0.5
in November,2021,East Carolina,3,1,4,0.75
in December/January,2021,East Carolina,0,0,0,
All Games,2022,East Carolina,8,5,13,0.6153846153846154
at Home,2022,East Carolina,4,3,7,0.5714285714285714
on Road/Neutral Site,2022,East Carolina,4,2,6,0.6666666666666666
vs. Conference,2022,East Carolina,4,4,8,0.5
vs. Non-Conference,2022,East Carolina,4,1,5,0.8
vs. Ranked (AP),2022,East Carolina,0,1,1,0.0
vs. Unranked (AP),2022,East Carolina,8,4,12,0.6666666666666666
vs. FBS (I-A),2022,East Carolina,7,5,12,0.5833333333333334
vs. FCS (I-AA),2022,East Carolina,1,0,1,1.0
vs. FBS Winning,2022,East Carolina,4,4,8,0.5
vs. FBS Non-Winning,2022,East Carolina,3,1,4,0.75
vs. BCS AQ,2022,East Carolina,4,5,9,0.4444444444444444
vs. BCS non-AQ,2022,East Carolina,3,0,3,1.0
vs. FBS Power 5,2022,East Carolina,0,1,1,0.0
vs. FBS non-Power 5,2022,East Carolina,7,4,11,0.6363636363636364
in August/September,2022,East Carolina,2,2,4,0.5
in October,2022,East Carolina,4,1,5,0.8
in November,2022,East Carolina,1,2,3,0.3333333333333333
in December/January,2022,East Carolina,1,0,1,1.0
All Games,2009,Eastern Michigan,0,12,12,0.0
at Home,2009,Eastern Michigan,0,5,5,0.0
on Road/Neutral Site,2009,Eastern Michigan,0,7,7,0.0
vs. Conference,2009,Eastern Michigan,0,8,8,0.0
vs. Non-Conference,2009,Eastern Michigan,0,4,4,0.0
vs. Ranked (AP),2009,Eastern Michigan,0,1,1,0.0
vs. Unranked (AP),2009,Eastern Michigan,0,11,11,0.0
vs. FBS (I-A),2009,Eastern Michigan,0,12,12,0.0
vs. FCS (I-AA),2009,Eastern Michigan,0,0,0,
vs. FBS Winning,2009,Eastern Michigan,0,5,5,0.0
vs. FBS Non-Winning,2009,Eastern Michigan,0,7,7,0.0
vs. BCS AQ,2009,Eastern Michigan,0,3,3,0.0
vs. BCS non-AQ,2009,Eastern Michigan,0,9,9,0.0
vs. FBS Power 5,2009,Eastern Michigan,0,3,3,0.0
vs. FBS non-Power 5,2009,Eastern Michigan,0,9,9,0.0
in August/September,2009,Eastern Michigan,0,3,3,0.0
in October,2009,Eastern Michigan,0,5,5,0.0
in November,2009,Eastern Michigan,0,4,4,0.0
in December/January,2009,Eastern Michigan,0,0,0,
All Games,2010,Eastern Michigan,2,10,12,0.16666666666666666
at Home,2010,Eastern Michigan,0,5,5,0.0
on Road/Neutral Site,2010,Eastern Michigan,2,5,7,0.2857142857142857
vs. Conference,2010,Eastern Michigan,2,6,8,0.25
vs. Non-Conference,2010,Eastern Michigan,0,4,4,0.0
vs. Ranked (AP),2010,Eastern Michigan,0,1,1,0.0
vs. Unranked (AP),2010,Eastern Michigan,2,9,11,0.18181818181818182
vs. FBS (I-A),2010,Eastern Michigan,2,10,12,0.16666666666666666
vs. FCS (I-AA),2010,Eastern Michigan,0,0,0,
vs. FBS Winning,2010,Eastern Michigan,0,6,6,0.0
vs. FBS Non-Winning,2010,Eastern Michigan,2,4,6,0.3333333333333333
vs. BCS AQ,2010,Eastern Michigan,0,3,3,0.0
vs. BCS non-AQ,2010,Eastern Michigan,2,7,9,0.2222222222222222
vs. FBS Power 5,2010,Eastern Michigan,0,3,3,0.0
vs. FBS non-Power 5,2010,Eastern Michigan,2,7,9,0.2222222222222222
in August/September,2010,Eastern Michigan,0,4,4,0.0
in October,2010,Eastern Michigan,1,4,5,0.2
in November,2010,Eastern Michigan,1,2,3,0.3333333333333333
in December/January,2010,Eastern Michigan,0,0,0,
All Games,2011,Eastern Michigan,6,6,12,0.5
at Home,2011,Eastern Michigan,5,1,6,0.8333333333333334
on Road/Neutral Site,2011,Eastern Michigan,1,5,6,0.16666666666666666
vs. Conference,2011,Eastern Michigan,4,4,8,0.5
vs. Non-Conference,2011,Eastern Michigan,2,2,4,0.5
vs. Ranked (AP),2011,Eastern Michigan,0,1,1,0.0
vs. Unranked (AP),2011,Eastern Michigan,6,5,11,0.5454545454545454
vs. FBS (I-A),2011,Eastern Michigan,4,6,10,0.4
vs. FCS (I-AA),2011,Eastern Michigan,2,0,2,1.0
vs. FBS Winning,2011,Eastern Michigan,1,4,5,0.2
vs. FBS Non-Winning,2011,Eastern Michigan,3,2,5,0.6
vs. BCS AQ,2011,Eastern Michigan,0,2,2,0.0
vs. BCS non-AQ,2011,Eastern Michigan,4,4,8,0.5
vs. FBS Power 5,2011,Eastern Michigan,0,2,2,0.0
vs. FBS non-Power 5,2011,Eastern Michigan,4,4,8,0.5
in August/September,2011,Eastern Michigan,2,2,4,0.5
in October,2011,Eastern Michigan,3,1,4,0.75
in November,2011,Eastern Michigan,1,3,4,0.25
in December/January,2011,Eastern Michigan,0,0,0,
All Games,2012,Eastern Michigan,2,10,12,0.16666666666666666
at Home,2012,Eastern Michigan,1,5,6,0.16666666666666666
on Road/Neutral Site,2012,Eastern Michigan,1,5,6,0.16666666666666666
vs. Conference,2012,Eastern Michigan,1,7,8,0.125
vs. Non-Conference,2012,Eastern Michigan,1,3,4,0.25
vs. Ranked (AP),2012,Eastern Michigan,0,1,1,0.0
vs. Unranked (AP),2012,Eastern Michigan,2,9,11,0.18181818181818182
vs. FBS (I-A),2012,Eastern Michigan,2,9,11,0.18181818181818182
vs. FCS (I-AA),2012,Eastern Michigan,0,1,1,0.0
vs. FBS Winning,2012,Eastern Michigan,0,8,8,0.0
vs. FBS Non-Winning,2012,Eastern Michigan,2,1,3,0.6666666666666666
vs. BCS AQ,2012,Eastern Michigan,0,2,2,0.0
vs. BCS non-AQ,2012,Eastern Michigan,2,7,9,0.2222222222222222
vs. FBS Power 5,2012,Eastern Michigan,0,2,2,0.0
vs. FBS non-Power 5,2012,Eastern Michigan,2,7,9,0.2222222222222222
in August/September,2012,Eastern Michigan,0,4,4,0.0
in October,2012,Eastern Michigan,1,3,4,0.25
in November,2012,Eastern Michigan,1,3,4,0.25
in December/January,2012,Eastern Michigan,0,0,0,
All Games,2013,Eastern Michigan,2,10,12,0.16666666666666666
at Home,2013,Eastern Michigan,2,3,5,0.4
on Road/Neutral Site,2013,Eastern Michigan,0,7,7,0.0
vs. Conference,2013,Eastern Michigan,1,7,8,0.125
vs. Non-Conference,2013,Eastern Michigan,1,3,4,0.25
vs. Ranked (AP),2013,Eastern Michigan,0,0,0,
vs. Unranked (AP),2013,Eastern Michigan,2,10,12,0.16666666666666666
vs. FBS (I-A),2013,Eastern Michigan,1,10,11,0.09090909090909091
vs. FCS (I-AA),2013,Eastern Michigan,1,0,1,1.0
vs. FBS Winning,2013,Eastern Michigan,0,7,7,0.0
vs. FBS Non-Winning,2013,Eastern Michigan,1,3,4,0.25
vs. BCS AQ,2013,Eastern Michigan,0,2,2,0.0
vs. BCS non-AQ,2013,Eastern Michigan,1,8,9,0.1111111111111111
vs. FBS Power 5,2013,Eastern Michigan,0,1,1,0.0
vs. FBS non-Power 5,2013,Eastern Michigan,1,9,10,0.1
in August/September,2013,Eastern Michigan,1,3,4,0.25
in October,2013,Eastern Michigan,0,4,4,0.0
in November,2013,Eastern Michigan,1,3,4,0.25
in December/January,2013,Eastern Michigan,0,0,0,
All Games,2014,Eastern Michigan,2,10,12,0.16666666666666666
at Home,2014,Eastern Michigan,2,3,5,0.4
on Road/Neutral Site,2014,Eastern Michigan,0,7,7,0.0
vs. Conference,2014,Eastern Michigan,1,7,8,0.125
vs. Non-Conference,2014,Eastern Michigan,1,3,4,0.25
vs. Ranked (AP),2014,Eastern Michigan,0,1,1,0.0
vs. Unranked (AP),2014,Eastern Michigan,2,9,11,0.18181818181818182
vs. FBS (I-A),2014,Eastern Michigan,1,10,11,0.09090909090909091
vs. FCS (I-AA),2014,Eastern Michigan,1,0,1,1.0
vs. FBS Winning,2014,Eastern Michigan,0,6,6,0.0
vs. FBS Non-Winning,2014,Eastern Michigan,1,4,5,0.2
vs. BCS AQ,2014,Eastern Michigan,0,2,2,0.0
vs. BCS non-AQ,2014,Eastern Michigan,1,8,9,0.1111111111111111
vs. FBS Power 5,2014,Eastern Michigan,0,2,2,0.0
vs. FBS non-Power 5,2014,Eastern Michigan,1,8,9,0.1111111111111111
in August/September,2014,Eastern Michigan,1,3,4,0.25
in October,2014,Eastern Michigan,1,3,4,0.25
in November,2014,Eastern Michigan,0,4,4,0.0
in December/January,2014,Eastern Michigan,0,0,0,
All Games,2015,Eastern Michigan,1,11,12,0.08333333333333333
at Home,2015,Eastern Michigan,0,6,6,0.0
on Road/Neutral Site,2015,Eastern Michigan,1,5,6,0.16666666666666666
vs. Conference,2015,Eastern Michigan,0,8,8,0.0
vs. Non-Conference,2015,Eastern Michigan,1,3,4,0.25
vs. Ranked (AP),2015,Eastern Michigan,0,1,1,0.0
vs. Unranked (AP),2015,Eastern Michigan,1,10,11,0.09090909090909091
vs. FBS (I-A),2015,Eastern Michigan,1,11,12,0.08333333333333333
vs. FCS (I-AA),2015,Eastern Michigan,0,0,0,
vs. FBS Winning,2015,Eastern Michigan,0,6,6,0.0
vs. FBS Non-Winning,2015,Eastern Michigan,1,5,6,0.16666666666666666
vs. BCS AQ,2015,Eastern Michigan,0,1,1,0.0
vs. BCS non-AQ,2015,Eastern Michigan,1,10,11,0.09090909090909091
vs. FBS Power 5,2015,Eastern Michigan,0,1,1,0.0
vs. FBS non-Power 5,2015,Eastern Michigan,1,10,11,0.09090909090909091
in August/September,2015,Eastern Michigan,1,3,4,0.25
in October,2015,Eastern Michigan,0,5,5,0.0
in November,2015,Eastern Michigan,0,3,3,0.0
in December/January,2015,Eastern Michigan,0,0,0,
All Games,2016,Eastern Michigan,7,6,13,0.5384615384615384
at Home,2016,Eastern Michigan,3,3,6,0.5
on Road/Neutral Site,2016,Eastern Michigan,4,3,7,0.5714285714285714
vs. Conference,2016,Eastern Michigan,4,4,8,0.5
vs. Non-Conference,2016,Eastern Michigan,3,2,5,0.6
vs. Ranked (AP),2016,Eastern Michigan,0,1,1,0.0
vs. Unranked (AP),2016,Eastern Michigan,7,5,12,0.5833333333333334
vs. FBS (I-A),2016,Eastern Michigan,6,6,12,0.5
vs. FCS (I-AA),2016,Eastern Michigan,1,0,1,1.0
vs. FBS Winning,2016,Eastern Michigan,2,3,5,0.4
vs. FBS Non-Winning,2016,Eastern Michigan,4,3,7,0.5714285714285714
vs. BCS AQ,2016,Eastern Michigan,0,1,1,0.0
vs. BCS non-AQ,2016,Eastern Michigan,6,5,11,0.5454545454545454
vs. FBS Power 5,2016,Eastern Michigan,0,1,1,0.0
vs. FBS non-Power 5,2016,Eastern Michigan,6,5,11,0.5454545454545454
in August/September,2016,Eastern Michigan,3,1,4,0.75
in October,2016,Eastern Michigan,2,3,5,0.4
in November,2016,Eastern Michigan,2,1,3,0.6666666666666666
in December/January,2016,Eastern Michigan,0,1,1,0.0
All Games,2017,Eastern Michigan,5,7,12,0.4166666666666667
at Home,2017,Eastern Michigan,3,2,5,0.6
on Road/Neutral Site,2017,Eastern Michigan,2,5,7,0.2857142857142857
vs. Conference,2017,Eastern Michigan,3,5,8,0.375
vs. Non-Conference,2017,Eastern Michigan,2,2,4,0.5
vs. Ranked (AP),2017,Eastern Michigan,0,0,0,
vs. Unranked (AP),2017,Eastern Michigan,5,7,12,0.4166666666666667
vs. FBS (I-A),2017,Eastern Michigan,5,7,12,0.4166666666666667
vs. FCS (I-AA),2017,Eastern Michigan,0,0,0,
vs. FBS Winning,2017,Eastern Michigan,0,6,6,0.0
vs. FBS Non-Winning,2017,Eastern Michigan,5,1,6,0.8333333333333334
vs. BCS AQ,2017,Eastern Michigan,1,1,2,0.5
vs. BCS non-AQ,2017,Eastern Michigan,4,6,10,0.4
vs. FBS Power 5,2017,Eastern Michigan,1,1,2,0.5
vs. FBS non-Power 5,2017,Eastern Michigan,4,6,10,0.4
in August/September,2017,Eastern Michigan,2,2,4,0.5
in October,2017,Eastern Michigan,0,4,4,0.0
in November,2017,Eastern Michigan,3,1,4,0.75
in December/January,2017,Eastern Michigan,0,0,0,
All Games,2018,Eastern Michigan,7,6,13,0.5384615384615384
at Home,2018,Eastern Michigan,4,2,6,0.6666666666666666
on Road/Neutral Site,2018,Eastern Michigan,3,4,7,0.42857142857142855
vs. Conference,2018,Eastern Michigan,5,3,8,0.625
vs. Non-Conference,2018,Eastern Michigan,2,3,5,0.4
vs. Ranked (AP),2018,Eastern Michigan,0,1,1,0.0
vs. Unranked (AP),2018,Eastern Michigan,7,5,12,0.5833333333333334
vs. FBS (I-A),2018,Eastern Michigan,6,6,12,0.5
vs. FCS (I-AA),2018,Eastern Michigan,1,0,1,1.0
vs. FBS Winning,2018,Eastern Michigan,1,6,7,0.14285714285714285
vs. FBS Non-Winning,2018,Eastern Michigan,5,0,5,1.0
vs. BCS AQ,2018,Eastern Michigan,1,0,1,1.0
vs. BCS non-AQ,2018,Eastern Michigan,5,6,11,0.45454545454545453
vs. FBS Power 5,2018,Eastern Michigan,1,0,1,1.0
vs. FBS non-Power 5,2018,Eastern Michigan,5,6,11,0.45454545454545453
in August/September,2018,Eastern Michigan,2,3,5,0.4
in October,2018,Eastern Michigan,2,2,4,0.5
in November,2018,Eastern Michigan,3,0,3,1.0
in December/January,2018,Eastern Michigan,0,1,1,0.0
All Games,2019,Eastern Michigan,6,7,13,0.46153846153846156
at Home,2019,Eastern Michigan,2,3,5,0.4
on Road/Neutral Site,2019,Eastern Michigan,4,4,8,0.5
vs. Conference,2019,Eastern Michigan,3,5,8,0.375
vs. Non-Conference,2019,Eastern Michigan,3,2,5,0.6
vs. Ranked (AP),2019,Eastern Michigan,0,0,0,
vs. Unranked (AP),2019,Eastern Michigan,6,7,13,0.46153846153846156
vs. FBS (I-A),2019,Eastern Michigan,5,7,12,0.4166666666666667
vs. FCS (I-AA),2019,Eastern Michigan,1,0,1,1.0
vs. FBS Winning,2019,Eastern Michigan,1,5,6,0.16666666666666666
vs. FBS Non-Winning,2019,Eastern Michigan,4,2,6,0.6666666666666666
vs. BCS AQ,2019,Eastern Michigan,1,2,3,0.3333333333333333
vs. BCS non-AQ,2019,Eastern Michigan,4,5,9,0.4444444444444444
vs. FBS Power 5,2019,Eastern Michigan,1,2,3,0.3333333333333333
vs. FBS non-Power 5,2019,Eastern Michigan,4,5,9,0.4444444444444444
in August/September,2019,Eastern Michigan,3,1,4,0.75
in October,2019,Eastern Michigan,1,3,4,0.25
in November,2019,Eastern Michigan,2,2,4,0.5
in December/January,2019,Eastern Michigan,0,1,1,0.0
All Games,2020,Eastern Michigan,2,4,6,0.3333333333333333
at Home,2020,Eastern Michigan,1,2,3,0.3333333333333333
on Road/Neutral Site,2020,Eastern Michigan,1,2,3,0.3333333333333333
vs. Conference,2020,Eastern Michigan,2,4,6,0.3333333333333333
vs. Non-Conference,2020,Eastern Michigan,0,0,0,
vs. Ranked (AP),2020,Eastern Michigan,0,0,0,
vs. Unranked (AP),2020,Eastern Michigan,2,4,6,0.3333333333333333
vs. FBS (I-A),2020,Eastern Michigan,2,4,6,0.3333333333333333
vs. FCS (I-AA),2020,Eastern Michigan,0,0,0,
vs. FBS Winning,2020,Eastern Michigan,1,3,4,0.25
vs. FBS Non-Winning,2020,Eastern Michigan,1,1,2,0.5
vs. BCS AQ,2020,Eastern Michigan,0,0,0,
vs. BCS non-AQ,2020,Eastern Michigan,2,4,6,0.3333333333333333
vs. FBS Power 5,2020,Eastern Michigan,0,0,0,
vs. FBS non-Power 5,2020,Eastern Michigan,2,4,6,0.3333333333333333
in August/September,2020,Eastern Michigan,0,0,0,
in October,2020,Eastern Michigan,0,0,0,
in November,2020,Eastern Michigan,0,4,4,0.0
in December/January,2020,Eastern Michigan,2,0,2,1.0
All Games,2021,Eastern Michigan,7,6,13,0.5384615384615384
at Home,2021,Eastern Michigan,4,2,6,0.6666666666666666
on Road/Neutral Site,2021,Eastern Michigan,3,4,7,0.42857142857142855
vs. Conference,2021,Eastern Michigan,4,4,8,0.5
vs. Non-Conference,2021,Eastern Michigan,3,2,5,0.6
vs. Ranked (AP),2021,Eastern Michigan,0,0,0,
vs. Unranked (AP),2021,Eastern Michigan,7,6,13,0.5384615384615384
vs. FBS (I-A),2021,Eastern Michigan,6,6,12,0.5
vs. FCS (I-AA),2021,Eastern Michigan,1,0,1,1.0
vs. FBS Winning,2021,Eastern Michigan,3,4,7,0.42857142857142855
vs. FBS Non-Winning,2021,Eastern Michigan,3,2,5,0.6
vs. BCS AQ,2021,Eastern Michigan,0,1,1,0.0
vs. BCS non-AQ,2021,Eastern Michigan,6,5,11,0.5454545454545454
vs. FBS Power 5,2021,Eastern Michigan,0,1,1,0.0
vs. FBS non-Power 5,2021,Eastern Michigan,6,5,11,0.5454545454545454
in August/September,2021,Eastern Michigan,3,1,4,0.75
in October,2021,Eastern Michigan,2,2,4,0.5
in November,2021,Eastern Michigan,2,2,4,0.5
in December/January,2021,Eastern Michigan,0,1,1,0.0
All Games,2022,Eastern Michigan,9,4,13,0.6923076923076923
at Home,2022,Eastern Michigan,3,3,6,0.5
on Road/Neutral Site,2022,Eastern Michigan,6,1,7,0.8571428571428571
vs. Conference,2022,Eastern Michigan,5,3,8,0.625
vs. Non-Conference,2022,Eastern Michigan,4,1,5,0.8
vs. Ranked (AP),2022,Eastern Michigan,0,0,0,
vs. Unranked (AP),2022,Eastern Michigan,9,4,13,0.6923076923076923
vs. FBS (I-A),2022,Eastern Michigan,8,4,12,0.6666666666666666
vs. FCS (I-AA),2022,Eastern Michigan,1,0,1,1.0
vs. FBS Winning,2022,Eastern Michigan,1,2,3,0.3333333333333333
vs. FBS Non-Winning,2022,Eastern Michigan,7,2,9,0.7777777777777778
vs. BCS AQ,2022,Eastern Michigan,1,0,1,1.0
vs. BCS non-AQ,2022,Eastern Michigan,7,4,11,0.6363636363636364
vs. FBS Power 5,2022,Eastern Michigan,1,0,1,1.0
vs. FBS non-Power 5,2022,Eastern Michigan,7,4,11,0.6363636363636364
in August/September,2022,Eastern Michigan,2,2,4,0.5
in October,2022,Eastern Michigan,3,2,5,0.6
in November,2022,Eastern Michigan,3,0,3,1.0
in December/January,2022,Eastern Michigan,1,0,1,1.0
All Games,2009,Florida,13,1,14,0.9285714285714286
at Home,2009,Florida,7,0,7,1.0
on Road/Neutral Site,2009,Florida,6,1,7,0.8571428571428571
vs. Conference,2009,Florida,8,1,9,0.8888888888888888
vs. Non-Conference,2009,Florida,5,0,5,1.0
vs. Ranked (AP),2009,Florida,2,1,3,0.6666666666666666
vs. Unranked (AP),2009,Florida,11,0,11,1.0
vs. FBS (I-A),2009,Florida,12,1,13,0.9230769230769231
vs. FCS (I-AA),2009,Florida,1,0,1,1.0
vs. FBS Winning,2009,Florida,9,1,10,0.9
vs. FBS Non-Winning,2009,Florida,3,0,3,1.0
vs. BCS AQ,2009,Florida,10,1,11,0.9090909090909091
vs. BCS non-AQ,2009,Florida,2,0,2,1.0
vs. FBS Power 5,2009,Florida,9,1,10,0.9
vs. FBS non-Power 5,2009,Florida,3,0,3,1.0
in August/September,2009,Florida,4,0,4,1.0
in October,2009,Florida,4,0,4,1.0
in November,2009,Florida,4,0,4,1.0
in December/January,2009,Florida,1,1,2,0.5
All Games,2010,Florida,8,5,13,0.6153846153846154
at Home,2010,Florida,4,3,7,0.5714285714285714
on Road/Neutral Site,2010,Florida,4,2,6,0.6666666666666666
vs. Conference,2010,Florida,4,4,8,0.5
vs. Non-Conference,2010,Florida,4,1,5,0.8
vs. Ranked (AP),2010,Florida,0,5,5,0.0
vs. Unranked (AP),2010,Florida,8,0,8,1.0
vs. FBS (I-A),2010,Florida,7,5,12,0.5833333333333334
vs. FCS (I-AA),2010,Florida,1,0,1,1.0
vs. FBS Winning,2010,Florida,3,5,8,0.375
vs. FBS Non-Winning,2010,Florida,4,0,4,1.0
vs. BCS AQ,2010,Florida,6,5,11,0.5454545454545454
vs. BCS non-AQ,2010,Florida,1,0,1,1.0
vs. FBS Power 5,2010,Florida,5,5,10,0.5
vs. FBS non-Power 5,2010,Florida,2,0,2,1.0
in August/September,2010,Florida,4,0,4,1.0
in October,2010,Florida,1,3,4,0.25
in November,2010,Florida,2,2,4,0.5
in December/January,2010,Florida,1,0,1,1.0
All Games,2011,Florida,7,6,13,0.5384615384615384
at Home,2011,Florida,5,2,7,0.7142857142857143
on Road/Neutral Site,2011,Florida,2,4,6,0.3333333333333333
vs. Conference,2011,Florida,3,5,8,0.375
vs. Non-Conference,2011,Florida,4,1,5,0.8
vs. Ranked (AP),2011,Florida,0,5,5,0.0
vs. Unranked (AP),2011,Florida,7,1,8,0.875
vs. FBS (I-A),2011,Florida,6,6,12,0.5
vs. FCS (I-AA),2011,Florida,1,0,1,1.0
vs. FBS Winning,2011,Florida,0,6,6,0.0
vs. FBS Non-Winning,2011,Florida,6,0,6,1.0
vs. BCS AQ,2011,Florida,4,6,10,0.4
vs. BCS non-AQ,2011,Florida,2,0,2,1.0
vs. FBS Power 5,2011,Florida,4,6,10,0.4
vs. FBS non-Power 5,2011,Florida,2,0,2,1.0
in August/September,2011,Florida,4,0,4,1.0
in October,2011,Florida,0,4,4,0.0
in November,2011,Florida,2,2,4,0.5
in December/January,2011,Florida,1,0,1,1.0
All Games,2012,Florida,11,2,13,0.8461538461538461
at Home,2012,Florida,7,0,7,1.0
on Road/Neutral Site,2012,Florida,4,2,6,0.6666666666666666
vs. Conference,2012,Florida,7,1,8,0.875
vs. Non-Conference,2012,Florida,4,1,5,0.8
vs. Ranked (AP),2012,Florida,5,2,7,0.7142857142857143
vs. Unranked (AP),2012,Florida,6,0,6,1.0
vs. FBS (I-A),2012,Florida,10,2,12,0.8333333333333334
vs. FCS (I-AA),2012,Florida,1,0,1,1.0
vs. FBS Winning,2012,Florida,7,2,9,0.7777777777777778
vs. FBS Non-Winning,2012,Florida,3,0,3,1.0
vs. BCS AQ,2012,Florida,8,2,10,0.8
vs. BCS non-AQ,2012,Florida,2,0,2,1.0
vs. FBS Power 5,2012,Florida,8,1,9,0.8888888888888888
vs. FBS non-Power 5,2012,Florida,2,1,3,0.6666666666666666
in August/September,2012,Florida,4,0,4,1.0
in October,2012,Florida,3,1,4,0.75
in November,2012,Florida,4,0,4,1.0
in December/January,2012,Florida,0,1,1,0.0
All Games,2013,Florida,4,8,12,0.3333333333333333
at Home,2013,Florida,3,3,6,0.5
on Road/Neutral Site,2013,Florida,1,5,6,0.16666666666666666
vs. Conference,2013,Florida,3,5,8,0.375
vs. Non-Conference,2013,Florida,1,3,4,0.25
vs. Ranked (AP),2013,Florida,0,5,5,0.0
vs. Unranked (AP),2013,Florida,4,3,7,0.5714285714285714
vs. FBS (I-A),2013,Florida,4,7,11,0.36363636363636365
vs. FCS (I-AA),2013,Florida,0,1,1,0.0
vs. FBS Winning,2013,Florida,1,7,8,0.125
vs. FBS Non-Winning,2013,Florida,3,0,3,1.0
vs. BCS AQ,2013,Florida,3,7,10,0.3
vs. BCS non-AQ,2013,Florida,1,0,1,1.0
vs. FBS Power 5,2013,Florida,3,7,10,0.3
vs. FBS non-Power 5,2013,Florida,1,0,1,1.0
in August/September,2013,Florida,3,1,4,0.75
in October,2013,Florida,1,2,3,0.3333333333333333
in November,2013,Florida,0,5,5,0.0
in December/January,2013,Florida,0,0,0,
All Games,2014,Florida,7,5,12,0.5833333333333334
at Home,2014,Florida,3,3,6,0.5
on Road/Neutral Site,2014,Florida,4,2,6,0.6666666666666666
vs. Conference,2014,Florida,4,4,8,0.5
vs. Non-Conference,2014,Florida,3,1,4,0.75
vs. Ranked (AP),2014,Florida,1,3,4,0.25
vs. Unranked (AP),2014,Florida,6,2,8,0.75
vs. FBS (I-A),2014,Florida,6,5,11,0.5454545454545454
vs. FCS (I-AA),2014,Florida,1,0,1,1.0
vs. FBS Winning,2014,Florida,3,5,8,0.375
vs. FBS Non-Winning,2014,Florida,3,0,3,1.0
vs. BCS AQ,2014,Florida,5,5,10,0.5
vs. BCS non-AQ,2014,Florida,1,0,1,1.0
vs. FBS Power 5,2014,Florida,4,5,9,0.4444444444444444
vs. FBS non-Power 5,2014,Florida,2,0,2,1.0
in August/September,2014,Florida,2,1,3,0.6666666666666666
in October,2014,Florida,1,2,3,0.3333333333333333
in November,2014,Florida,3,2,5,0.6
in December/January,2014,Florida,1,0,1,1.0
All Games,2015,Florida,10,4,14,0.7142857142857143
at Home,2015,Florida,6,1,7,0.8571428571428571
on Road/Neutral Site,2015,Florida,4,3,7,0.5714285714285714
vs. Conference,2015,Florida,7,2,9,0.7777777777777778
vs. Non-Conference,2015,Florida,3,2,5,0.6
vs. Ranked (AP),2015,Florida,2,4,6,0.3333333333333333
vs. Unranked (AP),2015,Florida,8,0,8,1.0
vs. FBS (I-A),2015,Florida,10,4,14,0.7142857142857143
vs. FCS (I-AA),2015,Florida,0,0,0,
vs. FBS Winning,2015,Florida,3,4,7,0.42857142857142855
vs. FBS Non-Winning,2015,Florida,7,0,7,1.0
vs. BCS AQ,2015,Florida,8,4,12,0.6666666666666666
vs. BCS non-AQ,2015,Florida,2,0,2,1.0
vs. FBS Power 5,2015,Florida,7,4,11,0.6363636363636364
vs. FBS non-Power 5,2015,Florida,3,0,3,1.0
in August/September,2015,Florida,4,0,4,1.0
in October,2015,Florida,3,1,4,0.75
in November,2015,Florida,3,1,4,0.75
in December/January,2015,Florida,0,2,2,0.0
All Games,2016,Florida,9,4,13,0.6923076923076923
at Home,2016,Florida,5,0,5,1.0
on Road/Neutral Site,2016,Florida,4,4,8,0.5
vs. Conference,2016,Florida,6,3,9,0.6666666666666666
vs. Non-Conference,2016,Florida,3,1,4,0.75
vs. Ranked (AP),2016,Florida,2,2,4,0.5
vs. Unranked (AP),2016,Florida,7,2,9,0.7777777777777778
vs. FBS (I-A),2016,Florida,9,4,13,0.6923076923076923
vs. FCS (I-AA),2016,Florida,0,0,0,
vs. FBS Winning,2016,Florida,4,4,8,0.5
vs. FBS Non-Winning,2016,Florida,5,0,5,1.0
vs. BCS AQ,2016,Florida,7,4,11,0.6363636363636364
vs. BCS non-AQ,2016,Florida,2,0,2,1.0
vs. FBS Power 5,2016,Florida,7,4,11,0.6363636363636364
vs. FBS non-Power 5,2016,Florida,2,0,2,1.0
in August/September,2016,Florida,3,1,4,0.75
in October,2016,Florida,3,0,3,1.0
in November,2016,Florida,2,2,4,0.5
in December/January,2016,Florida,1,1,2,0.5
All Games,2017,Florida,4,7,11,0.36363636363636365
at Home,2017,Florida,3,3,6,0.5
on Road/Neutral Site,2017,Florida,1,4,5,0.2
vs. Conference,2017,Florida,3,5,8,0.375
vs. Non-Conference,2017,Florida,1,2,3,0.3333333333333333
vs. Ranked (AP),2017,Florida,0,2,2,0.0
vs. Unranked (AP),2017,Florida,4,5,9,0.4444444444444444
vs. FBS (I-A),2017,Florida,4,7,11,0.36363636363636365
vs. FCS (I-AA),2017,Florida,0,0,0,
vs. FBS Winning,2017,Florida,2,7,9,0.2222222222222222
vs. FBS Non-Winning,2017,Florida,2,0,2,1.0
vs. BCS AQ,2017,Florida,3,7,10,0.3
vs. BCS non-AQ,2017,Florida,1,0,1,1.0
vs. FBS Power 5,2017,Florida,3,7,10,0.3
vs. FBS non-Power 5,2017,Florida,1,0,1,1.0
in August/September,2017,Florida,3,1,4,0.75
in October,2017,Florida,0,3,3,0.0
in November,2017,Florida,1,3,4,0.25
in December/January,2017,Florida,0,0,0,
All Games,2018,Florida,10,3,13,0.7692307692307693
at Home,2018,Florida,5,2,7,0.7142857142857143
on Road/Neutral Site,2018,Florida,5,1,6,0.8333333333333334
vs. Conference,2018,Florida,5,3,8,0.625
vs. Non-Conference,2018,Florida,5,0,5,1.0
vs. Ranked (AP),2018,Florida,2,2,4,0.5
vs. Unranked (AP),2018,Florida,8,1,9,0.8888888888888888
vs. FBS (I-A),2018,Florida,8,3,11,0.7272727272727273
vs. FCS (I-AA),2018,Florida,2,0,2,1.0
vs. FBS Winning,2018,Florida,4,3,7,0.5714285714285714
vs. FBS Non-Winning,2018,Florida,4,0,4,1.0
vs. BCS AQ,2018,Florida,7,3,10,0.7
vs. BCS non-AQ,2018,Florida,1,0,1,1.0
vs. FBS Power 5,2018,Florida,7,3,10,0.7
vs. FBS non-Power 5,2018,Florida,1,0,1,1.0
in August/September,2018,Florida,4,1,5,0.8
in October,2018,Florida,2,1,3,0.6666666666666666
in November,2018,Florida,3,1,4,0.75
in December/January,2018,Florida,1,0,1,1.0
All Games,2019,Florida,11,2,13,0.8461538461538461
at Home,2019,Florida,6,0,6,1.0
on Road/Neutral Site,2019,Florida,5,2,7,0.7142857142857143
vs. Conference,2019,Florida,6,2,8,0.75
vs. Non-Conference,2019,Florida,5,0,5,1.0
vs. Ranked (AP),2019,Florida,1,2,3,0.3333333333333333
vs. Unranked (AP),2019,Florida,10,0,10,1.0
vs. FBS (I-A),2019,Florida,9,2,11,0.8181818181818182
vs. FCS (I-AA),2019,Florida,2,0,2,1.0
vs. FBS Winning,2019,Florida,4,2,6,0.6666666666666666
vs. FBS Non-Winning,2019,Florida,5,0,5,1.0
vs. BCS AQ,2019,Florida,9,2,11,0.8181818181818182
vs. BCS non-AQ,2019,Florida,0,0,0,
vs. FBS Power 5,2019,Florida,9,2,11,0.8181818181818182
vs. FBS non-Power 5,2019,Florida,0,0,0,
in August/September,2019,Florida,5,0,5,1.0
in October,2019,Florida,2,1,3,0.6666666666666666
in November,2019,Florida,3,1,4,0.75
in December/January,2019,Florida,1,0,1,1.0
All Games,2020,Florida,8,4,12,0.6666666666666666
at Home,2020,Florida,4,1,5,0.8
on Road/Neutral Site,2020,Florida,4,3,7,0.5714285714285714
vs. Conference,2020,Florida,8,3,11,0.7272727272727273
vs. Non-Conference,2020,Florida,0,1,1,0.0
vs. Ranked (AP),2020,Florida,1,3,4,0.25
vs. Unranked (AP),2020,Florida,7,1,8,0.875
vs. FBS (I-A),2020,Florida,8,4,12,0.6666666666666666
vs. FCS (I-AA),2020,Florida,0,0,0,
vs. FBS Winning,2020,Florida,1,3,4,0.25
vs. FBS Non-Winning,2020,Florida,7,1,8,0.875
vs. BCS AQ,2020,Florida,8,4,12,0.6666666666666666
vs. BCS non-AQ,2020,Florida,0,0,0,
vs. FBS Power 5,2020,Florida,8,4,12,0.6666666666666666
vs. FBS non-Power 5,2020,Florida,0,0,0,
in August/September,2020,Florida,1,0,1,1.0
in October,2020,Florida,2,1,3,0.6666666666666666
in November,2020,Florida,4,0,4,1.0
in December/January,2020,Florida,1,3,4,0.25
All Games,2021,Florida,6,7,13,0.46153846153846156
at Home,2021,Florida,5,1,6,0.8333333333333334
on Road/Neutral Site,2021,Florida,1,6,7,0.14285714285714285
vs. Conference,2021,Florida,2,6,8,0.25
vs. Non-Conference,2021,Florida,4,1,5,0.8
vs. Ranked (AP),2021,Florida,0,3,3,0.0
vs. Unranked (AP),2021,Florida,6,4,10,0.6
vs. FBS (I-A),2021,Florida,5,7,12,0.4166666666666667
vs. FCS (I-AA),2021,Florida,1,0,1,1.0
vs. FBS Winning,2021,Florida,1,5,6,0.16666666666666666
vs. FBS Non-Winning,2021,Florida,4,2,6,0.6666666666666666
vs. BCS AQ,2021,Florida,4,7,11,0.36363636363636365
vs. BCS non-AQ,2021,Florida,1,0,1,1.0
vs. FBS Power 5,2021,Florida,3,6,9,0.3333333333333333
vs. FBS non-Power 5,2021,Florida,2,1,3,0.6666666666666666
in August/September,2021,Florida,3,1,4,0.75
in October,2021,Florida,1,3,4,0.25
in November,2021,Florida,2,2,4,0.5
in December/January,2021,Florida,0,1,1,0.0
All Games,2022,Florida,6,7,13,0.46153846153846156
at Home,2022,Florida,5,2,7,0.7142857142857143
on Road/Neutral Site,2022,Florida,1,5,6,0.16666666666666666
vs. Conference,2022,Florida,3,5,8,0.375
vs. Non-Conference,2022,Florida,3,2,5,0.6
vs. Ranked (AP),2022,Florida,2,5,7,0.2857142857142857
vs. Unranked (AP),2022,Florida,4,2,6,0.6666666666666666
vs. FBS (I-A),2022,Florida,5,7,12,0.4166666666666667
vs. FCS (I-AA),2022,Florida,1,0,1,1.0
vs. FBS Winning,2022,Florida,2,6,8,0.25
vs. FBS Non-Winning,2022,Florida,3,1,4,0.75
vs. BCS AQ,2022,Florida,5,7,12,0.4166666666666667
vs. BCS non-AQ,2022,Florida,0,0,0,
vs. FBS Power 5,2022,Florida,4,7,11,0.36363636363636365
vs. FBS non-Power 5,2022,Florida,1,0,1,1.0
in August/September,2022,Florida,2,2,4,0.5
in October,2022,Florida,2,2,4,0.5
in November,2022,Florida,2,2,4,0.5
in December/January,2022,Florida,0,1,1,0.0
All Games,2009,Florida Atlantic,5,7,12,0.4166666666666667
at Home,2009,Florida Atlantic,2,3,5,0.4
on Road/Neutral Site,2009,Florida Atlantic,3,4,7,0.42857142857142855
vs. Conference,2009,Florida Atlantic,5,3,8,0.625
vs. Non-Conference,2009,Florida Atlantic,0,4,4,0.0
vs. Ranked (AP),2009,Florida Atlantic,0,1,1,0.0
vs. Unranked (AP),2009,Florida Atlantic,5,6,11,0.45454545454545453
vs. FBS (I-A),2009,Florida Atlantic,5,7,12,0.4166666666666667
vs. FCS (I-AA),2009,Florida Atlantic,0,0,0,
vs. FBS Winning,2009,Florida Atlantic,0,5,5,0.0
vs. FBS Non-Winning,2009,Florida Atlantic,5,2,7,0.7142857142857143
vs. BCS AQ,2009,Florida Atlantic,0,2,2,0.0
vs. BCS non-AQ,2009,Florida Atlantic,5,5,10,0.5
vs. FBS Power 5,2009,Florida Atlantic,0,2,2,0.0
vs. FBS non-Power 5,2009,Florida Atlantic,5,5,10,0.5
in August/September,2009,Florida Atlantic,0,3,3,0.0
in October,2009,Florida Atlantic,2,2,4,0.5
in November,2009,Florida Atlantic,2,2,4,0.5
in December/January,2009,Florida Atlantic,1,0,1,1.0
All Games,2010,Florida Atlantic,4,8,12,0.3333333333333333
at Home,2010,Florida Atlantic,2,2,4,0.5
on Road/Neutral Site,2010,Florida Atlantic,2,6,8,0.25
vs. Conference,2010,Florida Atlantic,3,5,8,0.375
vs. Non-Conference,2010,Florida Atlantic,1,3,4,0.25
vs. Ranked (AP),2010,Florida Atlantic,0,1,1,0.0
vs. Unranked (AP),2010,Florida Atlantic,4,7,11,0.36363636363636365
vs. FBS (I-A),2010,Florida Atlantic,4,8,12,0.3333333333333333
vs. FCS (I-AA),2010,Florida Atlantic,0,0,0,
vs. FBS Winning,2010,Florida Atlantic,1,3,4,0.25
vs. FBS Non-Winning,2010,Florida Atlantic,3,5,8,0.375
vs. BCS AQ,2010,Florida Atlantic,0,3,3,0.0
vs. BCS non-AQ,2010,Florida Atlantic,4,5,9,0.4444444444444444
vs. FBS Power 5,2010,Florida Atlantic,0,2,2,0.0
vs. FBS non-Power 5,2010,Florida Atlantic,4,6,10,0.4
in August/September,2010,Florida Atlantic,1,2,3,0.3333333333333333
in October,2010,Florida Atlantic,1,3,4,0.25
in November,2010,Florida Atlantic,2,2,4,0.5
in December/January,2010,Florida Atlantic,0,1,1,0.0
All Games,2011,Florida Atlantic,1,11,12,0.08333333333333333
at Home,2011,Florida Atlantic,1,4,5,0.2
on Road/Neutral Site,2011,Florida Atlantic,0,7,7,0.0
vs. Conference,2011,Florida Atlantic,0,8,8,0.0
vs. Non-Conference,2011,Florida Atlantic,1,3,4,0.25
vs. Ranked (AP),2011,Florida Atlantic,0,1,1,0.0
vs. Unranked (AP),2011,Florida Atlantic,1,10,11,0.09090909090909091
vs. FBS (I-A),2011,Florida Atlantic,1,11,12,0.08333333333333333
vs. FCS (I-AA),2011,Florida Atlantic,0,0,0,
vs. FBS Winning,2011,Florida Atlantic,0,7,7,0.0
vs. FBS Non-Winning,2011,Florida Atlantic,1,4,5,0.2
vs. BCS AQ,2011,Florida Atlantic,0,3,3,0.0
vs. BCS non-AQ,2011,Florida Atlantic,1,8,9,0.1111111111111111
vs. FBS Power 5,2011,Florida Atlantic,0,3,3,0.0
vs. FBS non-Power 5,2011,Florida Atlantic,1,8,9,0.1111111111111111
in August/September,2011,Florida Atlantic,0,3,3,0.0
in October,2011,Florida Atlantic,0,4,4,0.0
in November,2011,Florida Atlantic,1,3,4,0.25
in December/January,2011,Florida Atlantic,0,1,1,0.0
All Games,2012,Florida Atlantic,3,9,12,0.25
at Home,2012,Florida Atlantic,2,3,5,0.4
on Road/Neutral Site,2012,Florida Atlantic,1,6,7,0.14285714285714285
vs. Conference,2012,Florida Atlantic,2,6,8,0.25
vs. Non-Conference,2012,Florida Atlantic,1,3,4,0.25
vs. Ranked (AP),2012,Florida Atlantic,0,2,2,0.0
vs. Unranked (AP),2012,Florida Atlantic,3,7,10,0.3
vs. FBS (I-A),2012,Florida Atlantic,2,9,11,0.18181818181818182
vs. FCS (I-AA),2012,Florida Atlantic,1,0,1,1.0
vs. FBS Winning,2012,Florida Atlantic,1,6,7,0.14285714285714285
vs. FBS Non-Winning,2012,Florida Atlantic,1,3,4,0.25
vs. BCS AQ,2012,Florida Atlantic,0,2,2,0.0
vs. BCS non-AQ,2012,Florida Atlantic,2,7,9,0.2222222222222222
vs. FBS Power 5,2012,Florida Atlantic,0,2,2,0.0
vs. FBS non-Power 5,2012,Florida Atlantic,2,7,9,0.2222222222222222
in August/September,2012,Florida Atlantic,1,4,5,0.2
in October,2012,Florida Atlantic,1,2,3,0.3333333333333333
in November,2012,Florida Atlantic,1,2,3,0.3333333333333333
in December/January,2012,Florida Atlantic,0,1,1,0.0
All Games,2013,Florida Atlantic,6,6,12,0.5
at Home,2013,Florida Atlantic,3,2,5,0.6
on Road/Neutral Site,2013,Florida Atlantic,3,4,7,0.42857142857142855
vs. Conference,2013,Florida Atlantic,4,4,8,0.5
vs. Non-Conference,2013,Florida Atlantic,2,2,4,0.5
vs. Ranked (AP),2013,Florida Atlantic,0,1,1,0.0
vs. Unranked (AP),2013,Florida Atlantic,6,5,11,0.5454545454545454
vs. FBS (I-A),2013,Florida Atlantic,6,6,12,0.5
vs. FCS (I-AA),2013,Florida Atlantic,0,0,0,
vs. FBS Winning,2013,Florida Atlantic,1,6,7,0.14285714285714285
vs. FBS Non-Winning,2013,Florida Atlantic,5,0,5,1.0
vs. BCS AQ,2013,Florida Atlantic,1,2,3,0.3333333333333333
vs. BCS non-AQ,2013,Florida Atlantic,5,4,9,0.5555555555555556
vs. FBS Power 5,2013,Florida Atlantic,0,2,2,0.0
vs. FBS non-Power 5,2013,Florida Atlantic,6,4,10,0.6
in August/September,2013,Florida Atlantic,1,4,5,0.2
in October,2013,Florida Atlantic,1,2,3,0.3333333333333333
in November,2013,Florida Atlantic,4,0,4,1.0
in December/January,2013,Florida Atlantic,0,0,0,
All Games,2014,Florida Atlantic,3,9,12,0.25
at Home,2014,Florida Atlantic,3,2,5,0.6
on Road/Neutral Site,2014,Florida Atlantic,0,7,7,0.0
vs. Conference,2014,Florida Atlantic,2,6,8,0.25
vs. Non-Conference,2014,Florida Atlantic,1,3,4,0.25
vs. Ranked (AP),2014,Florida Atlantic,0,2,2,0.0
vs. Unranked (AP),2014,Florida Atlantic,3,7,10,0.3
vs. FBS (I-A),2014,Florida Atlantic,3,9,12,0.25
vs. FCS (I-AA),2014,Florida Atlantic,0,0,0,
vs. FBS Winning,2014,Florida Atlantic,1,3,4,0.25
vs. FBS Non-Winning,2014,Florida Atlantic,2,6,8,0.25
vs. BCS AQ,2014,Florida Atlantic,1,2,3,0.3333333333333333
vs. BCS non-AQ,2014,Florida Atlantic,2,7,9,0.2222222222222222
vs. FBS Power 5,2014,Florida Atlantic,0,2,2,0.0
vs. FBS non-Power 5,2014,Florida Atlantic,3,7,10,0.3
in August/September,2014,Florida Atlantic,2,3,5,0.4
in October,2014,Florida Atlantic,1,2,3,0.3333333333333333
in November,2014,Florida Atlantic,0,4,4,0.0
in December/January,2014,Florida Atlantic,0,0,0,
All Games,2015,Florida Atlantic,3,9,12,0.25
at Home,2015,Florida Atlantic,1,5,6,0.16666666666666666
on Road/Neutral Site,2015,Florida Atlantic,2,4,6,0.3333333333333333
vs. Conference,2015,Florida Atlantic,3,5,8,0.375
vs. Non-Conference,2015,Florida Atlantic,0,4,4,0.0
vs. Ranked (AP),2015,Florida Atlantic,0,2,2,0.0
vs. Unranked (AP),2015,Florida Atlantic,3,7,10,0.3
vs. FBS (I-A),2015,Florida Atlantic,3,9,12,0.25
vs. FCS (I-AA),2015,Florida Atlantic,0,0,0,
vs. FBS Winning,2015,Florida Atlantic,0,5,5,0.0
vs. FBS Non-Winning,2015,Florida Atlantic,3,4,7,0.42857142857142855
vs. BCS AQ,2015,Florida Atlantic,0,3,3,0.0
vs. BCS non-AQ,2015,Florida Atlantic,3,6,9,0.3333333333333333
vs. FBS Power 5,2015,Florida Atlantic,0,2,2,0.0
vs. FBS non-Power 5,2015,Florida Atlantic,3,7,10,0.3
in August/September,2015,Florida Atlantic,1,3,4,0.25
in October,2015,Florida Atlantic,1,3,4,0.25
in November,2015,Florida Atlantic,1,3,4,0.25
in December/January,2015,Florida Atlantic,0,0,0,
All Games,2016,Florida Atlantic,3,9,12,0.25
at Home,2016,Florida Atlantic,2,4,6,0.3333333333333333
on Road/Neutral Site,2016,Florida Atlantic,1,5,6,0.16666666666666666
vs. Conference,2016,Florida Atlantic,2,6,8,0.25
vs. Non-Conference,2016,Florida Atlantic,1,3,4,0.25
vs. Ranked (AP),2016,Florida Atlantic,0,0,0,
vs. Unranked (AP),2016,Florida Atlantic,3,9,12,0.25
vs. FBS (I-A),2016,Florida Atlantic,2,9,11,0.18181818181818182
vs. FCS (I-AA),2016,Florida Atlantic,1,0,1,1.0
vs. FBS Winning,2016,Florida Atlantic,0,5,5,0.0
vs. FBS Non-Winning,2016,Florida Atlantic,2,4,6,0.3333333333333333
vs. BCS AQ,2016,Florida Atlantic,0,2,2,0.0
vs. BCS non-AQ,2016,Florida Atlantic,2,7,9,0.2222222222222222
vs. FBS Power 5,2016,Florida Atlantic,0,2,2,0.0
vs. FBS non-Power 5,2016,Florida Atlantic,2,7,9,0.2222222222222222
in August/September,2016,Florida Atlantic,1,3,4,0.25
in October,2016,Florida Atlantic,0,4,4,0.0
in November,2016,Florida Atlantic,2,2,4,0.5
in December/January,2016,Florida Atlantic,0,0,0,
All Games,2017,Florida Atlantic,11,3,14,0.7857142857142857
at Home,2017,Florida Atlantic,7,1,8,0.875
on Road/Neutral Site,2017,Florida Atlantic,4,2,6,0.6666666666666666
vs. Conference,2017,Florida Atlantic,9,0,9,1.0
vs. Non-Conference,2017,Florida Atlantic,2,3,5,0.4
vs. Ranked (AP),2017,Florida Atlantic,0,1,1,0.0
vs. Unranked (AP),2017,Florida Atlantic,11,2,13,0.8461538461538461
vs. FBS (I-A),2017,Florida Atlantic,10,3,13,0.7692307692307693
vs. FCS (I-AA),2017,Florida Atlantic,1,0,1,1.0
vs. FBS Winning,2017,Florida Atlantic,6,2,8,0.75
vs. FBS Non-Winning,2017,Florida Atlantic,4,1,5,0.8
vs. BCS AQ,2017,Florida Atlantic,0,2,2,0.0
vs. BCS non-AQ,2017,Florida Atlantic,10,1,11,0.9090909090909091
vs. FBS Power 5,2017,Florida Atlantic,0,1,1,0.0
vs. FBS non-Power 5,2017,Florida Atlantic,10,2,12,0.8333333333333334
in August/September,2017,Florida Atlantic,2,3,5,0.4
in October,2017,Florida Atlantic,3,0,3,1.0
in November,2017,Florida Atlantic,4,0,4,1.0
in December/January,2017,Florida Atlantic,2,0,2,1.0
All Games,2018,Florida Atlantic,5,7,12,0.4166666666666667
at Home,2018,Florida Atlantic,4,2,6,0.6666666666666666
on Road/Neutral Site,2018,Florida Atlantic,1,5,6,0.16666666666666666
vs. Conference,2018,Florida Atlantic,3,5,8,0.375
vs. Non-Conference,2018,Florida Atlantic,2,2,4,0.5
vs. Ranked (AP),2018,Florida Atlantic,0,2,2,0.0
vs. Unranked (AP),2018,Florida Atlantic,5,5,10,0.5
vs. FBS (I-A),2018,Florida Atlantic,4,7,11,0.36363636363636365
vs. FCS (I-AA),2018,Florida Atlantic,1,0,1,1.0
vs. FBS Winning,2018,Florida Atlantic,1,6,7,0.14285714285714285
vs. FBS Non-Winning,2018,Florida Atlantic,3,1,4,0.75
vs. BCS AQ,2018,Florida Atlantic,0,2,2,0.0
vs. BCS non-AQ,2018,Florida Atlantic,4,5,9,0.4444444444444444
vs. FBS Power 5,2018,Florida Atlantic,0,1,1,0.0
vs. FBS non-Power 5,2018,Florida Atlantic,4,6,10,0.4
in August/September,2018,Florida Atlantic,2,3,5,0.4
in October,2018,Florida Atlantic,1,2,3,0.3333333333333333
in November,2018,Florida Atlantic,2,2,4,0.5
in December/January,2018,Florida Atlantic,0,0,0,
All Games,2019,Florida Atlantic,11,3,14,0.7857142857142857
at Home,2019,Florida Atlantic,6,2,8,0.75
on Road/Neutral Site,2019,Florida Atlantic,5,1,6,0.8333333333333334
vs. Conference,2019,Florida Atlantic,8,1,9,0.8888888888888888
vs. Non-Conference,2019,Florida Atlantic,3,2,5,0.6
vs. Ranked (AP),2019,Florida Atlantic,0,2,2,0.0
vs. Unranked (AP),2019,Florida Atlantic,11,1,12,0.9166666666666666
vs. FBS (I-A),2019,Florida Atlantic,10,3,13,0.7692307692307693
vs. FCS (I-AA),2019,Florida Atlantic,1,0,1,1.0
vs. FBS Winning,2019,Florida Atlantic,5,3,8,0.625
vs. FBS Non-Winning,2019,Florida Atlantic,5,0,5,1.0
vs. BCS AQ,2019,Florida Atlantic,1,2,3,0.3333333333333333
vs. BCS non-AQ,2019,Florida Atlantic,9,1,10,0.9
vs. FBS Power 5,2019,Florida Atlantic,0,1,1,0.0
vs. FBS non-Power 5,2019,Florida Atlantic,10,2,12,0.8333333333333334
in August/September,2019,Florida Atlantic,3,2,5,0.6
in October,2019,Florida Atlantic,2,1,3,0.6666666666666666
in November,2019,Florida Atlantic,4,0,4,1.0
in December/January,2019,Florida Atlantic,2,0,2,1.0
All Games,2020,Florida Atlantic,5,4,9,0.5555555555555556
at Home,2020,Florida Atlantic,4,0,4,1.0
on Road/Neutral Site,2020,Florida Atlantic,1,4,5,0.2
vs. Conference,2020,Florida Atlantic,4,2,6,0.6666666666666666
vs. Non-Conference,2020,Florida Atlantic,1,2,3,0.3333333333333333
vs. Ranked (AP),2020,Florida Atlantic,0,0,0,
vs. Unranked (AP),2020,Florida Atlantic,5,4,9,0.5555555555555556
vs. FBS (I-A),2020,Florida Atlantic,5,4,9,0.5555555555555556
vs. FCS (I-AA),2020,Florida Atlantic,0,0,0,
vs. FBS Winning,2020,Florida Atlantic,1,3,4,0.25
vs. FBS Non-Winning,2020,Florida Atlantic,4,1,5,0.8
vs. BCS AQ,2020,Florida Atlantic,0,1,1,0.0
vs. BCS non-AQ,2020,Florida Atlantic,5,3,8,0.625
vs. FBS Power 5,2020,Florida Atlantic,0,0,0,
vs. FBS non-Power 5,2020,Florida Atlantic,5,4,9,0.5555555555555556
in August/September,2020,Florida Atlantic,0,0,0,
in October,2020,Florida Atlantic,2,1,3,0.6666666666666666
in November,2020,Florida Atlantic,3,0,3,1.0
in December/January,2020,Florida Atlantic,0,3,3,0.0
All Games,2021,Florida Atlantic,5,7,12,0.4166666666666667
at Home,2021,Florida Atlantic,4,2,6,0.6666666666666666
on Road/Neutral Site,2021,Florida Atlantic,1,5,6,0.16666666666666666
vs. Conference,2021,Florida Atlantic,3,5,8,0.375
vs. Non-Conference,2021,Florida Atlantic,2,2,4,0.5
vs. Ranked (AP),2021,Florida Atlantic,0,0,0,
vs. Unranked (AP),2021,Florida Atlantic,5,7,12,0.4166666666666667
vs. FBS (I-A),2021,Florida Atlantic,4,7,11,0.36363636363636365
vs. FCS (I-AA),2021,Florida Atlantic,1,0,1,1.0
vs. FBS Winning,2021,Florida Atlantic,1,5,6,0.16666666666666666
vs. FBS Non-Winning,2021,Florida Atlantic,3,2,5,0.6
vs. BCS AQ,2021,Florida Atlantic,0,1,1,0.0
vs. BCS non-AQ,2021,Florida Atlantic,4,6,10,0.4
vs. FBS Power 5,2021,Florida Atlantic,0,1,1,0.0
vs. FBS non-Power 5,2021,Florida Atlantic,4,6,10,0.4
in August/September,2021,Florida Atlantic,2,2,4,0.5
in October,2021,Florida Atlantic,3,1,4,0.75
in November,2021,Florida Atlantic,0,4,4,0.0
in December/January,2021,Florida Atlantic,0,0,0,
All Games,2022,Florida Atlantic,5,7,12,0.4166666666666667
at Home,2022,Florida Atlantic,4,2,6,0.6666666666666666
on Road/Neutral Site,2022,Florida Atlantic,1,5,6,0.16666666666666666
vs. Conference,2022,Florida Atlantic,4,4,8,0.5
vs. Non-Conference,2022,Florida Atlantic,1,3,4,0.25
vs. Ranked (AP),2022,Florida Atlantic,0,0,0,
vs. Unranked (AP),2022,Florida Atlantic,5,7,12,0.4166666666666667
vs. FBS (I-A),2022,Florida Atlantic,4,7,11,0.36363636363636365
vs. FCS (I-AA),2022,Florida Atlantic,1,0,1,1.0
vs. FBS Winning,2022,Florida Atlantic,1,5,6,0.16666666666666666
vs. FBS Non-Winning,2022,Florida Atlantic,3,2,5,0.6
vs. BCS AQ,2022,Florida Atlantic,0,2,2,0.0
vs. BCS non-AQ,2022,Florida Atlantic,4,5,9,0.4444444444444444
vs. FBS Power 5,2022,Florida Atlantic,0,1,1,0.0
vs. FBS non-Power 5,2022,Florida Atlantic,4,6,10,0.4
in August/September,2022,Florida Atlantic,2,3,5,0.4
in October,2022,Florida Atlantic,2,2,4,0.5
in November,2022,Florida Atlantic,1,2,3,0.3333333333333333
in December/January,2022,Florida Atlantic,0,0,0,
All Games,2009,Florida International,3,9,12,0.25
at Home,2009,Florida International,2,3,5,0.4
on Road/Neutral Site,2009,Florida International,1,6,7,0.14285714285714285
vs. Conference,2009,Florida International,3,5,8,0.375
vs. Non-Conference,2009,Florida International,0,4,4,0.0
vs. Ranked (AP),2009,Florida International,0,2,2,0.0
vs. Unranked (AP),2009,Florida International,3,7,10,0.3
vs. FBS (I-A),2009,Florida International,3,9,12,0.25
vs. FCS (I-AA),2009,Florida International,0,0,0,
vs. FBS Winning,2009,Florida International,0,5,5,0.0
vs. FBS Non-Winning,2009,Florida International,3,4,7,0.42857142857142855
vs. BCS AQ,2009,Florida International,0,3,3,0.0
vs. BCS non-AQ,2009,Florida International,3,6,9,0.3333333333333333
vs. FBS Power 5,2009,Florida International,0,2,2,0.0
vs. FBS non-Power 5,2009,Florida International,3,7,10,0.3
in August/September,2009,Florida International,0,3,3,0.0
in October,2009,Florida International,2,3,5,0.4
in November,2009,Florida International,1,2,3,0.3333333333333333
in December/January,2009,Florida International,0,1,1,0.0
All Games,2010,Florida International,7,6,13,0.5384615384615384
at Home,2010,Florida International,3,2,5,0.6
on Road/Neutral Site,2010,Florida International,4,4,8,0.5
vs. Conference,2010,Florida International,6,2,8,0.75
vs. Non-Conference,2010,Florida International,1,4,5,0.2
vs. Ranked (AP),2010,Florida International,0,2,2,0.0
vs. Unranked (AP),2010,Florida International,7,4,11,0.6363636363636364
vs. FBS (I-A),2010,Florida International,7,6,13,0.5384615384615384
vs. FCS (I-AA),2010,Florida International,0,0,0,
vs. FBS Winning,2010,Florida International,2,3,5,0.4
vs. FBS Non-Winning,2010,Florida International,5,3,8,0.625
vs. BCS AQ,2010,Florida International,0,4,4,0.0
vs. BCS non-AQ,2010,Florida International,7,2,9,0.7777777777777778
vs. FBS Power 5,2010,Florida International,0,2,2,0.0
vs. FBS non-Power 5,2010,Florida International,7,4,11,0.6363636363636364
in August/September,2010,Florida International,0,3,3,0.0
in October,2010,Florida International,2,2,4,0.5
in November,2010,Florida International,4,0,4,1.0
in December/January,2010,Florida International,1,1,2,0.5
All Games,2011,Florida International,8,5,13,0.6153846153846154
at Home,2011,Florida International,4,2,6,0.6666666666666666
on Road/Neutral Site,2011,Florida International,4,3,7,0.5714285714285714
vs. Conference,2011,Florida International,5,3,8,0.625
vs. Non-Conference,2011,Florida International,3,2,5,0.6
vs. Ranked (AP),2011,Florida International,0,0,0,
vs. Unranked (AP),2011,Florida International,8,5,13,0.6153846153846154
vs. FBS (I-A),2011,Florida International,8,5,13,0.6153846153846154
vs. FCS (I-AA),2011,Florida International,0,0,0,
vs. FBS Winning,2011,Florida International,1,4,5,0.2
vs. FBS Non-Winning,2011,Florida International,7,1,8,0.875
vs. BCS AQ,2011,Florida International,1,1,2,0.5
vs. BCS non-AQ,2011,Florida International,7,4,11,0.6363636363636364
vs. FBS Power 5,2011,Florida International,0,1,1,0.0
vs. FBS non-Power 5,2011,Florida International,8,4,12,0.6666666666666666
in August/September,2011,Florida International,3,1,4,0.75
in October,2011,Florida International,2,2,4,0.5
in November,2011,Florida International,3,1,4,0.75
in December/January,2011,Florida International,0,1,1,0.0
All Games,2012,Florida International,3,9,12,0.25
at Home,2012,Florida International,1,5,6,0.16666666666666666
on Road/Neutral Site,2012,Florida International,2,4,6,0.3333333333333333
vs. Conference,2012,Florida International,2,6,8,0.25
vs. Non-Conference,2012,Florida International,1,3,4,0.25
vs. Ranked (AP),2012,Florida International,0,1,1,0.0
vs. Unranked (AP),2012,Florida International,3,8,11,0.2727272727272727
vs. FBS (I-A),2012,Florida International,3,9,12,0.25
vs. FCS (I-AA),2012,Florida International,0,0,0,
vs. FBS Winning,2012,Florida International,0,7,7,0.0
vs. FBS Non-Winning,2012,Florida International,3,2,5,0.6
vs. BCS AQ,2012,Florida International,0,2,2,0.0
vs. BCS non-AQ,2012,Florida International,3,7,10,0.3
vs. FBS Power 5,2012,Florida International,0,1,1,0.0
vs. FBS non-Power 5,2012,Florida International,3,8,11,0.2727272727272727
in August/September,2012,Florida International,1,4,5,0.2
in October,2012,Florida International,0,4,4,0.0
in November,2012,Florida International,2,1,3,0.6666666666666666
in December/January,2012,Florida International,0,0,0,
All Games,2013,Florida International,1,11,12,0.08333333333333333
at Home,2013,Florida International,0,6,6,0.0
on Road/Neutral Site,2013,Florida International,1,5,6,0.16666666666666666
vs. Conference,2013,Florida International,1,7,8,0.125
vs. Non-Conference,2013,Florida International,0,4,4,0.0
vs. Ranked (AP),2013,Florida International,0,2,2,0.0
vs. Unranked (AP),2013,Florida International,1,9,10,0.1
vs. FBS (I-A),2013,Florida International,1,10,11,0.09090909090909091
vs. FCS (I-AA),2013,Florida International,0,1,1,0.0
vs. FBS Winning,2013,Florida International,0,6,6,0.0
vs. FBS Non-Winning,2013,Florida International,1,4,5,0.2
vs. BCS AQ,2013,Florida International,0,3,3,0.0
vs. BCS non-AQ,2013,Florida International,1,7,8,0.125
vs. FBS Power 5,2013,Florida International,0,1,1,0.0
vs. FBS non-Power 5,2013,Florida International,1,9,10,0.1
in August/September,2013,Florida International,0,4,4,0.0
in October,2013,Florida International,1,2,3,0.3333333333333333
in November,2013,Florida International,0,5,5,0.0
in December/January,2013,Florida International,0,0,0,
All Games,2014,Florida International,4,8,12,0.3333333333333333
at Home,2014,Florida International,3,5,8,0.375
on Road/Neutral Site,2014,Florida International,1,3,4,0.25
vs. Conference,2014,Florida International,3,5,8,0.375
vs. Non-Conference,2014,Florida International,1,3,4,0.25
vs. Ranked (AP),2014,Florida International,0,2,2,0.0
vs. Unranked (AP),2014,Florida International,4,6,10,0.4
vs. FBS (I-A),2014,Florida International,3,7,10,0.3
vs. FCS (I-AA),2014,Florida International,1,1,2,0.5
vs. FBS Winning,2014,Florida International,0,3,3,0.0
vs. FBS Non-Winning,2014,Florida International,3,4,7,0.42857142857142855
vs. BCS AQ,2014,Florida International,0,2,2,0.0
vs. BCS non-AQ,2014,Florida International,3,5,8,0.375
vs. FBS Power 5,2014,Florida International,0,2,2,0.0
vs. FBS non-Power 5,2014,Florida International,3,5,8,0.375
in August/September,2014,Florida International,2,3,5,0.4
in October,2014,Florida International,1,2,3,0.3333333333333333
in November,2014,Florida International,1,3,4,0.25
in December/January,2014,Florida International,0,0,0,
All Games,2015,Florida International,5,7,12,0.4166666666666667
at Home,2015,Florida International,4,1,5,0.8
on Road/Neutral Site,2015,Florida International,1,6,7,0.14285714285714285
vs. Conference,2015,Florida International,3,5,8,0.375
vs. Non-Conference,2015,Florida International,2,2,4,0.5
vs. Ranked (AP),2015,Florida International,0,1,1,0.0
vs. Unranked (AP),2015,Florida International,5,6,11,0.45454545454545453
vs. FBS (I-A),2015,Florida International,4,7,11,0.36363636363636365
vs. FCS (I-AA),2015,Florida International,1,0,1,1.0
vs. FBS Winning,2015,Florida International,0,4,4,0.0
vs. FBS Non-Winning,2015,Florida International,4,3,7,0.5714285714285714
vs. BCS AQ,2015,Florida International,1,1,2,0.5
vs. BCS non-AQ,2015,Florida International,3,6,9,0.3333333333333333
vs. FBS Power 5,2015,Florida International,0,1,1,0.0
vs. FBS non-Power 5,2015,Florida International,4,6,10,0.4
in August/September,2015,Florida International,2,2,4,0.5
in October,2015,Florida International,2,3,5,0.4
in November,2015,Florida International,1,2,3,0.3333333333333333
in December/January,2015,Florida International,0,0,0,
All Games,2016,Florida International,4,8,12,0.3333333333333333
at Home,2016,Florida International,2,5,7,0.2857142857142857
on Road/Neutral Site,2016,Florida International,2,3,5,0.4
vs. Conference,2016,Florida International,4,4,8,0.5
vs. Non-Conference,2016,Florida International,0,4,4,0.0
vs. Ranked (AP),2016,Florida International,0,0,0,
vs. Unranked (AP),2016,Florida International,4,8,12,0.3333333333333333
vs. FBS (I-A),2016,Florida International,4,8,12,0.3333333333333333
vs. FCS (I-AA),2016,Florida International,0,0,0,
vs. FBS Winning,2016,Florida International,0,4,4,0.0
vs. FBS Non-Winning,2016,Florida International,4,4,8,0.5
vs. BCS AQ,2016,Florida International,0,3,3,0.0
vs. BCS non-AQ,2016,Florida International,4,5,9,0.4444444444444444
vs. FBS Power 5,2016,Florida International,0,2,2,0.0
vs. FBS non-Power 5,2016,Florida International,4,6,10,0.4
in August/September,2016,Florida International,0,4,4,0.0
in October,2016,Florida International,3,2,5,0.6
in November,2016,Florida International,1,2,3,0.3333333333333333
in December/January,2016,Florida International,0,0,0,
All Games,2017,Florida International,8,5,13,0.6153846153846154
at Home,2017,Florida International,5,1,6,0.8333333333333334
on Road/Neutral Site,2017,Florida International,3,4,7,0.42857142857142855
vs. Conference,2017,Florida International,5,3,8,0.625
vs. Non-Conference,2017,Florida International,3,2,5,0.6
vs. Ranked (AP),2017,Florida International,0,1,1,0.0
vs. Unranked (AP),2017,Florida International,8,4,12,0.6666666666666666
vs. FBS (I-A),2017,Florida International,7,5,12,0.5833333333333334
vs. FCS (I-AA),2017,Florida International,1,0,1,1.0
vs. FBS Winning,2017,Florida International,2,4,6,0.3333333333333333
vs. FBS Non-Winning,2017,Florida International,5,1,6,0.8333333333333334
vs. BCS AQ,2017,Florida International,1,2,3,0.3333333333333333
vs. BCS non-AQ,2017,Florida International,6,3,9,0.6666666666666666
vs. FBS Power 5,2017,Florida International,0,0,0,
vs. FBS non-Power 5,2017,Florida International,7,5,12,0.5833333333333334
in August/September,2017,Florida International,3,1,4,0.75
in October,2017,Florida International,2,1,3,0.6666666666666666
in November,2017,Florida International,2,2,4,0.5
in December/January,2017,Florida International,1,1,2,0.5
All Games,2018,Florida International,9,4,13,0.6923076923076923
at Home,2018,Florida International,4,3,7,0.5714285714285714
on Road/Neutral Site,2018,Florida International,5,1,6,0.8333333333333334
vs. Conference,2018,Florida International,6,2,8,0.75
vs. Non-Conference,2018,Florida International,3,2,5,0.6
vs. Ranked (AP),2018,Florida International,0,0,0,
vs. Unranked (AP),2018,Florida International,9,4,13,0.6923076923076923
vs. FBS (I-A),2018,Florida International,8,4,12,0.6666666666666666
vs. FCS (I-AA),2018,Florida International,1,0,1,1.0
vs. FBS Winning,2018,Florida International,2,2,4,0.5
vs. FBS Non-Winning,2018,Florida International,6,2,8,0.75
vs. BCS AQ,2018,Florida International,0,2,2,0.0
vs. BCS non-AQ,2018,Florida International,8,2,10,0.8
vs. FBS Power 5,2018,Florida International,0,2,2,0.0
vs. FBS non-Power 5,2018,Florida International,8,2,10,0.8
in August/September,2018,Florida International,3,2,5,0.6
in October,2018,Florida International,3,0,3,1.0
in November,2018,Florida International,2,2,4,0.5
in December/January,2018,Florida International,1,0,1,1.0
All Games,2019,Florida International,6,7,13,0.46153846153846156
at Home,2019,Florida International,6,1,7,0.8571428571428571
on Road/Neutral Site,2019,Florida International,0,6,6,0.0
vs. Conference,2019,Florida International,3,5,8,0.375
vs. Non-Conference,2019,Florida International,3,2,5,0.6
vs. Ranked (AP),2019,Florida International,0,0,0,
vs. Unranked (AP),2019,Florida International,6,7,13,0.46153846153846156
vs. FBS (I-A),2019,Florida International,5,7,12,0.4166666666666667
vs. FCS (I-AA),2019,Florida International,1,0,1,1.0
vs. FBS Winning,2019,Florida International,1,6,7,0.14285714285714285
vs. FBS Non-Winning,2019,Florida International,4,1,5,0.8
vs. BCS AQ,2019,Florida International,1,1,2,0.5
vs. BCS non-AQ,2019,Florida International,4,6,10,0.4
vs. FBS Power 5,2019,Florida International,1,0,1,1.0
vs. FBS non-Power 5,2019,Florida International,4,7,11,0.36363636363636365
in August/September,2019,Florida International,1,3,4,0.25
in October,2019,Florida International,3,1,4,0.75
in November,2019,Florida International,2,2,4,0.5
in December/January,2019,Florida International,0,1,1,0.0
All Games,2020,Florida International,0,5,5,0.0
at Home,2020,Florida International,0,3,3,0.0
on Road/Neutral Site,2020,Florida International,0,2,2,0.0
vs. Conference,2020,Florida International,0,3,3,0.0
vs. Non-Conference,2020,Florida International,0,2,2,0.0
vs. Ranked (AP),2020,Florida International,0,1,1,0.0
vs. Unranked (AP),2020,Florida International,0,4,4,0.0
vs. FBS (I-A),2020,Florida International,0,4,4,0.0
vs. FCS (I-AA),2020,Florida International,0,1,1,0.0
vs. FBS Winning,2020,Florida International,0,2,2,0.0
vs. FBS Non-Winning,2020,Florida International,0,2,2,0.0
vs. BCS AQ,2020,Florida International,0,0,0,
vs. BCS non-AQ,2020,Florida International,0,4,4,0.0
vs. FBS Power 5,2020,Florida International,0,0,0,
vs. FBS non-Power 5,2020,Florida International,0,4,4,0.0
in August/September,2020,Florida International,0,1,1,0.0
in October,2020,Florida International,0,2,2,0.0
in November,2020,Florida International,0,2,2,0.0
in December/January,2020,Florida International,0,0,0,
All Games,2021,Florida International,1,11,12,0.08333333333333333
at Home,2021,Florida International,1,5,6,0.16666666666666666
on Road/Neutral Site,2021,Florida International,0,6,6,0.0
vs. Conference,2021,Florida International,0,8,8,0.0
vs. Non-Conference,2021,Florida International,1,3,4,0.25
vs. Ranked (AP),2021,Florida International,0,0,0,
vs. Unranked (AP),2021,Florida International,1,11,12,0.08333333333333333
vs. FBS (I-A),2021,Florida International,0,11,11,0.0
vs. FCS (I-AA),2021,Florida International,1,0,1,1.0
vs. FBS Winning,2021,Florida International,0,5,5,0.0
vs. FBS Non-Winning,2021,Florida International,0,6,6,0.0
vs. BCS AQ,2021,Florida International,0,1,1,0.0
vs. BCS non-AQ,2021,Florida International,0,10,10,0.0
vs. FBS Power 5,2021,Florida International,0,1,1,0.0
vs. FBS non-Power 5,2021,Florida International,0,10,10,0.0
in August/September,2021,Florida International,1,3,4,0.25
in October,2021,Florida International,0,4,4,0.0
in November,2021,Florida International,0,4,4,0.0
in December/January,2021,Florida International,0,0,0,
All Games,2022,Florida International,4,8,12,0.3333333333333333
at Home,2022,Florida International,2,4,6,0.3333333333333333
on Road/Neutral Site,2022,Florida International,2,4,6,0.3333333333333333
vs. Conference,2022,Florida International,2,6,8,0.25
vs. Non-Conference,2022,Florida International,2,2,4,0.5
vs. Ranked (AP),2022,Florida International,0,0,0,
vs. Unranked (AP),2022,Florida International,4,8,12,0.3333333333333333
vs. FBS (I-A),2022,Florida International,3,8,11,0.2727272727272727
vs. FCS (I-AA),2022,Florida International,1,0,1,1.0
vs. FBS Winning,2022,Florida International,1,3,4,0.25
vs. FBS Non-Winning,2022,Florida International,2,5,7,0.2857142857142857
vs. BCS AQ,2022,Florida International,0,0,0,
vs. BCS non-AQ,2022,Florida International,3,8,11,0.2727272727272727
vs. FBS Power 5,2022,Florida International,0,0,0,
vs. FBS non-Power 5,2022,Florida International,3,8,11,0.2727272727272727
in August/September,2022,Florida International,1,2,3,0.3333333333333333
in October,2022,Florida International,3,2,5,0.6
in November,2022,Florida International,0,4,4,0.0
in December/January,2022,Florida International,0,0,0,
All Games,2009,Florida State,7,6,13,0.5384615384615384
at Home,2009,Florida State,3,3,6,0.5
on Road/Neutral Site,2009,Florida State,4,3,7,0.5714285714285714
vs. Conference,2009,Florida State,4,4,8,0.5
vs. Non-Conference,2009,Florida State,3,2,5,0.6
vs. Ranked (AP),2009,Florida State,2,4,6,0.3333333333333333
vs. Unranked (AP),2009,Florida State,5,2,7,0.7142857142857143
vs. FBS (I-A),2009,Florida State,6,6,12,0.5
vs. FCS (I-AA),2009,Florida State,1,0,1,1.0
vs. FBS Winning,2009,Florida State,3,6,9,0.3333333333333333
vs. FBS Non-Winning,2009,Florida State,3,0,3,1.0
vs. BCS AQ,2009,Florida State,5,6,11,0.45454545454545453
vs. BCS non-AQ,2009,Florida State,1,0,1,1.0
vs. FBS Power 5,2009,Florida State,4,5,9,0.4444444444444444
vs. FBS non-Power 5,2009,Florida State,2,1,3,0.6666666666666666
in August/September,2009,Florida State,2,2,4,0.5
in October,2009,Florida State,2,2,4,0.5
in November,2009,Florida State,2,2,4,0.5
in December/January,2009,Florida State,1,0,1,1.0
All Games,2010,Florida State,10,4,14,0.7142857142857143
at Home,2010,Florida State,6,1,7,0.8571428571428571
on Road/Neutral Site,2010,Florida State,4,3,7,0.5714285714285714
vs. Conference,2010,Florida State,6,3,9,0.6666666666666666
vs. Non-Conference,2010,Florida State,4,1,5,0.8
vs. Ranked (AP),2010,Florida State,2,3,5,0.4
vs. Unranked (AP),2010,Florida State,8,1,9,0.8888888888888888
vs. FBS (I-A),2010,Florida State,9,4,13,0.6923076923076923
vs. FCS (I-AA),2010,Florida State,1,0,1,1.0
vs. FBS Winning,2010,Florida State,6,4,10,0.6
vs. FBS Non-Winning,2010,Florida State,3,0,3,1.0
vs. BCS AQ,2010,Florida State,8,4,12,0.6666666666666666
vs. BCS non-AQ,2010,Florida State,1,0,1,1.0
vs. FBS Power 5,2010,Florida State,8,4,12,0.6666666666666666
vs. FBS non-Power 5,2010,Florida State,1,0,1,1.0
in August/September,2010,Florida State,3,1,4,0.75
in October,2010,Florida State,3,1,4,0.75
in November,2010,Florida State,3,1,4,0.75
in December/January,2010,Florida State,1,1,2,0.5
All Games,2011,Florida State,9,4,13,0.6923076923076923
at Home,2011,Florida State,5,2,7,0.7142857142857143
on Road/Neutral Site,2011,Florida State,4,2,6,0.6666666666666666
vs. Conference,2011,Florida State,5,3,8,0.625
vs. Non-Conference,2011,Florida State,4,1,5,0.8
vs. Ranked (AP),2011,Florida State,0,2,2,0.0
vs. Unranked (AP),2011,Florida State,9,2,11,0.8181818181818182
vs. FBS (I-A),2011,Florida State,8,4,12,0.6666666666666666
vs. FCS (I-AA),2011,Florida State,1,0,1,1.0
vs. FBS Winning,2011,Florida State,3,3,6,0.5
vs. FBS Non-Winning,2011,Florida State,5,1,6,0.8333333333333334
vs. BCS AQ,2011,Florida State,7,4,11,0.6363636363636364
vs. BCS non-AQ,2011,Florida State,1,0,1,1.0
vs. FBS Power 5,2011,Florida State,6,4,10,0.6
vs. FBS non-Power 5,2011,Florida State,2,0,2,1.0
in August/September,2011,Florida State,2,2,4,0.5
in October,2011,Florida State,3,1,4,0.75
in November,2011,Florida State,3,1,4,0.75
in December/January,2011,Florida State,1,0,1,1.0
All Games,2012,Florida State,12,2,14,0.8571428571428571
at Home,2012,Florida State,6,1,7,0.8571428571428571
on Road/Neutral Site,2012,Florida State,6,1,7,0.8571428571428571
vs. Conference,2012,Florida State,8,1,9,0.8888888888888888
vs. Non-Conference,2012,Florida State,4,1,5,0.8
vs. Ranked (AP),2012,Florida State,2,1,3,0.6666666666666666
vs. Unranked (AP),2012,Florida State,10,1,11,0.9090909090909091
vs. FBS (I-A),2012,Florida State,10,2,12,0.8333333333333334
vs. FCS (I-AA),2012,Florida State,2,0,2,1.0
vs. FBS Winning,2012,Florida State,4,2,6,0.6666666666666666
vs. FBS Non-Winning,2012,Florida State,6,0,6,1.0
vs. BCS AQ,2012,Florida State,9,2,11,0.8181818181818182
vs. BCS non-AQ,2012,Florida State,1,0,1,1.0
vs. FBS Power 5,2012,Florida State,8,2,10,0.8
vs. FBS non-Power 5,2012,Florida State,2,0,2,1.0
in August/September,2012,Florida State,5,0,5,1.0
in October,2012,Florida State,3,1,4,0.75
in November,2012,Florida State,2,1,3,0.6666666666666666
in December/January,2012,Florida State,2,0,2,1.0
All Games,2013,Florida State,14,0,14,1.0
at Home,2013,Florida State,7,0,7,1.0
on Road/Neutral Site,2013,Florida State,7,0,7,1.0
vs. Conference,2013,Florida State,9,0,9,1.0
vs. Non-Conference,2013,Florida State,5,0,5,1.0
vs. Ranked (AP),2013,Florida State,3,0,3,1.0
vs. Unranked (AP),2013,Florida State,11,0,11,1.0
vs. FBS (I-A),2013,Florida State,13,0,13,1.0
vs. FCS (I-AA),2013,Florida State,1,0,1,1.0
vs. FBS Winning,2013,Florida State,8,0,8,1.0
vs. FBS Non-Winning,2013,Florida State,5,0,5,1.0
vs. BCS AQ,2013,Florida State,11,0,11,1.0
vs. BCS non-AQ,2013,Florida State,2,0,2,1.0
vs. FBS Power 5,2013,Florida State,11,0,11,1.0
vs. FBS non-Power 5,2013,Florida State,2,0,2,1.0
in August/September,2013,Florida State,4,0,4,1.0
in October,2013,Florida State,3,0,3,1.0
in November,2013,Florida State,5,0,5,1.0
in December/January,2013,Florida State,2,0,2,1.0
All Games,2014,Florida State,13,1,14,0.9285714285714286
at Home,2014,Florida State,7,0,7,1.0
on Road/Neutral Site,2014,Florida State,6,1,7,0.8571428571428571
vs. Conference,2014,Florida State,9,0,9,1.0
vs. Non-Conference,2014,Florida State,4,1,5,0.8
vs. Ranked (AP),2014,Florida State,3,1,4,0.75
vs. Unranked (AP),2014,Florida State,10,0,10,1.0
vs. FBS (I-A),2014,Florida State,12,1,13,0.9230769230769231
vs. FCS (I-AA),2014,Florida State,1,0,1,1.0
vs. FBS Winning,2014,Florida State,8,1,9,0.8888888888888888
vs. FBS Non-Winning,2014,Florida State,4,0,4,1.0
vs. BCS AQ,2014,Florida State,12,1,13,0.9230769230769231
vs. BCS non-AQ,2014,Florida State,0,0,0,
vs. FBS Power 5,2014,Florida State,11,1,12,0.9166666666666666
vs. FBS non-Power 5,2014,Florida State,1,0,1,1.0
in August/September,2014,Florida State,4,0,4,1.0
in October,2014,Florida State,4,0,4,1.0
in November,2014,Florida State,4,0,4,1.0
in December/January,2014,Florida State,1,1,2,0.5
All Games,2015,Florida State,10,3,13,0.7692307692307693
at Home,2015,Florida State,7,0,7,1.0
on Road/Neutral Site,2015,Florida State,3,3,6,0.5
vs. Conference,2015,Florida State,6,2,8,0.75
vs. Non-Conference,2015,Florida State,4,1,5,0.8
vs. Ranked (AP),2015,Florida State,1,2,3,0.3333333333333333
vs. Unranked (AP),2015,Florida State,9,1,10,0.9
vs. FBS (I-A),2015,Florida State,9,3,12,0.75
vs. FCS (I-AA),2015,Florida State,1,0,1,1.0
vs. FBS Winning,2015,Florida State,5,2,7,0.7142857142857143
vs. FBS Non-Winning,2015,Florida State,4,1,5,0.8
vs. BCS AQ,2015,Florida State,8,3,11,0.7272727272727273
vs. BCS non-AQ,2015,Florida State,1,0,1,1.0
vs. FBS Power 5,2015,Florida State,7,2,9,0.7777777777777778
vs. FBS non-Power 5,2015,Florida State,2,1,3,0.6666666666666666
in August/September,2015,Florida State,3,0,3,1.0
in October,2015,Florida State,4,1,5,0.8
in November,2015,Florida State,3,1,4,0.75
in December/January,2015,Florida State,0,1,1,0.0
All Games,2016,Florida State,10,3,13,0.7692307692307693
at Home,2016,Florida State,4,2,6,0.6666666666666666
on Road/Neutral Site,2016,Florida State,6,1,7,0.8571428571428571
vs. Conference,2016,Florida State,5,3,8,0.625
vs. Non-Conference,2016,Florida State,5,0,5,1.0
vs. Ranked (AP),2016,Florida State,3,2,5,0.6
vs. Unranked (AP),2016,Florida State,7,1,8,0.875
vs. FBS (I-A),2016,Florida State,9,3,12,0.75
vs. FCS (I-AA),2016,Florida State,1,0,1,1.0
vs. FBS Winning,2016,Florida State,7,3,10,0.7
vs. FBS Non-Winning,2016,Florida State,2,0,2,1.0
vs. BCS AQ,2016,Florida State,9,3,12,0.75
vs. BCS non-AQ,2016,Florida State,0,0,0,
vs. FBS Power 5,2016,Florida State,8,3,11,0.7272727272727273
vs. FBS non-Power 5,2016,Florida State,1,0,1,1.0
in August/September,2016,Florida State,3,1,4,0.75
in October,2016,Florida State,2,2,4,0.5
in November,2016,Florida State,4,0,4,1.0
in December/January,2016,Florida State,1,0,1,1.0
All Games,2017,Florida State,7,6,13,0.5384615384615384
at Home,2017,Florida State,3,3,6,0.5
on Road/Neutral Site,2017,Florida State,4,3,7,0.5714285714285714
vs. Conference,2017,Florida State,3,5,8,0.375
vs. Non-Conference,2017,Florida State,4,1,5,0.8
vs. Ranked (AP),2017,Florida State,0,4,4,0.0
vs. Unranked (AP),2017,Florida State,7,2,9,0.7777777777777778
vs. FBS (I-A),2017,Florida State,6,6,12,0.5
vs. FCS (I-AA),2017,Florida State,1,0,1,1.0
vs. FBS Winning,2017,Florida State,3,6,9,0.3333333333333333
vs. FBS Non-Winning,2017,Florida State,3,0,3,1.0
vs. BCS AQ,2017,Florida State,4,6,10,0.4
vs. BCS non-AQ,2017,Florida State,2,0,2,1.0
vs. FBS Power 5,2017,Florida State,4,6,10,0.4
vs. FBS non-Power 5,2017,Florida State,2,0,2,1.0
in August/September,2017,Florida State,1,2,3,0.3333333333333333
in October,2017,Florida State,1,3,4,0.25
in November,2017,Florida State,3,1,4,0.75
in December/January,2017,Florida State,2,0,2,1.0
All Games,2018,Florida State,5,7,12,0.4166666666666667
at Home,2018,Florida State,4,3,7,0.5714285714285714
on Road/Neutral Site,2018,Florida State,1,4,5,0.2
vs. Conference,2018,Florida State,3,5,8,0.375
vs. Non-Conference,2018,Florida State,2,2,4,0.5
vs. Ranked (AP),2018,Florida State,0,4,4,0.0
vs. Unranked (AP),2018,Florida State,5,3,8,0.625
vs. FBS (I-A),2018,Florida State,4,7,11,0.36363636363636365
vs. FCS (I-AA),2018,Florida State,1,0,1,1.0
vs. FBS Winning,2018,Florida State,3,6,9,0.3333333333333333
vs. FBS Non-Winning,2018,Florida State,1,1,2,0.5
vs. BCS AQ,2018,Florida State,3,7,10,0.3
vs. BCS non-AQ,2018,Florida State,1,0,1,1.0
vs. FBS Power 5,2018,Florida State,3,6,9,0.3333333333333333
vs. FBS non-Power 5,2018,Florida State,1,1,2,0.5
in August/September,2018,Florida State,3,2,5,0.6
in October,2018,Florida State,1,2,3,0.3333333333333333
in November,2018,Florida State,1,3,4,0.25
in December/January,2018,Florida State,0,0,0,
All Games,2019,Florida State,6,7,13,0.46153846153846156
at Home,2019,Florida State,5,2,7,0.7142857142857143
on Road/Neutral Site,2019,Florida State,1,5,6,0.16666666666666666
vs. Conference,2019,Florida State,4,4,8,0.5
vs. Non-Conference,2019,Florida State,2,3,5,0.4
vs. Ranked (AP),2019,Florida State,0,3,3,0.0
vs. Unranked (AP),2019,Florida State,6,4,10,0.6
vs. FBS (I-A),2019,Florida State,5,7,12,0.4166666666666667
vs. FCS (I-AA),2019,Florida State,1,0,1,1.0
vs. FBS Winning,2019,Florida State,1,6,7,0.14285714285714285
vs. FBS Non-Winning,2019,Florida State,4,1,5,0.8
vs. BCS AQ,2019,Florida State,4,6,10,0.4
vs. BCS non-AQ,2019,Florida State,1,1,2,0.5
vs. FBS Power 5,2019,Florida State,4,6,10,0.4
vs. FBS non-Power 5,2019,Florida State,1,1,2,0.5
in August/September,2019,Florida State,3,2,5,0.6
in October,2019,Florida State,1,2,3,0.3333333333333333
in November,2019,Florida State,2,2,4,0.5
in December/January,2019,Florida State,0,1,1,0.0
All Games,2020,Florida State,3,6,9,0.3333333333333333
at Home,2020,Florida State,3,2,5,0.6
on Road/Neutral Site,2020,Florida State,0,4,4,0.0
vs. Conference,2020,Florida State,2,6,8,0.25
vs. Non-Conference,2020,Florida State,1,0,1,1.0
vs. Ranked (AP),2020,Florida State,1,3,4,0.25
vs. Unranked (AP),2020,Florida State,2,3,5,0.4
vs. FBS (I-A),2020,Florida State,2,6,8,0.25
vs. FCS (I-AA),2020,Florida State,1,0,1,1.0
vs. FBS Winning,2020,Florida State,1,4,5,0.2
vs. FBS Non-Winning,2020,Florida State,1,2,3,0.3333333333333333
vs. BCS AQ,2020,Florida State,2,6,8,0.25
vs. BCS non-AQ,2020,Florida State,0,0,0,
vs. FBS Power 5,2020,Florida State,2,6,8,0.25
vs. FBS non-Power 5,2020,Florida State,0,0,0,
in August/September,2020,Florida State,0,2,2,0.0
in October,2020,Florida State,2,2,4,0.5
in November,2020,Florida State,0,2,2,0.0
in December/January,2020,Florida State,1,0,1,1.0
All Games,2021,Florida State,5,7,12,0.4166666666666667
at Home,2021,Florida State,3,4,7,0.42857142857142855
on Road/Neutral Site,2021,Florida State,2,3,5,0.4
vs. Conference,2021,Florida State,4,4,8,0.5
vs. Non-Conference,2021,Florida State,1,3,4,0.25
vs. Ranked (AP),2021,Florida State,0,4,4,0.0
vs. Unranked (AP),2021,Florida State,5,3,8,0.625
vs. FBS (I-A),2021,Florida State,5,6,11,0.45454545454545453
vs. FCS (I-AA),2021,Florida State,0,1,1,0.0
vs. FBS Winning,2021,Florida State,1,4,5,0.2
vs. FBS Non-Winning,2021,Florida State,4,2,6,0.6666666666666666
vs. BCS AQ,2021,Florida State,4,6,10,0.4
vs. BCS non-AQ,2021,Florida State,1,0,1,1.0
vs. FBS Power 5,2021,Florida State,4,5,9,0.4444444444444444
vs. FBS non-Power 5,2021,Florida State,1,1,2,0.5
in August/September,2021,Florida State,0,4,4,0.0
in October,2021,Florida State,3,1,4,0.75
in November,2021,Florida State,2,2,4,0.5
in December/January,2021,Florida State,0,0,0,
All Games,2022,Florida State,10,3,13,0.7692307692307693
at Home,2022,Florida State,5,2,7,0.7142857142857143
on Road/Neutral Site,2022,Florida State,5,1,6,0.8333333333333334
vs. Conference,2022,Florida State,5,3,8,0.625
vs. Non-Conference,2022,Florida State,5,0,5,1.0
vs. Ranked (AP),2022,Florida State,1,1,2,0.5
vs. Unranked (AP),2022,Florida State,9,2,11,0.8181818181818182
vs. FBS (I-A),2022,Florida State,9,3,12,0.75
vs. FCS (I-AA),2022,Florida State,1,0,1,1.0
vs. FBS Winning,2022,Florida State,3,3,6,0.5
vs. FBS Non-Winning,2022,Florida State,6,0,6,1.0
vs. BCS AQ,2022,Florida State,8,3,11,0.7272727272727273
vs. BCS non-AQ,2022,Florida State,1,0,1,1.0
vs. FBS Power 5,2022,Florida State,8,3,11,0.7272727272727273
vs. FBS non-Power 5,2022,Florida State,1,0,1,1.0
in August/September,2022,Florida State,4,0,4,1.0
in October,2022,Florida State,1,3,4,0.25
in November,2022,Florida State,4,0,4,1.0
in December/January,2022,Florida State,1,0,1,1.0
All Games,2009,Fresno State,8,5,13,0.6153846153846154
at Home,2009,Fresno State,4,1,5,0.8
on Road/Neutral Site,2009,Fresno State,4,4,8,0.5
vs. Conference,2009,Fresno State,6,2,8,0.75
vs. Non-Conference,2009,Fresno State,2,3,5,0.4
vs. Ranked (AP),2009,Fresno State,0,3,3,0.0
vs. Unranked (AP),2009,Fresno State,8,2,10,0.8
vs. FBS (I-A),2009,Fresno State,7,5,12,0.5833333333333334
vs. FCS (I-AA),2009,Fresno State,1,0,1,1.0
vs. FBS Winning,2009,Fresno State,1,5,6,0.16666666666666666
vs. FBS Non-Winning,2009,Fresno State,6,0,6,1.0
vs. BCS AQ,2009,Fresno State,1,2,3,0.3333333333333333
vs. BCS non-AQ,2009,Fresno State,6,3,9,0.6666666666666666
vs. FBS Power 5,2009,Fresno State,1,1,2,0.5
vs. FBS non-Power 5,2009,Fresno State,6,4,10,0.6
in August/September,2009,Fresno State,1,3,4,0.25
in October,2009,Fresno State,4,0,4,1.0
in November,2009,Fresno State,2,1,3,0.6666666666666666
in December/January,2009,Fresno State,1,1,2,0.5
All Games,2010,Fresno State,8,5,13,0.6153846153846154
at Home,2010,Fresno State,5,2,7,0.7142857142857143
on Road/Neutral Site,2010,Fresno State,3,3,6,0.5
vs. Conference,2010,Fresno State,5,3,8,0.625
vs. Non-Conference,2010,Fresno State,3,2,5,0.6
vs. Ranked (AP),2010,Fresno State,0,2,2,0.0
vs. Unranked (AP),2010,Fresno State,8,3,11,0.7272727272727273
vs. FBS (I-A),2010,Fresno State,7,5,12,0.5833333333333334
vs. FCS (I-AA),2010,Fresno State,1,0,1,1.0
vs. FBS Winning,2010,Fresno State,1,4,5,0.2
vs. FBS Non-Winning,2010,Fresno State,6,1,7,0.8571428571428571
vs. BCS AQ,2010,Fresno State,2,1,3,0.6666666666666666
vs. BCS non-AQ,2010,Fresno State,5,4,9,0.5555555555555556
vs. FBS Power 5,2010,Fresno State,1,1,2,0.5
vs. FBS non-Power 5,2010,Fresno State,6,4,10,0.6
in August/September,2010,Fresno State,2,1,3,0.6666666666666666
in October,2010,Fresno State,3,1,4,0.75
in November,2010,Fresno State,2,2,4,0.5
in December/January,2010,Fresno State,1,1,2,0.5
All Games,2011,Fresno State,4,9,13,0.3076923076923077
at Home,2011,Fresno State,2,4,6,0.3333333333333333
on Road/Neutral Site,2011,Fresno State,2,5,7,0.2857142857142857
vs. Conference,2011,Fresno State,3,4,7,0.42857142857142855
vs. Non-Conference,2011,Fresno State,1,5,6,0.16666666666666666
vs. Ranked (AP),2011,Fresno State,0,2,2,0.0
vs. Unranked (AP),2011,Fresno State,4,7,11,0.36363636363636365
vs. FBS (I-A),2011,Fresno State,3,9,12,0.25
vs. FCS (I-AA),2011,Fresno State,1,0,1,1.0
vs. FBS Winning,2011,Fresno State,1,6,7,0.14285714285714285
vs. FBS Non-Winning,2011,Fresno State,2,3,5,0.4
vs. BCS AQ,2011,Fresno State,0,3,3,0.0
vs. BCS non-AQ,2011,Fresno State,3,6,9,0.3333333333333333
vs. FBS Power 5,2011,Fresno State,0,3,3,0.0
vs. FBS non-Power 5,2011,Fresno State,3,6,9,0.3333333333333333
in August/September,2011,Fresno State,2,2,4,0.5
in October,2011,Fresno State,1,3,4,0.25
in November,2011,Fresno State,1,3,4,0.25
in December/January,2011,Fresno State,0,1,1,0.0
All Games,2012,Fresno State,9,4,13,0.6923076923076923
at Home,2012,Fresno State,6,0,6,1.0
on Road/Neutral Site,2012,Fresno State,3,4,7,0.42857142857142855
vs. Conference,2012,Fresno State,7,1,8,0.875
vs. Non-Conference,2012,Fresno State,2,3,5,0.4
vs. Ranked (AP),2012,Fresno State,0,2,2,0.0
vs. Unranked (AP),2012,Fresno State,9,2,11,0.8181818181818182
vs. FBS (I-A),2012,Fresno State,8,4,12,0.6666666666666666
vs. FCS (I-AA),2012,Fresno State,1,0,1,1.0
vs. FBS Winning,2012,Fresno State,2,4,6,0.3333333333333333
vs. FBS Non-Winning,2012,Fresno State,6,0,6,1.0
vs. BCS AQ,2012,Fresno State,1,1,2,0.5
vs. BCS non-AQ,2012,Fresno State,7,3,10,0.7
vs. FBS Power 5,2012,Fresno State,1,1,2,0.5
vs. FBS non-Power 5,2012,Fresno State,7,3,10,0.7
in August/September,2012,Fresno State,3,2,5,0.6
in October,2012,Fresno State,3,1,4,0.75
in November,2012,Fresno State,3,0,3,1.0
in December/January,2012,Fresno State,0,1,1,0.0
All Games,2013,Fresno State,11,2,13,0.8461538461538461
at Home,2013,Fresno State,7,0,7,1.0
on Road/Neutral Site,2013,Fresno State,4,2,6,0.6666666666666666
vs. Conference,2013,Fresno State,8,1,9,0.8888888888888888
vs. Non-Conference,2013,Fresno State,3,1,4,0.75
vs. Ranked (AP),2013,Fresno State,0,1,1,0.0
vs. Unranked (AP),2013,Fresno State,11,1,12,0.9166666666666666
vs. FBS (I-A),2013,Fresno State,10,2,12,0.8333333333333334
vs. FCS (I-AA),2013,Fresno State,1,0,1,1.0
vs. FBS Winning,2013,Fresno State,4,1,5,0.8
vs. FBS Non-Winning,2013,Fresno State,6,1,7,0.8571428571428571
vs. BCS AQ,2013,Fresno State,1,1,2,0.5
vs. BCS non-AQ,2013,Fresno State,9,1,10,0.9
vs. FBS Power 5,2013,Fresno State,0,1,1,0.0
vs. FBS non-Power 5,2013,Fresno State,10,1,11,0.9090909090909091
in August/September,2013,Fresno State,4,0,4,1.0
in October,2013,Fresno State,3,0,3,1.0
in November,2013,Fresno State,3,1,4,0.75
in December/January,2013,Fresno State,1,1,2,0.5
All Games,2014,Fresno State,6,8,14,0.42857142857142855
at Home,2014,Fresno State,4,2,6,0.6666666666666666
on Road/Neutral Site,2014,Fresno State,2,6,8,0.25
vs. Conference,2014,Fresno State,5,4,9,0.5555555555555556
vs. Non-Conference,2014,Fresno State,1,4,5,0.2
vs. Ranked (AP),2014,Fresno State,0,4,4,0.0
vs. Unranked (AP),2014,Fresno State,6,4,10,0.6
vs. FBS (I-A),2014,Fresno State,5,8,13,0.38461538461538464
vs. FCS (I-AA),2014,Fresno State,1,0,1,1.0
vs. FBS Winning,2014,Fresno State,2,6,8,0.25
vs. FBS Non-Winning,2014,Fresno State,3,2,5,0.6
vs. BCS AQ,2014,Fresno State,0,3,3,0.0
vs. BCS non-AQ,2014,Fresno State,5,5,10,0.5
vs. FBS Power 5,2014,Fresno State,0,3,3,0.0
vs. FBS non-Power 5,2014,Fresno State,5,5,10,0.5
in August/September,2014,Fresno State,2,3,5,0.4
in October,2014,Fresno State,1,2,3,0.3333333333333333
in November,2014,Fresno State,3,1,4,0.75
in December/January,2014,Fresno State,0,2,2,0.0
All Games,2015,Fresno State,3,9,12,0.25
at Home,2015,Fresno State,2,4,6,0.3333333333333333
on Road/Neutral Site,2015,Fresno State,1,5,6,0.16666666666666666
vs. Conference,2015,Fresno State,2,6,8,0.25
vs. Non-Conference,2015,Fresno State,1,3,4,0.25
vs. Ranked (AP),2015,Fresno State,0,2,2,0.0
vs. Unranked (AP),2015,Fresno State,3,7,10,0.3
vs. FBS (I-A),2015,Fresno State,2,9,11,0.18181818181818182
vs. FCS (I-AA),2015,Fresno State,1,0,1,1.0
vs. FBS Winning,2015,Fresno State,0,7,7,0.0
vs. FBS Non-Winning,2015,Fresno State,2,2,4,0.5
vs. BCS AQ,2015,Fresno State,0,2,2,0.0
vs. BCS non-AQ,2015,Fresno State,2,7,9,0.2222222222222222
vs. FBS Power 5,2015,Fresno State,0,2,2,0.0
vs. FBS non-Power 5,2015,Fresno State,2,7,9,0.2222222222222222
in August/September,2015,Fresno State,1,3,4,0.25
in October,2015,Fresno State,1,3,4,0.25
in November,2015,Fresno State,1,3,4,0.25
in December/January,2015,Fresno State,0,0,0,
All Games,2016,Fresno State,1,11,12,0.08333333333333333
at Home,2016,Fresno State,1,5,6,0.16666666666666666
on Road/Neutral Site,2016,Fresno State,0,6,6,0.0
vs. Conference,2016,Fresno State,0,8,8,0.0
vs. Non-Conference,2016,Fresno State,1,3,4,0.25
vs. Ranked (AP),2016,Fresno State,0,1,1,0.0
vs. Unranked (AP),2016,Fresno State,1,10,11,0.09090909090909091
vs. FBS (I-A),2016,Fresno State,0,11,11,0.0
vs. FCS (I-AA),2016,Fresno State,1,0,1,1.0
vs. FBS Winning,2016,Fresno State,0,6,6,0.0
vs. FBS Non-Winning,2016,Fresno State,0,5,5,0.0
vs. BCS AQ,2016,Fresno State,0,2,2,0.0
vs. BCS non-AQ,2016,Fresno State,0,9,9,0.0
vs. FBS Power 5,2016,Fresno State,0,1,1,0.0
vs. FBS non-Power 5,2016,Fresno State,0,10,10,0.0
in August/September,2016,Fresno State,1,3,4,0.25
in October,2016,Fresno State,0,5,5,0.0
in November,2016,Fresno State,0,3,3,0.0
in December/January,2016,Fresno State,0,0,0,
All Games,2017,Fresno State,10,4,14,0.7142857142857143
at Home,2017,Fresno State,5,1,6,0.8333333333333334
on Road/Neutral Site,2017,Fresno State,5,3,8,0.625
vs. Conference,2017,Fresno State,7,2,9,0.7777777777777778
vs. Non-Conference,2017,Fresno State,3,2,5,0.6
vs. Ranked (AP),2017,Fresno State,1,3,4,0.25
vs. Unranked (AP),2017,Fresno State,9,1,10,0.9
vs. FBS (I-A),2017,Fresno State,9,4,13,0.6923076923076923
vs. FCS (I-AA),2017,Fresno State,1,0,1,1.0
vs. FBS Winning,2017,Fresno State,4,3,7,0.5714285714285714
vs. FBS Non-Winning,2017,Fresno State,5,1,6,0.8333333333333334
vs. BCS AQ,2017,Fresno State,1,2,3,0.3333333333333333
vs. BCS non-AQ,2017,Fresno State,8,2,10,0.8
vs. FBS Power 5,2017,Fresno State,0,2,2,0.0
vs. FBS non-Power 5,2017,Fresno State,9,2,11,0.8181818181818182
in August/September,2017,Fresno State,2,2,4,0.5
in October,2017,Fresno State,3,1,4,0.75
in November,2017,Fresno State,4,0,4,1.0
in December/January,2017,Fresno State,1,1,2,0.5
All Games,2018,Fresno State,12,2,14,0.8571428571428571
at Home,2018,Fresno State,6,0,6,1.0
on Road/Neutral Site,2018,Fresno State,6,2,8,0.75
vs. Conference,2018,Fresno State,8,1,9,0.8888888888888888
vs. Non-Conference,2018,Fresno State,4,1,5,0.8
vs. Ranked (AP),2018,Fresno State,1,1,2,0.5
vs. Unranked (AP),2018,Fresno State,11,1,12,0.9166666666666666
vs. FBS (I-A),2018,Fresno State,11,2,13,0.8461538461538461
vs. FCS (I-AA),2018,Fresno State,1,0,1,1.0
vs. FBS Winning,2018,Fresno State,6,2,8,0.75
vs. FBS Non-Winning,2018,Fresno State,5,0,5,1.0
vs. BCS AQ,2018,Fresno State,2,1,3,0.6666666666666666
vs. BCS non-AQ,2018,Fresno State,9,1,10,0.9
vs. FBS Power 5,2018,Fresno State,2,1,3,0.6666666666666666
vs. FBS non-Power 5,2018,Fresno State,9,1,10,0.9
in August/September,2018,Fresno State,3,1,4,0.75
in October,2018,Fresno State,4,0,4,1.0
in November,2018,Fresno State,3,1,4,0.75
in December/January,2018,Fresno State,2,0,2,1.0
All Games,2019,Fresno State,4,8,12,0.3333333333333333
at Home,2019,Fresno State,2,4,6,0.3333333333333333
on Road/Neutral Site,2019,Fresno State,2,4,6,0.3333333333333333
vs. Conference,2019,Fresno State,2,6,8,0.25
vs. Non-Conference,2019,Fresno State,2,2,4,0.5
vs. Ranked (AP),2019,Fresno State,0,2,2,0.0
vs. Unranked (AP),2019,Fresno State,4,6,10,0.4
vs. FBS (I-A),2019,Fresno State,3,8,11,0.2727272727272727
vs. FCS (I-AA),2019,Fresno State,1,0,1,1.0
vs. FBS Winning,2019,Fresno State,1,6,7,0.14285714285714285
vs. FBS Non-Winning,2019,Fresno State,2,2,4,0.5
vs. BCS AQ,2019,Fresno State,0,2,2,0.0
vs. BCS non-AQ,2019,Fresno State,3,6,9,0.3333333333333333
vs. FBS Power 5,2019,Fresno State,0,2,2,0.0
vs. FBS non-Power 5,2019,Fresno State,3,6,9,0.3333333333333333
in August/September,2019,Fresno State,2,2,4,0.5
in October,2019,Fresno State,1,2,3,0.3333333333333333
in November,2019,Fresno State,1,4,5,0.2
in December/January,2019,Fresno State,0,0,0,
All Games,2020,Fresno State,3,3,6,0.5
at Home,2020,Fresno State,1,1,2,0.5
on Road/Neutral Site,2020,Fresno State,2,2,4,0.5
vs. Conference,2020,Fresno State,3,3,6,0.5
vs. Non-Conference,2020,Fresno State,0,0,0,
vs. Ranked (AP),2020,Fresno State,0,0,0,
vs. Unranked (AP),2020,Fresno State,3,3,6,0.5
vs. FBS (I-A),2020,Fresno State,3,3,6,0.5
vs. FCS (I-AA),2020,Fresno State,0,0,0,
vs. FBS Winning,2020,Fresno State,0,2,2,0.0
vs. FBS Non-Winning,2020,Fresno State,3,1,4,0.75
vs. BCS AQ,2020,Fresno State,0,0,0,
vs. BCS non-AQ,2020,Fresno State,3,3,6,0.5
vs. FBS Power 5,2020,Fresno State,0,0,0,
vs. FBS non-Power 5,2020,Fresno State,3,3,6,0.5
in August/September,2020,Fresno State,0,0,0,
in October,2020,Fresno State,1,1,2,0.5
in November,2020,Fresno State,2,0,2,1.0
in December/January,2020,Fresno State,0,2,2,0.0
All Games,2021,Fresno State,10,3,13,0.7692307692307693
at Home,2021,Fresno State,5,1,6,0.8333333333333334
on Road/Neutral Site,2021,Fresno State,5,2,7,0.7142857142857143
vs. Conference,2021,Fresno State,6,2,8,0.75
vs. Non-Conference,2021,Fresno State,4,1,5,0.8
vs. Ranked (AP),2021,Fresno State,1,1,2,0.5
vs. Unranked (AP),2021,Fresno State,9,2,11,0.8181818181818182
vs. FBS (I-A),2021,Fresno State,9,3,12,0.75
vs. FCS (I-AA),2021,Fresno State,1,0,1,1.0
vs. FBS Winning,2021,Fresno State,5,2,7,0.7142857142857143
vs. FBS Non-Winning,2021,Fresno State,4,1,5,0.8
vs. BCS AQ,2021,Fresno State,1,1,2,0.5
vs. BCS non-AQ,2021,Fresno State,8,2,10,0.8
vs. FBS Power 5,2021,Fresno State,1,1,2,0.5
vs. FBS non-Power 5,2021,Fresno State,8,2,10,0.8
in August/September,2021,Fresno State,4,1,5,0.8
in October,2021,Fresno State,3,1,4,0.75
in November,2021,Fresno State,2,1,3,0.6666666666666666
in December/January,2021,Fresno State,1,0,1,1.0
All Games,2022,Fresno State,10,4,14,0.7142857142857143
at Home,2022,Fresno State,5,1,6,0.8333333333333334
on Road/Neutral Site,2022,Fresno State,5,3,8,0.625
vs. Conference,2022,Fresno State,8,1,9,0.8888888888888888
vs. Non-Conference,2022,Fresno State,2,3,5,0.4
vs. Ranked (AP),2022,Fresno State,0,2,2,0.0
vs. Unranked (AP),2022,Fresno State,10,2,12,0.8333333333333334
vs. FBS (I-A),2022,Fresno State,9,4,13,0.6923076923076923
vs. FCS (I-AA),2022,Fresno State,1,0,1,1.0
vs. FBS Winning,2022,Fresno State,5,3,8,0.625
vs. FBS Non-Winning,2022,Fresno State,4,1,5,0.8
vs. BCS AQ,2022,Fresno State,1,2,3,0.3333333333333333
vs. BCS non-AQ,2022,Fresno State,8,2,10,0.8
vs. FBS Power 5,2022,Fresno State,1,2,3,0.3333333333333333
vs. FBS non-Power 5,2022,Fresno State,8,2,10,0.8
in August/September,2022,Fresno State,1,2,3,0.3333333333333333
in October,2022,Fresno State,3,2,5,0.6
in November,2022,Fresno State,4,0,4,1.0
in December/January,2022,Fresno State,2,0,2,1.0
All Games,2009,Georgia,8,5,13,0.6153846153846154
at Home,2009,Georgia,4,2,6,0.6666666666666666
on Road/Neutral Site,2009,Georgia,4,3,7,0.5714285714285714
vs. Conference,2009,Georgia,4,4,8,0.5
vs. Non-Conference,2009,Georgia,4,1,5,0.8
vs. Ranked (AP),2009,Georgia,1,2,3,0.3333333333333333
vs. Unranked (AP),2009,Georgia,7,3,10,0.7
vs. FBS (I-A),2009,Georgia,7,5,12,0.5833333333333334
vs. FCS (I-AA),2009,Georgia,1,0,1,1.0
vs. FBS Winning,2009,Georgia,4,5,9,0.4444444444444444
vs. FBS Non-Winning,2009,Georgia,3,0,3,1.0
vs. BCS AQ,2009,Georgia,7,5,12,0.5833333333333334
vs. BCS non-AQ,2009,Georgia,0,0,0,
vs. FBS Power 5,2009,Georgia,7,5,12,0.5833333333333334
vs. FBS non-Power 5,2009,Georgia,0,0,0,
in August/September,2009,Georgia,3,1,4,0.75
in October,2009,Georgia,1,3,4,0.25
in November,2009,Georgia,3,1,4,0.75
in December/January,2009,Georgia,1,0,1,1.0
All Games,2010,Georgia,6,7,13,0.46153846153846156
at Home,2010,Georgia,5,1,6,0.8333333333333334
on Road/Neutral Site,2010,Georgia,1,6,7,0.14285714285714285
vs. Conference,2010,Georgia,3,5,8,0.375
vs. Non-Conference,2010,Georgia,3,2,5,0.6
vs. Ranked (AP),2010,Georgia,0,5,5,0.0
vs. Unranked (AP),2010,Georgia,6,2,8,0.75
vs. FBS (I-A),2010,Georgia,5,7,12,0.4166666666666667
vs. FCS (I-AA),2010,Georgia,1,0,1,1.0
vs. FBS Winning,2010,Georgia,0,6,6,0.0
vs. FBS Non-Winning,2010,Georgia,5,1,6,0.8333333333333334
vs. BCS AQ,2010,Georgia,4,6,10,0.4
vs. BCS non-AQ,2010,Georgia,1,1,2,0.5
vs. FBS Power 5,2010,Georgia,4,6,10,0.4
vs. FBS non-Power 5,2010,Georgia,1,1,2,0.5
in August/September,2010,Georgia,1,3,4,0.25
in October,2010,Georgia,3,2,5,0.6
in November,2010,Georgia,2,1,3,0.6666666666666666
in December/January,2010,Georgia,0,1,1,0.0
All Games,2011,Georgia,10,4,14,0.7142857142857143
at Home,2011,Georgia,5,1,6,0.8333333333333334
on Road/Neutral Site,2011,Georgia,5,3,8,0.625
vs. Conference,2011,Georgia,7,2,9,0.7777777777777778
vs. Non-Conference,2011,Georgia,3,2,5,0.6
vs. Ranked (AP),2011,Georgia,0,4,4,0.0
vs. Unranked (AP),2011,Georgia,10,0,10,1.0
vs. FBS (I-A),2011,Georgia,9,4,13,0.6923076923076923
vs. FCS (I-AA),2011,Georgia,1,0,1,1.0
vs. FBS Winning,2011,Georgia,4,4,8,0.5
vs. FBS Non-Winning,2011,Georgia,5,0,5,1.0
vs. BCS AQ,2011,Georgia,8,3,11,0.7272727272727273
vs. BCS non-AQ,2011,Georgia,1,1,2,0.5
vs. FBS Power 5,2011,Georgia,8,3,11,0.7272727272727273
vs. FBS non-Power 5,2011,Georgia,1,1,2,0.5
in August/September,2011,Georgia,2,2,4,0.5
in October,2011,Georgia,4,0,4,1.0
in November,2011,Georgia,4,0,4,1.0
in December/January,2011,Georgia,0,2,2,0.0
All Games,2012,Georgia,12,2,14,0.8571428571428571
at Home,2012,Georgia,7,0,7,1.0
on Road/Neutral Site,2012,Georgia,5,2,7,0.7142857142857143
vs. Conference,2012,Georgia,7,2,9,0.7777777777777778
vs. Non-Conference,2012,Georgia,5,0,5,1.0
vs. Ranked (AP),2012,Georgia,3,2,5,0.6
vs. Unranked (AP),2012,Georgia,9,0,9,1.0
vs. FBS (I-A),2012,Georgia,11,2,13,0.8461538461538461
vs. FCS (I-AA),2012,Georgia,1,0,1,1.0
vs. FBS Winning,2012,Georgia,4,2,6,0.6666666666666666
vs. FBS Non-Winning,2012,Georgia,7,0,7,1.0
vs. BCS AQ,2012,Georgia,9,2,11,0.8181818181818182
vs. BCS non-AQ,2012,Georgia,2,0,2,1.0
vs. FBS Power 5,2012,Georgia,9,2,11,0.8181818181818182
vs. FBS non-Power 5,2012,Georgia,2,0,2,1.0
in August/September,2012,Georgia,5,0,5,1.0
in October,2012,Georgia,2,1,3,0.6666666666666666
in November,2012,Georgia,4,0,4,1.0
in December/January,2012,Georgia,1,1,2,0.5
All Games,2013,Georgia,8,5,13,0.6153846153846154
at Home,2013,Georgia,5,1,6,0.8333333333333334
on Road/Neutral Site,2013,Georgia,3,4,7,0.42857142857142855
vs. Conference,2013,Georgia,5,3,8,0.625
vs. Non-Conference,2013,Georgia,3,2,5,0.6
vs. Ranked (AP),2013,Georgia,2,4,6,0.3333333333333333
vs. Unranked (AP),2013,Georgia,6,1,7,0.8571428571428571
vs. FBS (I-A),2013,Georgia,7,5,12,0.5833333333333334
vs. FCS (I-AA),2013,Georgia,1,0,1,1.0
vs. FBS Winning,2013,Georgia,4,5,9,0.4444444444444444
vs. FBS Non-Winning,2013,Georgia,3,0,3,1.0
vs. BCS AQ,2013,Georgia,6,5,11,0.5454545454545454
vs. BCS non-AQ,2013,Georgia,1,0,1,1.0
vs. FBS Power 5,2013,Georgia,6,5,11,0.5454545454545454
vs. FBS non-Power 5,2013,Georgia,1,0,1,1.0
in August/September,2013,Georgia,3,1,4,0.75
in October,2013,Georgia,1,2,3,0.3333333333333333
in November,2013,Georgia,4,1,5,0.8
in December/January,2013,Georgia,0,1,1,0.0
All Games,2014,Georgia,10,3,13,0.7692307692307693
at Home,2014,Georgia,6,1,7,0.8571428571428571
on Road/Neutral Site,2014,Georgia,4,2,6,0.6666666666666666
vs. Conference,2014,Georgia,6,2,8,0.75
vs. Non-Conference,2014,Georgia,4,1,5,0.8
vs. Ranked (AP),2014,Georgia,4,1,5,0.8
vs. Unranked (AP),2014,Georgia,6,2,8,0.75
vs. FBS (I-A),2014,Georgia,9,3,12,0.75
vs. FCS (I-AA),2014,Georgia,1,0,1,1.0
vs. FBS Winning,2014,Georgia,6,3,9,0.6666666666666666
vs. FBS Non-Winning,2014,Georgia,3,0,3,1.0
vs. BCS AQ,2014,Georgia,8,3,11,0.7272727272727273
vs. BCS non-AQ,2014,Georgia,1,0,1,1.0
vs. FBS Power 5,2014,Georgia,8,3,11,0.7272727272727273
vs. FBS non-Power 5,2014,Georgia,1,0,1,1.0
in August/September,2014,Georgia,3,1,4,0.75
in October,2014,Georgia,3,0,3,1.0
in November,2014,Georgia,3,2,5,0.6
in December/January,2014,Georgia,1,0,1,1.0
All Games,2015,Georgia,10,3,13,0.7692307692307693
at Home,2015,Georgia,6,1,7,0.8571428571428571
on Road/Neutral Site,2015,Georgia,4,2,6,0.6666666666666666
vs. Conference,2015,Georgia,5,3,8,0.625
vs. Non-Conference,2015,Georgia,5,0,5,1.0
vs. Ranked (AP),2015,Georgia,0,3,3,0.0
vs. Unranked (AP),2015,Georgia,10,0,10,1.0
vs. FBS (I-A),2015,Georgia,9,3,12,0.75
vs. FCS (I-AA),2015,Georgia,1,0,1,1.0
vs. FBS Winning,2015,Georgia,3,3,6,0.5
vs. FBS Non-Winning,2015,Georgia,6,0,6,1.0
vs. BCS AQ,2015,Georgia,7,3,10,0.7
vs. BCS non-AQ,2015,Georgia,2,0,2,1.0
vs. FBS Power 5,2015,Georgia,7,3,10,0.7
vs. FBS non-Power 5,2015,Georgia,2,0,2,1.0
in August/September,2015,Georgia,4,0,4,1.0
in October,2015,Georgia,1,3,4,0.25
in November,2015,Georgia,4,0,4,1.0
in December/January,2015,Georgia,1,0,1,1.0
All Games,2016,Georgia,8,5,13,0.6153846153846154
at Home,2016,Georgia,3,3,6,0.5
on Road/Neutral Site,2016,Georgia,5,2,7,0.7142857142857143
vs. Conference,2016,Georgia,4,4,8,0.5
vs. Non-Conference,2016,Georgia,4,1,5,0.8
vs. Ranked (AP),2016,Georgia,1,1,2,0.5
vs. Unranked (AP),2016,Georgia,7,4,11,0.6363636363636364
vs. FBS (I-A),2016,Georgia,7,5,12,0.5833333333333334
vs. FCS (I-AA),2016,Georgia,1,0,1,1.0
vs. FBS Winning,2016,Georgia,3,3,6,0.5
vs. FBS Non-Winning,2016,Georgia,4,2,6,0.6666666666666666
vs. BCS AQ,2016,Georgia,6,5,11,0.5454545454545454
vs. BCS non-AQ,2016,Georgia,1,0,1,1.0
vs. FBS Power 5,2016,Georgia,6,5,11,0.5454545454545454
vs. FBS non-Power 5,2016,Georgia,1,0,1,1.0
in August/September,2016,Georgia,3,1,4,0.75
in October,2016,Georgia,1,3,4,0.25
in November,2016,Georgia,3,1,4,0.75
in December/January,2016,Georgia,1,0,1,1.0
All Games,2017,Georgia,13,2,15,0.8666666666666667
at Home,2017,Georgia,6,0,6,1.0
on Road/Neutral Site,2017,Georgia,7,2,9,0.7777777777777778
vs. Conference,2017,Georgia,8,2,10,0.8
vs. Non-Conference,2017,Georgia,5,0,5,1.0
vs. Ranked (AP),2017,Georgia,4,2,6,0.6666666666666666
vs. Unranked (AP),2017,Georgia,9,0,9,1.0
vs. FBS (I-A),2017,Georgia,12,2,14,0.8571428571428571
vs. FCS (I-AA),2017,Georgia,1,0,1,1.0
vs. FBS Winning,2017,Georgia,8,2,10,0.8
vs. FBS Non-Winning,2017,Georgia,4,0,4,1.0
vs. BCS AQ,2017,Georgia,11,2,13,0.8461538461538461
vs. BCS non-AQ,2017,Georgia,1,0,1,1.0
vs. FBS Power 5,2017,Georgia,10,2,12,0.8333333333333334
vs. FBS non-Power 5,2017,Georgia,2,0,2,1.0
in August/September,2017,Georgia,5,0,5,1.0
in October,2017,Georgia,3,0,3,1.0
in November,2017,Georgia,3,1,4,0.75
in December/January,2017,Georgia,2,1,3,0.6666666666666666
All Games,2018,Georgia,11,3,14,0.7857142857142857
at Home,2018,Georgia,7,0,7,1.0
on Road/Neutral Site,2018,Georgia,4,3,7,0.5714285714285714
vs. Conference,2018,Georgia,7,2,9,0.7777777777777778
vs. Non-Conference,2018,Georgia,4,1,5,0.8
vs. Ranked (AP),2018,Georgia,2,3,5,0.4
vs. Unranked (AP),2018,Georgia,9,0,9,1.0
vs. FBS (I-A),2018,Georgia,10,3,13,0.7692307692307693
vs. FCS (I-AA),2018,Georgia,1,0,1,1.0
vs. FBS Winning,2018,Georgia,7,3,10,0.7
vs. FBS Non-Winning,2018,Georgia,3,0,3,1.0
vs. BCS AQ,2018,Georgia,8,3,11,0.7272727272727273
vs. BCS non-AQ,2018,Georgia,2,0,2,1.0
vs. FBS Power 5,2018,Georgia,8,3,11,0.7272727272727273
vs. FBS non-Power 5,2018,Georgia,2,0,2,1.0
in August/September,2018,Georgia,5,0,5,1.0
in October,2018,Georgia,2,1,3,0.6666666666666666
in November,2018,Georgia,4,0,4,1.0
in December/January,2018,Georgia,0,2,2,0.0
All Games,2019,Georgia,12,2,14,0.8571428571428571
at Home,2019,Georgia,6,1,7,0.8571428571428571
on Road/Neutral Site,2019,Georgia,6,1,7,0.8571428571428571
vs. Conference,2019,Georgia,7,2,9,0.7777777777777778
vs. Non-Conference,2019,Georgia,5,0,5,1.0
vs. Ranked (AP),2019,Georgia,4,1,5,0.8
vs. Unranked (AP),2019,Georgia,8,1,9,0.8888888888888888
vs. FBS (I-A),2019,Georgia,11,2,13,0.8461538461538461
vs. FCS (I-AA),2019,Georgia,1,0,1,1.0
vs. FBS Winning,2019,Georgia,8,1,9,0.8888888888888888
vs. FBS Non-Winning,2019,Georgia,3,1,4,0.75
vs. BCS AQ,2019,Georgia,10,2,12,0.8333333333333334
vs. BCS non-AQ,2019,Georgia,1,0,1,1.0
vs. FBS Power 5,2019,Georgia,9,2,11,0.8181818181818182
vs. FBS non-Power 5,2019,Georgia,2,0,2,1.0
in August/September,2019,Georgia,4,0,4,1.0
in October,2019,Georgia,2,1,3,0.6666666666666666
in November,2019,Georgia,5,0,5,1.0
in December/January,2019,Georgia,1,1,2,0.5
All Games,2020,Georgia,8,2,10,0.8
at Home,2020,Georgia,3,0,3,1.0
on Road/Neutral Site,2020,Georgia,5,2,7,0.7142857142857143
vs. Conference,2020,Georgia,7,2,9,0.7777777777777778
vs. Non-Conference,2020,Georgia,1,0,1,1.0
vs. Ranked (AP),2020,Georgia,1,2,3,0.3333333333333333
vs. Unranked (AP),2020,Georgia,7,0,7,1.0
vs. FBS (I-A),2020,Georgia,8,2,10,0.8
vs. FCS (I-AA),2020,Georgia,0,0,0,
vs. FBS Winning,2020,Georgia,2,2,4,0.5
vs. FBS Non-Winning,2020,Georgia,6,0,6,1.0
vs. BCS AQ,2020,Georgia,8,2,10,0.8
vs. BCS non-AQ,2020,Georgia,0,0,0,
vs. FBS Power 5,2020,Georgia,7,2,9,0.7777777777777778
vs. FBS non-Power 5,2020,Georgia,1,0,1,1.0
in August/September,2020,Georgia,1,0,1,1.0
in October,2020,Georgia,3,1,4,0.75
in November,2020,Georgia,2,1,3,0.6666666666666666
in December/January,2020,Georgia,2,0,2,1.0
All Games,2021,Georgia,14,1,15,0.9333333333333333
at Home,2021,Georgia,6,0,6,1.0
on Road/Neutral Site,2021,Georgia,8,1,9,0.8888888888888888
vs. Conference,2021,Georgia,9,1,10,0.9
vs. Non-Conference,2021,Georgia,5,0,5,1.0
vs. Ranked (AP),2021,Georgia,5,1,6,0.8333333333333334
vs. Unranked (AP),2021,Georgia,9,0,9,1.0
vs. FBS (I-A),2021,Georgia,13,1,14,0.9285714285714286
vs. FCS (I-AA),2021,Georgia,1,0,1,1.0
vs. FBS Winning,2021,Georgia,8,1,9,0.8888888888888888
vs. FBS Non-Winning,2021,Georgia,5,0,5,1.0
vs. BCS AQ,2021,Georgia,12,1,13,0.9230769230769231
vs. BCS non-AQ,2021,Georgia,1,0,1,1.0
vs. FBS Power 5,2021,Georgia,12,1,13,0.9230769230769231
vs. FBS non-Power 5,2021,Georgia,1,0,1,1.0
in August/September,2021,Georgia,4,0,4,1.0
in October,2021,Georgia,4,0,4,1.0
in November,2021,Georgia,4,0,4,1.0
in December/January,2021,Georgia,2,1,3,0.6666666666666666
All Games,2022,Georgia,15,0,15,1.0
at Home,2022,Georgia,7,0,7,1.0
on Road/Neutral Site,2022,Georgia,8,0,8,1.0
vs. Conference,2022,Georgia,9,0,9,1.0
vs. Non-Conference,2022,Georgia,6,0,6,1.0
vs. Ranked (AP),2022,Georgia,7,0,7,1.0
vs. Unranked (AP),2022,Georgia,8,0,8,1.0
vs. FBS (I-A),2022,Georgia,14,0,14,1.0
vs. FCS (I-AA),2022,Georgia,1,0,1,1.0
vs. FBS Winning,2022,Georgia,8,0,8,1.0
vs. FBS Non-Winning,2022,Georgia,6,0,6,1.0
vs. BCS AQ,2022,Georgia,13,0,13,1.0
vs. BCS non-AQ,2022,Georgia,1,0,1,1.0
vs. FBS Power 5,2022,Georgia,13,0,13,1.0
vs. FBS non-Power 5,2022,Georgia,1,0,1,1.0
in August/September,2022,Georgia,4,0,4,1.0
in October,2022,Georgia,4,0,4,1.0
in November,2022,Georgia,4,0,4,1.0
in December/January,2022,Georgia,3,0,3,1.0
All Games,2014,Georgia Southern,9,3,12,0.75
at Home,2014,Georgia Southern,5,0,5,1.0
on Road/Neutral Site,2014,Georgia Southern,4,3,7,0.5714285714285714
vs. Conference,2014,Georgia Southern,8,0,8,1.0
vs. Non-Conference,2014,Georgia Southern,1,3,4,0.25
vs. Ranked (AP),2014,Georgia Southern,0,1,1,0.0
vs. Unranked (AP),2014,Georgia Southern,9,2,11,0.8181818181818182
vs. FBS (I-A),2014,Georgia Southern,8,3,11,0.7272727272727273
vs. FCS (I-AA),2014,Georgia Southern,1,0,1,1.0
vs. FBS Winning,2014,Georgia Southern,2,3,5,0.4
vs. FBS Non-Winning,2014,Georgia Southern,6,0,6,1.0
vs. BCS AQ,2014,Georgia Southern,0,2,2,0.0
vs. BCS non-AQ,2014,Georgia Southern,8,1,9,0.8888888888888888
vs. FBS Power 5,2014,Georgia Southern,0,2,2,0.0
vs. FBS non-Power 5,2014,Georgia Southern,8,1,9,0.8888888888888888
in August/September,2014,Georgia Southern,3,2,5,0.6
in October,2014,Georgia Southern,4,0,4,1.0
in November,2014,Georgia Southern,2,1,3,0.6666666666666666
in December/January,2014,Georgia Southern,0,0,0,
All Games,2015,Georgia Southern,9,4,13,0.6923076923076923
at Home,2015,Georgia Southern,5,1,6,0.8333333333333334
on Road/Neutral Site,2015,Georgia Southern,4,3,7,0.5714285714285714
vs. Conference,2015,Georgia Southern,6,2,8,0.75
vs. Non-Conference,2015,Georgia Southern,3,2,5,0.6
vs. Ranked (AP),2015,Georgia Southern,0,0,0,
vs. Unranked (AP),2015,Georgia Southern,9,4,13,0.6923076923076923
vs. FBS (I-A),2015,Georgia Southern,8,4,12,0.6666666666666666
vs. FCS (I-AA),2015,Georgia Southern,1,0,1,1.0
vs. FBS Winning,2015,Georgia Southern,2,3,5,0.4
vs. FBS Non-Winning,2015,Georgia Southern,6,1,7,0.8571428571428571
vs. BCS AQ,2015,Georgia Southern,0,2,2,0.0
vs. BCS non-AQ,2015,Georgia Southern,8,2,10,0.8
vs. FBS Power 5,2015,Georgia Southern,0,2,2,0.0
vs. FBS non-Power 5,2015,Georgia Southern,8,2,10,0.8
in August/September,2015,Georgia Southern,3,1,4,0.75
in October,2015,Georgia Southern,3,1,4,0.75
in November,2015,Georgia Southern,2,1,3,0.6666666666666666
in December/January,2015,Georgia Southern,1,1,2,0.5
All Games,2016,Georgia Southern,5,7,12,0.4166666666666667
at Home,2016,Georgia Southern,3,2,5,0.6
on Road/Neutral Site,2016,Georgia Southern,2,5,7,0.2857142857142857
vs. Conference,2016,Georgia Southern,4,4,8,0.5
vs. Non-Conference,2016,Georgia Southern,1,3,4,0.25
vs. Ranked (AP),2016,Georgia Southern,0,1,1,0.0
vs. Unranked (AP),2016,Georgia Southern,5,6,11,0.45454545454545453
vs. FBS (I-A),2016,Georgia Southern,4,7,11,0.36363636363636365
vs. FCS (I-AA),2016,Georgia Southern,1,0,1,1.0
vs. FBS Winning,2016,Georgia Southern,1,4,5,0.2
vs. FBS Non-Winning,2016,Georgia Southern,3,3,6,0.5
vs. BCS AQ,2016,Georgia Southern,0,2,2,0.0
vs. BCS non-AQ,2016,Georgia Southern,4,5,9,0.4444444444444444
vs. FBS Power 5,2016,Georgia Southern,0,2,2,0.0
vs. FBS non-Power 5,2016,Georgia Southern,4,5,9,0.4444444444444444
in August/September,2016,Georgia Southern,3,1,4,0.75
in October,2016,Georgia Southern,1,3,4,0.25
in November,2016,Georgia Southern,0,3,3,0.0
in December/January,2016,Georgia Southern,1,0,1,1.0
All Games,2017,Georgia Southern,2,10,12,0.16666666666666666
at Home,2017,Georgia Southern,1,3,4,0.25
on Road/Neutral Site,2017,Georgia Southern,1,7,8,0.125
vs. Conference,2017,Georgia Southern,2,6,8,0.25
vs. Non-Conference,2017,Georgia Southern,0,4,4,0.0
vs. Ranked (AP),2017,Georgia Southern,0,1,1,0.0
vs. Unranked (AP),2017,Georgia Southern,2,9,11,0.18181818181818182
vs. FBS (I-A),2017,Georgia Southern,2,9,11,0.18181818181818182
vs. FCS (I-AA),2017,Georgia Southern,0,1,1,0.0
vs. FBS Winning,2017,Georgia Southern,0,6,6,0.0
vs. FBS Non-Winning,2017,Georgia Southern,2,3,5,0.4
vs. BCS AQ,2017,Georgia Southern,0,2,2,0.0
vs. BCS non-AQ,2017,Georgia Southern,2,7,9,0.2222222222222222
vs. FBS Power 5,2017,Georgia Southern,0,2,2,0.0
vs. FBS non-Power 5,2017,Georgia Southern,2,7,9,0.2222222222222222
in August/September,2017,Georgia Southern,0,3,3,0.0
in October,2017,Georgia Southern,0,4,4,0.0
in November,2017,Georgia Southern,2,2,4,0.5
in December/January,2017,Georgia Southern,0,1,1,0.0
All Games,2018,Georgia Southern,10,3,13,0.7692307692307693
at Home,2018,Georgia Southern,5,1,6,0.8333333333333334
on Road/Neutral Site,2018,Georgia Southern,5,2,7,0.7142857142857143
vs. Conference,2018,Georgia Southern,6,2,8,0.75
vs. Non-Conference,2018,Georgia Southern,4,1,5,0.8
vs. Ranked (AP),2018,Georgia Southern,0,1,1,0.0
vs. Unranked (AP),2018,Georgia Southern,10,2,12,0.8333333333333334
vs. FBS (I-A),2018,Georgia Southern,9,3,12,0.75
vs. FCS (I-AA),2018,Georgia Southern,1,0,1,1.0
vs. FBS Winning,2018,Georgia Southern,3,2,5,0.6
vs. FBS Non-Winning,2018,Georgia Southern,6,1,7,0.8571428571428571
vs. BCS AQ,2018,Georgia Southern,0,1,1,0.0
vs. BCS non-AQ,2018,Georgia Southern,9,2,11,0.8181818181818182
vs. FBS Power 5,2018,Georgia Southern,0,1,1,0.0
vs. FBS non-Power 5,2018,Georgia Southern,9,2,11,0.8181818181818182
in August/September,2018,Georgia Southern,3,1,4,0.75
in October,2018,Georgia Southern,4,0,4,1.0
in November,2018,Georgia Southern,2,2,4,0.5
in December/January,2018,Georgia Southern,1,0,1,1.0
All Games,2019,Georgia Southern,7,6,13,0.5384615384615384
at Home,2019,Georgia Southern,5,1,6,0.8333333333333334
on Road/Neutral Site,2019,Georgia Southern,2,5,7,0.2857142857142857
vs. Conference,2019,Georgia Southern,5,3,8,0.625
vs. Non-Conference,2019,Georgia Southern,2,3,5,0.4
vs. Ranked (AP),2019,Georgia Southern,1,2,3,0.3333333333333333
vs. Unranked (AP),2019,Georgia Southern,6,4,10,0.6
vs. FBS (I-A),2019,Georgia Southern,6,6,12,0.5
vs. FCS (I-AA),2019,Georgia Southern,1,0,1,1.0
vs. FBS Winning,2019,Georgia Southern,2,5,7,0.2857142857142857
vs. FBS Non-Winning,2019,Georgia Southern,4,1,5,0.8
vs. BCS AQ,2019,Georgia Southern,0,2,2,0.0
vs. BCS non-AQ,2019,Georgia Southern,6,4,10,0.6
vs. FBS Power 5,2019,Georgia Southern,0,2,2,0.0
vs. FBS non-Power 5,2019,Georgia Southern,6,4,10,0.6
in August/September,2019,Georgia Southern,1,3,4,0.25
in October,2019,Georgia Southern,4,0,4,1.0
in November,2019,Georgia Southern,2,2,4,0.5
in December/January,2019,Georgia Southern,0,1,1,0.0
All Games,2020,Georgia Southern,8,5,13,0.6153846153846154
at Home,2020,Georgia Southern,6,1,7,0.8571428571428571
on Road/Neutral Site,2020,Georgia Southern,2,4,6,0.3333333333333333
vs. Conference,2020,Georgia Southern,4,4,8,0.5
vs. Non-Conference,2020,Georgia Southern,4,1,5,0.8
vs. Ranked (AP),2020,Georgia Southern,0,2,2,0.0
vs. Unranked (AP),2020,Georgia Southern,8,3,11,0.7272727272727273
vs. FBS (I-A),2020,Georgia Southern,7,5,12,0.5833333333333334
vs. FCS (I-AA),2020,Georgia Southern,1,0,1,1.0
vs. FBS Winning,2020,Georgia Southern,1,5,6,0.16666666666666666
vs. FBS Non-Winning,2020,Georgia Southern,6,0,6,1.0
vs. BCS AQ,2020,Georgia Southern,0,0,0,
vs. BCS non-AQ,2020,Georgia Southern,7,5,12,0.5833333333333334
vs. FBS Power 5,2020,Georgia Southern,0,0,0,
vs. FBS non-Power 5,2020,Georgia Southern,7,5,12,0.5833333333333334
in August/September,2020,Georgia Southern,1,1,2,0.5
in October,2020,Georgia Southern,3,1,4,0.75
in November,2020,Georgia Southern,2,2,4,0.5
in December/January,2020,Georgia Southern,2,1,3,0.6666666666666666
All Games,2021,Georgia Southern,3,9,12,0.25
at Home,2021,Georgia Southern,2,4,6,0.3333333333333333
on Road/Neutral Site,2021,Georgia Southern,1,5,6,0.16666666666666666
vs. Conference,2021,Georgia Southern,2,6,8,0.25
vs. Non-Conference,2021,Georgia Southern,1,3,4,0.25
vs. Ranked (AP),2021,Georgia Southern,0,3,3,0.0
vs. Unranked (AP),2021,Georgia Southern,3,6,9,0.3333333333333333
vs. FBS (I-A),2021,Georgia Southern,2,9,11,0.18181818181818182
vs. FCS (I-AA),2021,Georgia Southern,1,0,1,1.0
vs. FBS Winning,2021,Georgia Southern,0,6,6,0.0
vs. FBS Non-Winning,2021,Georgia Southern,2,3,5,0.4
vs. BCS AQ,2021,Georgia Southern,0,1,1,0.0
vs. BCS non-AQ,2021,Georgia Southern,2,8,10,0.2
vs. FBS Power 5,2021,Georgia Southern,0,1,1,0.0
vs. FBS non-Power 5,2021,Georgia Southern,2,8,10,0.2
in August/September,2021,Georgia Southern,1,3,4,0.25
in October,2021,Georgia Southern,1,3,4,0.25
in November,2021,Georgia Southern,1,3,4,0.25
in December/January,2021,Georgia Southern,0,0,0,
All Games,2022,Georgia Southern,6,7,13,0.46153846153846156
at Home,2022,Georgia Southern,4,2,6,0.6666666666666666
on Road/Neutral Site,2022,Georgia Southern,2,5,7,0.2857142857142857
vs. Conference,2022,Georgia Southern,3,5,8,0.375
vs. Non-Conference,2022,Georgia Southern,3,2,5,0.6
vs. Ranked (AP),2022,Georgia Southern,0,0,0,
vs. Unranked (AP),2022,Georgia Southern,6,7,13,0.46153846153846156
vs. FBS (I-A),2022,Georgia Southern,5,7,12,0.4166666666666667
vs. FCS (I-AA),2022,Georgia Southern,1,0,1,1.0
vs. FBS Winning,2022,Georgia Southern,1,5,6,0.16666666666666666
vs. FBS Non-Winning,2022,Georgia Southern,4,2,6,0.6666666666666666
vs. BCS AQ,2022,Georgia Southern,1,0,1,1.0
vs. BCS non-AQ,2022,Georgia Southern,4,7,11,0.36363636363636365
vs. FBS Power 5,2022,Georgia Southern,1,0,1,1.0
vs. FBS non-Power 5,2022,Georgia Southern,4,7,11,0.36363636363636365
in August/September,2022,Georgia Southern,3,1,4,0.75
in October,2022,Georgia Southern,2,2,4,0.5
in November,2022,Georgia Southern,1,3,4,0.25
in December/January,2022,Georgia Southern,0,1,1,0.0
All Games,2013,Georgia State,0,12,12,0.0
at Home,2013,Georgia State,0,7,7,0.0
on Road/Neutral Site,2013,Georgia State,0,5,5,0.0
vs. Conference,2013,Georgia State,0,7,7,0.0
vs. Non-Conference,2013,Georgia State,0,5,5,0.0
vs. Ranked (AP),2013,Georgia State,0,1,1,0.0
vs. Unranked (AP),2013,Georgia State,0,11,11,0.0
vs. FBS (I-A),2013,Georgia State,0,9,9,0.0
vs. FCS (I-AA),2013,Georgia State,0,3,3,0.0
vs. FBS Winning,2013,Georgia State,0,4,4,0.0
vs. FBS Non-Winning,2013,Georgia State,0,5,5,0.0
vs. BCS AQ,2013,Georgia State,0,2,2,0.0
vs. BCS non-AQ,2013,Georgia State,0,7,7,0.0
vs. FBS Power 5,2013,Georgia State,0,2,2,0.0
vs. FBS non-Power 5,2013,Georgia State,0,7,7,0.0
in August/September,2013,Georgia State,0,4,4,0.0
in October,2013,Georgia State,0,4,4,0.0
in November,2013,Georgia State,0,4,4,0.0
in December/January,2013,Georgia State,0,0,0,
All Games,2014,Georgia State,1,11,12,0.08333333333333333
at Home,2014,Georgia State,1,5,6,0.16666666666666666
on Road/Neutral Site,2014,Georgia State,0,6,6,0.0
vs. Conference,2014,Georgia State,0,8,8,0.0
vs. Non-Conference,2014,Georgia State,1,3,4,0.25
vs. Ranked (AP),2014,Georgia State,0,1,1,0.0
vs. Unranked (AP),2014,Georgia State,1,10,11,0.09090909090909091
vs. FBS (I-A),2014,Georgia State,0,11,11,0.0
vs. FCS (I-AA),2014,Georgia State,1,0,1,1.0
vs. FBS Winning,2014,Georgia State,0,8,8,0.0
vs. FBS Non-Winning,2014,Georgia State,0,3,3,0.0
vs. BCS AQ,2014,Georgia State,0,2,2,0.0
vs. BCS non-AQ,2014,Georgia State,0,9,9,0.0
vs. FBS Power 5,2014,Georgia State,0,2,2,0.0
vs. FBS non-Power 5,2014,Georgia State,0,9,9,0.0
in August/September,2014,Georgia State,1,3,4,0.25
in October,2014,Georgia State,0,4,4,0.0
in November,2014,Georgia State,0,4,4,0.0
in December/January,2014,Georgia State,0,0,0,
All Games,2015,Georgia State,6,7,13,0.46153846153846156
at Home,2015,Georgia State,2,4,6,0.3333333333333333
on Road/Neutral Site,2015,Georgia State,4,3,7,0.5714285714285714
vs. Conference,2015,Georgia State,5,3,8,0.625
vs. Non-Conference,2015,Georgia State,1,4,5,0.2
vs. Ranked (AP),2015,Georgia State,0,1,1,0.0
vs. Unranked (AP),2015,Georgia State,6,6,12,0.5
vs. FBS (I-A),2015,Georgia State,6,6,12,0.5
vs. FCS (I-AA),2015,Georgia State,0,1,1,0.0
vs. FBS Winning,2015,Georgia State,1,3,4,0.25
vs. FBS Non-Winning,2015,Georgia State,5,3,8,0.625
vs. BCS AQ,2015,Georgia State,0,1,1,0.0
vs. BCS non-AQ,2015,Georgia State,6,5,11,0.5454545454545454
vs. FBS Power 5,2015,Georgia State,0,1,1,0.0
vs. FBS non-Power 5,2015,Georgia State,6,5,11,0.5454545454545454
in August/September,2015,Georgia State,1,2,3,0.3333333333333333
in October,2015,Georgia State,1,3,4,0.25
in November,2015,Georgia State,3,1,4,0.75
in December/January,2015,Georgia State,1,1,2,0.5
All Games,2016,Georgia State,3,9,12,0.25
at Home,2016,Georgia State,3,3,6,0.5
on Road/Neutral Site,2016,Georgia State,0,6,6,0.0
vs. Conference,2016,Georgia State,2,6,8,0.25
vs. Non-Conference,2016,Georgia State,1,3,4,0.25
vs. Ranked (AP),2016,Georgia State,0,1,1,0.0
vs. Unranked (AP),2016,Georgia State,3,8,11,0.2727272727272727
vs. FBS (I-A),2016,Georgia State,2,9,11,0.18181818181818182
vs. FCS (I-AA),2016,Georgia State,1,0,1,1.0
vs. FBS Winning,2016,Georgia State,0,6,6,0.0
vs. FBS Non-Winning,2016,Georgia State,2,3,5,0.4
vs. BCS AQ,2016,Georgia State,0,1,1,0.0
vs. BCS non-AQ,2016,Georgia State,2,8,10,0.2
vs. FBS Power 5,2016,Georgia State,0,1,1,0.0
vs. FBS non-Power 5,2016,Georgia State,2,8,10,0.2
in August/September,2016,Georgia State,0,3,3,0.0
in October,2016,Georgia State,2,3,5,0.4
in November,2016,Georgia State,1,2,3,0.3333333333333333
in December/January,2016,Georgia State,0,1,1,0.0
All Games,2017,Georgia State,7,5,12,0.5833333333333334
at Home,2017,Georgia State,1,4,5,0.2
on Road/Neutral Site,2017,Georgia State,6,1,7,0.8571428571428571
vs. Conference,2017,Georgia State,5,3,8,0.625
vs. Non-Conference,2017,Georgia State,2,2,4,0.5
vs. Ranked (AP),2017,Georgia State,0,1,1,0.0
vs. Unranked (AP),2017,Georgia State,7,4,11,0.6363636363636364
vs. FBS (I-A),2017,Georgia State,7,4,11,0.6363636363636364
vs. FCS (I-AA),2017,Georgia State,0,1,1,0.0
vs. FBS Winning,2017,Georgia State,0,3,3,0.0
vs. FBS Non-Winning,2017,Georgia State,7,1,8,0.875
vs. BCS AQ,2017,Georgia State,0,1,1,0.0
vs. BCS non-AQ,2017,Georgia State,7,3,10,0.7
vs. FBS Power 5,2017,Georgia State,0,1,1,0.0
vs. FBS non-Power 5,2017,Georgia State,7,3,10,0.7
in August/September,2017,Georgia State,1,2,3,0.3333333333333333
in October,2017,Georgia State,3,1,4,0.75
in November,2017,Georgia State,2,1,3,0.6666666666666666
in December/January,2017,Georgia State,1,1,2,0.5
All Games,2018,Georgia State,2,10,12,0.16666666666666666
at Home,2018,Georgia State,2,4,6,0.3333333333333333
on Road/Neutral Site,2018,Georgia State,0,6,6,0.0
vs. Conference,2018,Georgia State,1,7,8,0.125
vs. Non-Conference,2018,Georgia State,1,3,4,0.25
vs. Ranked (AP),2018,Georgia State,0,0,0,
vs. Unranked (AP),2018,Georgia State,2,10,12,0.16666666666666666
vs. FBS (I-A),2018,Georgia State,1,10,11,0.09090909090909091
vs. FCS (I-AA),2018,Georgia State,1,0,1,1.0
vs. FBS Winning,2018,Georgia State,0,7,7,0.0
vs. FBS Non-Winning,2018,Georgia State,1,3,4,0.25
vs. BCS AQ,2018,Georgia State,0,2,2,0.0
vs. BCS non-AQ,2018,Georgia State,1,8,9,0.1111111111111111
vs. FBS Power 5,2018,Georgia State,0,1,1,0.0
vs. FBS non-Power 5,2018,Georgia State,1,9,10,0.1
in August/September,2018,Georgia State,2,3,5,0.4
in October,2018,Georgia State,0,3,3,0.0
in November,2018,Georgia State,0,4,4,0.0
in December/January,2018,Georgia State,0,0,0,
All Games,2019,Georgia State,7,6,13,0.5384615384615384
at Home,2019,Georgia State,5,1,6,0.8333333333333334
on Road/Neutral Site,2019,Georgia State,2,5,7,0.2857142857142857
vs. Conference,2019,Georgia State,4,4,8,0.5
vs. Non-Conference,2019,Georgia State,3,2,5,0.6
vs. Ranked (AP),2019,Georgia State,0,1,1,0.0
vs. Unranked (AP),2019,Georgia State,7,5,12,0.5833333333333334
vs. FBS (I-A),2019,Georgia State,6,6,12,0.5
vs. FCS (I-AA),2019,Georgia State,1,0,1,1.0
vs. FBS Winning,2019,Georgia State,2,4,6,0.3333333333333333
vs. FBS Non-Winning,2019,Georgia State,4,2,6,0.6666666666666666
vs. BCS AQ,2019,Georgia State,1,0,1,1.0
vs. BCS non-AQ,2019,Georgia State,5,6,11,0.45454545454545453
vs. FBS Power 5,2019,Georgia State,1,0,1,1.0
vs. FBS non-Power 5,2019,Georgia State,5,6,11,0.45454545454545453
in August/September,2019,Georgia State,2,2,4,0.5
in October,2019,Georgia State,4,0,4,1.0
in November,2019,Georgia State,1,3,4,0.25
in December/January,2019,Georgia State,0,1,1,0.0
All Games,2020,Georgia State,6,4,10,0.6
at Home,2020,Georgia State,3,2,5,0.6
on Road/Neutral Site,2020,Georgia State,3,2,5,0.6
vs. Conference,2020,Georgia State,4,4,8,0.5
vs. Non-Conference,2020,Georgia State,2,0,2,1.0
vs. Ranked (AP),2020,Georgia State,0,2,2,0.0
vs. Unranked (AP),2020,Georgia State,6,2,8,0.75
vs. FBS (I-A),2020,Georgia State,6,4,10,0.6
vs. FCS (I-AA),2020,Georgia State,0,0,0,
vs. FBS Winning,2020,Georgia State,1,3,4,0.25
vs. FBS Non-Winning,2020,Georgia State,5,1,6,0.8333333333333334
vs. BCS AQ,2020,Georgia State,1,0,1,1.0
vs. BCS non-AQ,2020,Georgia State,5,4,9,0.5555555555555556
vs. FBS Power 5,2020,Georgia State,0,0,0,
vs. FBS non-Power 5,2020,Georgia State,6,4,10,0.6
in August/September,2020,Georgia State,0,1,1,0.0
in October,2020,Georgia State,2,2,4,0.5
in November,2020,Georgia State,3,1,4,0.75
in December/January,2020,Georgia State,1,0,1,1.0
All Games,2021,Georgia State,8,5,13,0.6153846153846154
at Home,2021,Georgia State,4,2,6,0.6666666666666666
on Road/Neutral Site,2021,Georgia State,4,3,7,0.5714285714285714
vs. Conference,2021,Georgia State,6,2,8,0.75
vs. Non-Conference,2021,Georgia State,2,3,5,0.4
vs. Ranked (AP),2021,Georgia State,0,1,1,0.0
vs. Unranked (AP),2021,Georgia State,8,4,12,0.6666666666666666
vs. FBS (I-A),2021,Georgia State,8,5,13,0.6153846153846154
vs. FCS (I-AA),2021,Georgia State,0,0,0,
vs. FBS Winning,2021,Georgia State,1,3,4,0.25
vs. FBS Non-Winning,2021,Georgia State,7,2,9,0.7777777777777778
vs. BCS AQ,2021,Georgia State,0,2,2,0.0
vs. BCS non-AQ,2021,Georgia State,8,3,11,0.7272727272727273
vs. FBS Power 5,2021,Georgia State,0,2,2,0.0
vs. FBS non-Power 5,2021,Georgia State,8,3,11,0.7272727272727273
in August/September,2021,Georgia State,1,3,4,0.25
in October,2021,Georgia State,3,1,4,0.75
in November,2021,Georgia State,3,1,4,0.75
in December/January,2021,Georgia State,1,0,1,1.0
All Games,2022,Georgia State,4,8,12,0.3333333333333333
at Home,2022,Georgia State,2,4,6,0.3333333333333333
on Road/Neutral Site,2022,Georgia State,2,4,6,0.3333333333333333
vs. Conference,2022,Georgia State,3,5,8,0.375
vs. Non-Conference,2022,Georgia State,1,3,4,0.25
vs. Ranked (AP),2022,Georgia State,0,1,1,0.0
vs. Unranked (AP),2022,Georgia State,4,7,11,0.36363636363636365
vs. FBS (I-A),2022,Georgia State,4,8,12,0.3333333333333333
vs. FCS (I-AA),2022,Georgia State,0,0,0,
vs. FBS Winning,2022,Georgia State,1,5,6,0.16666666666666666
vs. FBS Non-Winning,2022,Georgia State,3,3,6,0.5
vs. BCS AQ,2022,Georgia State,0,2,2,0.0
vs. BCS non-AQ,2022,Georgia State,4,6,10,0.4
vs. FBS Power 5,2022,Georgia State,0,2,2,0.0
vs. FBS non-Power 5,2022,Georgia State,4,6,10,0.4
in August/September,2022,Georgia State,0,4,4,0.0
in October,2022,Georgia State,3,1,4,0.75
in November,2022,Georgia State,1,3,4,0.25
in December/January,2022,Georgia State,0,0,0,
All Games,2009,Georgia Tech,11,3,14,0.7857142857142857
at Home,2009,Georgia Tech,5,1,6,0.8333333333333334
on Road/Neutral Site,2009,Georgia Tech,6,2,8,0.75
vs. Conference,2009,Georgia Tech,8,1,9,0.8888888888888888
vs. Non-Conference,2009,Georgia Tech,3,2,5,0.6
vs. Ranked (AP),2009,Georgia Tech,3,2,5,0.6
vs. Unranked (AP),2009,Georgia Tech,8,1,9,0.8888888888888888
vs. FBS (I-A),2009,Georgia Tech,10,3,13,0.7692307692307693
vs. FCS (I-AA),2009,Georgia Tech,1,0,1,1.0
vs. FBS Winning,2009,Georgia Tech,5,3,8,0.625
vs. FBS Non-Winning,2009,Georgia Tech,5,0,5,1.0
vs. BCS AQ,2009,Georgia Tech,10,3,13,0.7692307692307693
vs. BCS non-AQ,2009,Georgia Tech,0,0,0,
vs. FBS Power 5,2009,Georgia Tech,10,3,13,0.7692307692307693
vs. FBS non-Power 5,2009,Georgia Tech,0,0,0,
in August/September,2009,Georgia Tech,3,1,4,0.75
in October,2009,Georgia Tech,5,0,5,1.0
in November,2009,Georgia Tech,2,1,3,0.6666666666666666
in December/January,2009,Georgia Tech,1,1,2,0.5
All Games,2010,Georgia Tech,6,7,13,0.46153846153846156
at Home,2010,Georgia Tech,4,2,6,0.6666666666666666
on Road/Neutral Site,2010,Georgia Tech,2,5,7,0.2857142857142857
vs. Conference,2010,Georgia Tech,4,4,8,0.5
vs. Non-Conference,2010,Georgia Tech,2,3,5,0.4
vs. Ranked (AP),2010,Georgia Tech,0,2,2,0.0
vs. Unranked (AP),2010,Georgia Tech,6,5,11,0.5454545454545454
vs. FBS (I-A),2010,Georgia Tech,5,7,12,0.4166666666666667
vs. FCS (I-AA),2010,Georgia Tech,1,0,1,1.0
vs. FBS Winning,2010,Georgia Tech,1,4,5,0.2
vs. FBS Non-Winning,2010,Georgia Tech,4,3,7,0.5714285714285714
vs. BCS AQ,2010,Georgia Tech,4,6,10,0.4
vs. BCS non-AQ,2010,Georgia Tech,1,1,2,0.5
vs. FBS Power 5,2010,Georgia Tech,4,6,10,0.4
vs. FBS non-Power 5,2010,Georgia Tech,1,1,2,0.5
in August/September,2010,Georgia Tech,2,2,4,0.5
in October,2010,Georgia Tech,3,1,4,0.75
in November,2010,Georgia Tech,1,3,4,0.25
in December/January,2010,Georgia Tech,0,1,1,0.0
All Games,2011,Georgia Tech,8,5,13,0.6153846153846154
at Home,2011,Georgia Tech,5,2,7,0.7142857142857143
on Road/Neutral Site,2011,Georgia Tech,3,3,6,0.5
vs. Conference,2011,Georgia Tech,5,3,8,0.625
vs. Non-Conference,2011,Georgia Tech,3,2,5,0.6
vs. Ranked (AP),2011,Georgia Tech,1,2,3,0.3333333333333333
vs. Unranked (AP),2011,Georgia Tech,7,3,10,0.7
vs. FBS (I-A),2011,Georgia Tech,7,5,12,0.5833333333333334
vs. FCS (I-AA),2011,Georgia Tech,1,0,1,1.0
vs. FBS Winning,2011,Georgia Tech,3,4,7,0.42857142857142855
vs. FBS Non-Winning,2011,Georgia Tech,4,1,5,0.8
vs. BCS AQ,2011,Georgia Tech,6,5,11,0.5454545454545454
vs. BCS non-AQ,2011,Georgia Tech,1,0,1,1.0
vs. FBS Power 5,2011,Georgia Tech,6,5,11,0.5454545454545454
vs. FBS non-Power 5,2011,Georgia Tech,1,0,1,1.0
in August/September,2011,Georgia Tech,4,0,4,1.0
in October,2011,Georgia Tech,3,2,5,0.6
in November,2011,Georgia Tech,1,2,3,0.3333333333333333
in December/January,2011,Georgia Tech,0,1,1,0.0
All Games,2012,Georgia Tech,7,7,14,0.5
at Home,2012,Georgia Tech,4,3,7,0.5714285714285714
on Road/Neutral Site,2012,Georgia Tech,3,4,7,0.42857142857142855
vs. Conference,2012,Georgia Tech,5,4,9,0.5555555555555556
vs. Non-Conference,2012,Georgia Tech,2,3,5,0.4
vs. Ranked (AP),2012,Georgia Tech,0,3,3,0.0
vs. Unranked (AP),2012,Georgia Tech,7,4,11,0.6363636363636364
vs. FBS (I-A),2012,Georgia Tech,6,7,13,0.46153846153846156
vs. FCS (I-AA),2012,Georgia Tech,1,0,1,1.0
vs. FBS Winning,2012,Georgia Tech,2,7,9,0.2222222222222222
vs. FBS Non-Winning,2012,Georgia Tech,4,0,4,1.0
vs. BCS AQ,2012,Georgia Tech,6,5,11,0.5454545454545454
vs. BCS non-AQ,2012,Georgia Tech,0,2,2,0.0
vs. FBS Power 5,2012,Georgia Tech,6,5,11,0.5454545454545454
vs. FBS non-Power 5,2012,Georgia Tech,0,2,2,0.0
in August/September,2012,Georgia Tech,2,3,5,0.4
in October,2012,Georgia Tech,1,2,3,0.3333333333333333
in November,2012,Georgia Tech,3,1,4,0.75
in December/January,2012,Georgia Tech,1,1,2,0.5
All Games,2013,Georgia Tech,7,6,13,0.5384615384615384
at Home,2013,Georgia Tech,5,2,7,0.7142857142857143
on Road/Neutral Site,2013,Georgia Tech,2,4,6,0.3333333333333333
vs. Conference,2013,Georgia Tech,5,3,8,0.625
vs. Non-Conference,2013,Georgia Tech,2,3,5,0.4
vs. Ranked (AP),2013,Georgia Tech,1,1,2,0.5
vs. Unranked (AP),2013,Georgia Tech,6,5,11,0.5454545454545454
vs. FBS (I-A),2013,Georgia Tech,5,6,11,0.45454545454545453
vs. FCS (I-AA),2013,Georgia Tech,2,0,2,1.0
vs. FBS Winning,2013,Georgia Tech,4,6,10,0.4
vs. FBS Non-Winning,2013,Georgia Tech,1,0,1,1.0
vs. BCS AQ,2013,Georgia Tech,5,5,10,0.5
vs. BCS non-AQ,2013,Georgia Tech,0,1,1,0.0
vs. FBS Power 5,2013,Georgia Tech,5,5,10,0.5
vs. FBS non-Power 5,2013,Georgia Tech,0,1,1,0.0
in August/September,2013,Georgia Tech,3,1,4,0.75
in October,2013,Georgia Tech,2,2,4,0.5
in November,2013,Georgia Tech,2,2,4,0.5
in December/January,2013,Georgia Tech,0,1,1,0.0
All Games,2014,Georgia Tech,11,3,14,0.7857142857142857
at Home,2014,Georgia Tech,5,1,6,0.8333333333333334
on Road/Neutral Site,2014,Georgia Tech,6,2,8,0.75
vs. Conference,2014,Georgia Tech,6,3,9,0.6666666666666666
vs. Non-Conference,2014,Georgia Tech,5,0,5,1.0
vs. Ranked (AP),2014,Georgia Tech,3,1,4,0.75
vs. Unranked (AP),2014,Georgia Tech,8,2,10,0.8
vs. FBS (I-A),2014,Georgia Tech,10,3,13,0.7692307692307693
vs. FCS (I-AA),2014,Georgia Tech,1,0,1,1.0
vs. FBS Winning,2014,Georgia Tech,6,2,8,0.75
vs. FBS Non-Winning,2014,Georgia Tech,4,1,5,0.8
vs. BCS AQ,2014,Georgia Tech,9,3,12,0.75
vs. BCS non-AQ,2014,Georgia Tech,1,0,1,1.0
vs. FBS Power 5,2014,Georgia Tech,8,3,11,0.7272727272727273
vs. FBS non-Power 5,2014,Georgia Tech,2,0,2,1.0
in August/September,2014,Georgia Tech,4,0,4,1.0
in October,2014,Georgia Tech,2,2,4,0.5
in November,2014,Georgia Tech,4,0,4,1.0
in December/January,2014,Georgia Tech,1,1,2,0.5
All Games,2015,Georgia Tech,3,9,12,0.25
at Home,2015,Georgia Tech,3,4,7,0.42857142857142855
on Road/Neutral Site,2015,Georgia Tech,0,5,5,0.0
vs. Conference,2015,Georgia Tech,1,7,8,0.125
vs. Non-Conference,2015,Georgia Tech,2,2,4,0.5
vs. Ranked (AP),2015,Georgia Tech,1,3,4,0.25
vs. Unranked (AP),2015,Georgia Tech,2,6,8,0.25
vs. FBS (I-A),2015,Georgia Tech,2,9,11,0.18181818181818182
vs. FCS (I-AA),2015,Georgia Tech,1,0,1,1.0
vs. FBS Winning,2015,Georgia Tech,1,8,9,0.1111111111111111
vs. FBS Non-Winning,2015,Georgia Tech,1,1,2,0.5
vs. BCS AQ,2015,Georgia Tech,2,9,11,0.18181818181818182
vs. BCS non-AQ,2015,Georgia Tech,0,0,0,
vs. FBS Power 5,2015,Georgia Tech,1,8,9,0.1111111111111111
vs. FBS non-Power 5,2015,Georgia Tech,1,1,2,0.5
in August/September,2015,Georgia Tech,2,2,4,0.5
in October,2015,Georgia Tech,1,4,5,0.2
in November,2015,Georgia Tech,0,3,3,0.0
in December/January,2015,Georgia Tech,0,0,0,
All Games,2016,Georgia Tech,9,4,13,0.6923076923076923
at Home,2016,Georgia Tech,5,2,7,0.7142857142857143
on Road/Neutral Site,2016,Georgia Tech,4,2,6,0.6666666666666666
vs. Conference,2016,Georgia Tech,4,4,8,0.5
vs. Non-Conference,2016,Georgia Tech,5,0,5,1.0
vs. Ranked (AP),2016,Georgia Tech,1,2,3,0.3333333333333333
vs. Unranked (AP),2016,Georgia Tech,8,2,10,0.8
vs. FBS (I-A),2016,Georgia Tech,8,4,12,0.6666666666666666
vs. FCS (I-AA),2016,Georgia Tech,1,0,1,1.0
vs. FBS Winning,2016,Georgia Tech,4,4,8,0.5
vs. FBS Non-Winning,2016,Georgia Tech,4,0,4,1.0
vs. BCS AQ,2016,Georgia Tech,7,4,11,0.6363636363636364
vs. BCS non-AQ,2016,Georgia Tech,1,0,1,1.0
vs. FBS Power 5,2016,Georgia Tech,7,4,11,0.6363636363636364
vs. FBS non-Power 5,2016,Georgia Tech,1,0,1,1.0
in August/September,2016,Georgia Tech,3,1,4,0.75
in October,2016,Georgia Tech,2,2,4,0.5
in November,2016,Georgia Tech,3,1,4,0.75
in December/January,2016,Georgia Tech,1,0,1,1.0
All Games,2017,Georgia Tech,5,6,11,0.45454545454545453
at Home,2017,Georgia Tech,5,1,6,0.8333333333333334
on Road/Neutral Site,2017,Georgia Tech,0,5,5,0.0
vs. Conference,2017,Georgia Tech,4,4,8,0.5
vs. Non-Conference,2017,Georgia Tech,1,2,3,0.3333333333333333
vs. Ranked (AP),2017,Georgia Tech,1,3,4,0.25
vs. Unranked (AP),2017,Georgia Tech,4,3,7,0.5714285714285714
vs. FBS (I-A),2017,Georgia Tech,4,6,10,0.4
vs. FCS (I-AA),2017,Georgia Tech,1,0,1,1.0
vs. FBS Winning,2017,Georgia Tech,2,4,6,0.3333333333333333
vs. FBS Non-Winning,2017,Georgia Tech,2,2,4,0.5
vs. BCS AQ,2017,Georgia Tech,4,6,10,0.4
vs. BCS non-AQ,2017,Georgia Tech,0,0,0,
vs. FBS Power 5,2017,Georgia Tech,4,6,10,0.4
vs. FBS non-Power 5,2017,Georgia Tech,0,0,0,
in August/September,2017,Georgia Tech,3,1,4,0.75
in October,2017,Georgia Tech,1,2,3,0.3333333333333333
in November,2017,Georgia Tech,1,3,4,0.25
in December/January,2017,Georgia Tech,0,0,0,
All Games,2018,Georgia Tech,7,6,13,0.5384615384615384
at Home,2018,Georgia Tech,4,2,6,0.6666666666666666
on Road/Neutral Site,2018,Georgia Tech,3,4,7,0.42857142857142855
vs. Conference,2018,Georgia Tech,5,3,8,0.625
vs. Non-Conference,2018,Georgia Tech,2,3,5,0.4
vs. Ranked (AP),2018,Georgia Tech,0,2,2,0.0
vs. Unranked (AP),2018,Georgia Tech,7,4,11,0.6363636363636364
vs. FBS (I-A),2018,Georgia Tech,6,6,12,0.5
vs. FCS (I-AA),2018,Georgia Tech,1,0,1,1.0
vs. FBS Winning,2018,Georgia Tech,2,5,7,0.2857142857142857
vs. FBS Non-Winning,2018,Georgia Tech,4,1,5,0.8
vs. BCS AQ,2018,Georgia Tech,5,6,11,0.45454545454545453
vs. BCS non-AQ,2018,Georgia Tech,1,0,1,1.0
vs. FBS Power 5,2018,Georgia Tech,5,5,10,0.5
vs. FBS non-Power 5,2018,Georgia Tech,1,1,2,0.5
in August/September,2018,Georgia Tech,2,3,5,0.4
in October,2018,Georgia Tech,2,1,3,0.6666666666666666
in November,2018,Georgia Tech,3,1,4,0.75
in December/January,2018,Georgia Tech,0,1,1,0.0
All Games,2019,Georgia Tech,3,9,12,0.25
at Home,2019,Georgia Tech,2,5,7,0.2857142857142857
on Road/Neutral Site,2019,Georgia Tech,1,4,5,0.2
vs. Conference,2019,Georgia Tech,2,6,8,0.25
vs. Non-Conference,2019,Georgia Tech,1,3,4,0.25
vs. Ranked (AP),2019,Georgia Tech,0,2,2,0.0
vs. Unranked (AP),2019,Georgia Tech,3,7,10,0.3
vs. FBS (I-A),2019,Georgia Tech,3,8,11,0.2727272727272727
vs. FCS (I-AA),2019,Georgia Tech,0,1,1,0.0
vs. FBS Winning,2019,Georgia Tech,0,7,7,0.0
vs. FBS Non-Winning,2019,Georgia Tech,3,1,4,0.75
vs. BCS AQ,2019,Georgia Tech,3,8,11,0.2727272727272727
vs. BCS non-AQ,2019,Georgia Tech,0,0,0,
vs. FBS Power 5,2019,Georgia Tech,2,7,9,0.2222222222222222
vs. FBS non-Power 5,2019,Georgia Tech,1,1,2,0.5
in August/September,2019,Georgia Tech,1,3,4,0.25
in October,2019,Georgia Tech,1,2,3,0.3333333333333333
in November,2019,Georgia Tech,1,4,5,0.2
in December/January,2019,Georgia Tech,0,0,0,
All Games,2020,Georgia Tech,3,7,10,0.3
at Home,2020,Georgia Tech,2,4,6,0.3333333333333333
on Road/Neutral Site,2020,Georgia Tech,1,3,4,0.25
vs. Conference,2020,Georgia Tech,3,6,9,0.3333333333333333
vs. Non-Conference,2020,Georgia Tech,0,1,1,0.0
vs. Ranked (AP),2020,Georgia Tech,0,3,3,0.0
vs. Unranked (AP),2020,Georgia Tech,3,4,7,0.42857142857142855
vs. FBS (I-A),2020,Georgia Tech,3,7,10,0.3
vs. FCS (I-AA),2020,Georgia Tech,0,0,0,
vs. FBS Winning,2020,Georgia Tech,0,6,6,0.0
vs. FBS Non-Winning,2020,Georgia Tech,3,1,4,0.75
vs. BCS AQ,2020,Georgia Tech,3,7,10,0.3
vs. BCS non-AQ,2020,Georgia Tech,0,0,0,
vs. FBS Power 5,2020,Georgia Tech,3,6,9,0.3333333333333333
vs. FBS non-Power 5,2020,Georgia Tech,0,1,1,0.0
in August/September,2020,Georgia Tech,1,2,3,0.3333333333333333
in October,2020,Georgia Tech,1,3,4,0.25
in November,2020,Georgia Tech,1,0,1,1.0
in December/January,2020,Georgia Tech,0,2,2,0.0
All Games,2021,Georgia Tech,3,9,12,0.25
at Home,2021,Georgia Tech,1,5,6,0.16666666666666666
on Road/Neutral Site,2021,Georgia Tech,2,4,6,0.3333333333333333
vs. Conference,2021,Georgia Tech,2,6,8,0.25
vs. Non-Conference,2021,Georgia Tech,1,3,4,0.25
vs. Ranked (AP),2021,Georgia Tech,0,4,4,0.0
vs. Unranked (AP),2021,Georgia Tech,3,5,8,0.375
vs. FBS (I-A),2021,Georgia Tech,2,9,11,0.18181818181818182
vs. FCS (I-AA),2021,Georgia Tech,1,0,1,1.0
vs. FBS Winning,2021,Georgia Tech,0,6,6,0.0
vs. FBS Non-Winning,2021,Georgia Tech,2,3,5,0.4
vs. BCS AQ,2021,Georgia Tech,2,8,10,0.2
vs. BCS non-AQ,2021,Georgia Tech,0,1,1,0.0
vs. FBS Power 5,2021,Georgia Tech,2,7,9,0.2222222222222222
vs. FBS non-Power 5,2021,Georgia Tech,0,2,2,0.0
in August/September,2021,Georgia Tech,2,2,4,0.5
in October,2021,Georgia Tech,1,3,4,0.25
in November,2021,Georgia Tech,0,4,4,0.0
in December/January,2021,Georgia Tech,0,0,0,
All Games,2022,Georgia Tech,5,7,12,0.4166666666666667
at Home,2022,Georgia Tech,2,4,6,0.3333333333333333
on Road/Neutral Site,2022,Georgia Tech,3,3,6,0.5
vs. Conference,2022,Georgia Tech,4,4,8,0.5
vs. Non-Conference,2022,Georgia Tech,1,3,4,0.25
vs. Ranked (AP),2022,Georgia Tech,1,3,4,0.25
vs. Unranked (AP),2022,Georgia Tech,4,4,8,0.5
vs. FBS (I-A),2022,Georgia Tech,4,7,11,0.36363636363636365
vs. FCS (I-AA),2022,Georgia Tech,1,0,1,1.0
vs. FBS Winning,2022,Georgia Tech,3,5,8,0.375
vs. FBS Non-Winning,2022,Georgia Tech,1,2,3,0.3333333333333333
vs. BCS AQ,2022,Georgia Tech,4,7,11,0.36363636363636365
vs. BCS non-AQ,2022,Georgia Tech,0,0,0,
vs. FBS Power 5,2022,Georgia Tech,4,6,10,0.4
vs. FBS non-Power 5,2022,Georgia Tech,0,1,1,0.0
in August/September,2022,Georgia Tech,1,3,4,0.25
in October,2022,Georgia Tech,2,2,4,0.5
in November,2022,Georgia Tech,2,2,4,0.5
in December/January,2022,Georgia Tech,0,0,0,
All Games,2009,Hawai'i,6,7,13,0.46153846153846156
at Home,2009,Hawai'i,4,3,7,0.5714285714285714
on Road/Neutral Site,2009,Hawai'i,2,4,6,0.3333333333333333
vs. Conference,2009,Hawai'i,3,5,8,0.375
vs. Non-Conference,2009,Hawai'i,3,2,5,0.6
vs. Ranked (AP),2009,Hawai'i,0,2,2,0.0
vs. Unranked (AP),2009,Hawai'i,6,5,11,0.5454545454545454
vs. FBS (I-A),2009,Hawai'i,5,7,12,0.4166666666666667
vs. FCS (I-AA),2009,Hawai'i,1,0,1,1.0
vs. FBS Winning,2009,Hawai'i,1,5,6,0.16666666666666666
vs. FBS Non-Winning,2009,Hawai'i,4,2,6,0.6666666666666666
vs. BCS AQ,2009,Hawai'i,1,1,2,0.5
vs. BCS non-AQ,2009,Hawai'i,4,6,10,0.4
vs. FBS Power 5,2009,Hawai'i,1,1,2,0.5
vs. FBS non-Power 5,2009,Hawai'i,4,6,10,0.4
in August/September,2009,Hawai'i,2,2,4,0.5
in October,2009,Hawai'i,0,4,4,0.0
in November,2009,Hawai'i,4,0,4,1.0
in December/January,2009,Hawai'i,0,1,1,0.0
All Games,2010,Hawai'i,10,4,14,0.7142857142857143
at Home,2010,Hawai'i,6,2,8,0.75
on Road/Neutral Site,2010,Hawai'i,4,2,6,0.6666666666666666
vs. Conference,2010,Hawai'i,7,1,8,0.875
vs. Non-Conference,2010,Hawai'i,3,3,6,0.5
vs. Ranked (AP),2010,Hawai'i,1,2,3,0.3333333333333333
vs. Unranked (AP),2010,Hawai'i,9,2,11,0.8181818181818182
vs. FBS (I-A),2010,Hawai'i,9,4,13,0.6923076923076923
vs. FCS (I-AA),2010,Hawai'i,1,0,1,1.0
vs. FBS Winning,2010,Hawai'i,3,3,6,0.5
vs. FBS Non-Winning,2010,Hawai'i,6,1,7,0.8571428571428571
vs. BCS AQ,2010,Hawai'i,0,2,2,0.0
vs. BCS non-AQ,2010,Hawai'i,9,2,11,0.8181818181818182
vs. FBS Power 5,2010,Hawai'i,0,2,2,0.0
vs. FBS non-Power 5,2010,Hawai'i,9,2,11,0.8181818181818182
in August/September,2010,Hawai'i,2,2,4,0.5
in October,2010,Hawai'i,5,0,5,1.0
in November,2010,Hawai'i,2,1,3,0.6666666666666666
in December/January,2010,Hawai'i,1,1,2,0.5
All Games,2011,Hawai'i,6,7,13,0.46153846153846156
at Home,2011,Hawai'i,4,3,7,0.5714285714285714
on Road/Neutral Site,2011,Hawai'i,2,4,6,0.3333333333333333
vs. Conference,2011,Hawai'i,3,4,7,0.42857142857142855
vs. Non-Conference,2011,Hawai'i,3,3,6,0.5
vs. Ranked (AP),2011,Hawai'i,0,0,0,
vs. Unranked (AP),2011,Hawai'i,6,7,13,0.46153846153846156
vs. FBS (I-A),2011,Hawai'i,5,7,12,0.4166666666666667
vs. FCS (I-AA),2011,Hawai'i,1,0,1,1.0
vs. FBS Winning,2011,Hawai'i,1,4,5,0.2
vs. FBS Non-Winning,2011,Hawai'i,4,3,7,0.5714285714285714
vs. BCS AQ,2011,Hawai'i,1,1,2,0.5
vs. BCS non-AQ,2011,Hawai'i,4,6,10,0.4
vs. FBS Power 5,2011,Hawai'i,1,1,2,0.5
vs. FBS non-Power 5,2011,Hawai'i,4,6,10,0.4
in August/September,2011,Hawai'i,2,2,4,0.5
in October,2011,Hawai'i,3,1,4,0.75
in November,2011,Hawai'i,1,3,4,0.25
in December/January,2011,Hawai'i,0,1,1,0.0
All Games,2012,Hawai'i,3,9,12,0.25
at Home,2012,Hawai'i,3,3,6,0.5
on Road/Neutral Site,2012,Hawai'i,0,6,6,0.0
vs. Conference,2012,Hawai'i,1,7,8,0.125
vs. Non-Conference,2012,Hawai'i,2,2,4,0.5
vs. Ranked (AP),2012,Hawai'i,0,1,1,0.0
vs. Unranked (AP),2012,Hawai'i,3,8,11,0.2727272727272727
vs. FBS (I-A),2012,Hawai'i,2,9,11,0.18181818181818182
vs. FCS (I-AA),2012,Hawai'i,1,0,1,1.0
vs. FBS Winning,2012,Hawai'i,0,6,6,0.0
vs. FBS Non-Winning,2012,Hawai'i,2,3,5,0.4
vs. BCS AQ,2012,Hawai'i,0,1,1,0.0
vs. BCS non-AQ,2012,Hawai'i,2,8,10,0.2
vs. FBS Power 5,2012,Hawai'i,0,1,1,0.0
vs. FBS non-Power 5,2012,Hawai'i,2,8,10,0.2
in August/September,2012,Hawai'i,1,3,4,0.25
in October,2012,Hawai'i,0,3,3,0.0
in November,2012,Hawai'i,1,3,4,0.25
in December/January,2012,Hawai'i,1,0,1,1.0
All Games,2013,Hawai'i,1,11,12,0.08333333333333333
at Home,2013,Hawai'i,1,5,6,0.16666666666666666
on Road/Neutral Site,2013,Hawai'i,0,6,6,0.0
vs. Conference,2013,Hawai'i,0,8,8,0.0
vs. Non-Conference,2013,Hawai'i,1,3,4,0.25
vs. Ranked (AP),2013,Hawai'i,0,1,1,0.0
vs. Unranked (AP),2013,Hawai'i,1,10,11,0.09090909090909091
vs. FBS (I-A),2013,Hawai'i,1,11,12,0.08333333333333333
vs. FCS (I-AA),2013,Hawai'i,0,0,0,
vs. FBS Winning,2013,Hawai'i,0,8,8,0.0
vs. FBS Non-Winning,2013,Hawai'i,1,3,4,0.25
vs. BCS AQ,2013,Hawai'i,0,2,2,0.0
vs. BCS non-AQ,2013,Hawai'i,1,9,10,0.1
vs. FBS Power 5,2013,Hawai'i,0,2,2,0.0
vs. FBS non-Power 5,2013,Hawai'i,1,9,10,0.1
in August/September,2013,Hawai'i,0,4,4,0.0
in October,2013,Hawai'i,0,3,3,0.0
in November,2013,Hawai'i,1,4,5,0.2
in December/January,2013,Hawai'i,0,0,0,
All Games,2014,Hawai'i,4,9,13,0.3076923076923077
at Home,2014,Hawai'i,3,4,7,0.42857142857142855
on Road/Neutral Site,2014,Hawai'i,1,5,6,0.16666666666666666
vs. Conference,2014,Hawai'i,3,5,8,0.375
vs. Non-Conference,2014,Hawai'i,1,4,5,0.2
vs. Ranked (AP),2014,Hawai'i,0,0,0,
vs. Unranked (AP),2014,Hawai'i,4,9,13,0.3076923076923077
vs. FBS (I-A),2014,Hawai'i,3,9,12,0.25
vs. FCS (I-AA),2014,Hawai'i,1,0,1,1.0
vs. FBS Winning,2014,Hawai'i,0,6,6,0.0
vs. FBS Non-Winning,2014,Hawai'i,3,3,6,0.5
vs. BCS AQ,2014,Hawai'i,0,3,3,0.0
vs. BCS non-AQ,2014,Hawai'i,3,6,9,0.3333333333333333
vs. FBS Power 5,2014,Hawai'i,0,3,3,0.0
vs. FBS non-Power 5,2014,Hawai'i,3,6,9,0.3333333333333333
in August/September,2014,Hawai'i,1,3,4,0.25
in October,2014,Hawai'i,1,3,4,0.25
in November,2014,Hawai'i,2,3,5,0.4
in December/January,2014,Hawai'i,0,0,0,
All Games,2015,Hawai'i,3,10,13,0.23076923076923078
at Home,2015,Hawai'i,3,4,7,0.42857142857142855
on Road/Neutral Site,2015,Hawai'i,0,6,6,0.0
vs. Conference,2015,Hawai'i,0,8,8,0.0
vs. Non-Conference,2015,Hawai'i,3,2,5,0.6
vs. Ranked (AP),2015,Hawai'i,0,2,2,0.0
vs. Unranked (AP),2015,Hawai'i,3,8,11,0.2727272727272727
vs. FBS (I-A),2015,Hawai'i,2,10,12,0.16666666666666666
vs. FCS (I-AA),2015,Hawai'i,1,0,1,1.0
vs. FBS Winning,2015,Hawai'i,0,7,7,0.0
vs. FBS Non-Winning,2015,Hawai'i,2,3,5,0.4
vs. BCS AQ,2015,Hawai'i,1,2,3,0.3333333333333333
vs. BCS non-AQ,2015,Hawai'i,1,8,9,0.1111111111111111
vs. FBS Power 5,2015,Hawai'i,1,2,3,0.3333333333333333
vs. FBS non-Power 5,2015,Hawai'i,1,8,9,0.1111111111111111
in August/September,2015,Hawai'i,2,2,4,0.5
in October,2015,Hawai'i,0,5,5,0.0
in November,2015,Hawai'i,1,3,4,0.25
in December/January,2015,Hawai'i,0,0,0,
All Games,2016,Hawai'i,7,7,14,0.5
at Home,2016,Hawai'i,3,3,6,0.5
on Road/Neutral Site,2016,Hawai'i,4,4,8,0.5
vs. Conference,2016,Hawai'i,4,4,8,0.5
vs. Non-Conference,2016,Hawai'i,3,3,6,0.5
vs. Ranked (AP),2016,Hawai'i,0,1,1,0.0
vs. Unranked (AP),2016,Hawai'i,7,6,13,0.5384615384615384
vs. FBS (I-A),2016,Hawai'i,6,7,13,0.46153846153846156
vs. FCS (I-AA),2016,Hawai'i,1,0,1,1.0
vs. FBS Winning,2016,Hawai'i,2,4,6,0.3333333333333333
vs. FBS Non-Winning,2016,Hawai'i,4,3,7,0.5714285714285714
vs. BCS AQ,2016,Hawai'i,0,3,3,0.0
vs. BCS non-AQ,2016,Hawai'i,6,4,10,0.6
vs. FBS Power 5,2016,Hawai'i,0,3,3,0.0
vs. FBS non-Power 5,2016,Hawai'i,6,4,10,0.6
in August/September,2016,Hawai'i,1,3,4,0.25
in October,2016,Hawai'i,3,2,5,0.6
in November,2016,Hawai'i,2,2,4,0.5
in December/January,2016,Hawai'i,1,0,1,1.0
All Games,2017,Hawai'i,3,9,12,0.25
at Home,2017,Hawai'i,2,4,6,0.3333333333333333
on Road/Neutral Site,2017,Hawai'i,1,5,6,0.16666666666666666
vs. Conference,2017,Hawai'i,1,7,8,0.125
vs. Non-Conference,2017,Hawai'i,2,2,4,0.5
vs. Ranked (AP),2017,Hawai'i,0,0,0,
vs. Unranked (AP),2017,Hawai'i,3,9,12,0.25
vs. FBS (I-A),2017,Hawai'i,2,9,11,0.18181818181818182
vs. FCS (I-AA),2017,Hawai'i,1,0,1,1.0
vs. FBS Winning,2017,Hawai'i,0,4,4,0.0
vs. FBS Non-Winning,2017,Hawai'i,2,5,7,0.2857142857142857
vs. BCS AQ,2017,Hawai'i,0,1,1,0.0
vs. BCS non-AQ,2017,Hawai'i,2,8,10,0.2
vs. FBS Power 5,2017,Hawai'i,0,1,1,0.0
vs. FBS non-Power 5,2017,Hawai'i,2,8,10,0.2
in August/September,2017,Hawai'i,2,3,5,0.4
in October,2017,Hawai'i,1,2,3,0.3333333333333333
in November,2017,Hawai'i,0,4,4,0.0
in December/January,2017,Hawai'i,0,0,0,
All Games,2018,Hawai'i,8,6,14,0.5714285714285714
at Home,2018,Hawai'i,5,2,7,0.7142857142857143
on Road/Neutral Site,2018,Hawai'i,3,4,7,0.42857142857142855
vs. Conference,2018,Hawai'i,5,3,8,0.625
vs. Non-Conference,2018,Hawai'i,3,3,6,0.5
vs. Ranked (AP),2018,Hawai'i,0,3,3,0.0
vs. Unranked (AP),2018,Hawai'i,8,3,11,0.7272727272727273
vs. FBS (I-A),2018,Hawai'i,7,6,13,0.5384615384615384
vs. FCS (I-AA),2018,Hawai'i,1,0,1,1.0
vs. FBS Winning,2018,Hawai'i,1,6,7,0.14285714285714285
vs. FBS Non-Winning,2018,Hawai'i,6,0,6,1.0
vs. BCS AQ,2018,Hawai'i,1,0,1,1.0
vs. BCS non-AQ,2018,Hawai'i,6,6,12,0.5
vs. FBS Power 5,2018,Hawai'i,0,0,0,
vs. FBS non-Power 5,2018,Hawai'i,7,6,13,0.5384615384615384
in August/September,2018,Hawai'i,5,1,6,0.8333333333333334
in October,2018,Hawai'i,1,3,4,0.25
in November,2018,Hawai'i,2,1,3,0.6666666666666666
in December/January,2018,Hawai'i,0,1,1,0.0
All Games,2019,Hawai'i,10,5,15,0.6666666666666666
at Home,2019,Hawai'i,6,2,8,0.75
on Road/Neutral Site,2019,Hawai'i,4,3,7,0.5714285714285714
vs. Conference,2019,Hawai'i,5,4,9,0.5555555555555556
vs. Non-Conference,2019,Hawai'i,5,1,6,0.8333333333333334
vs. Ranked (AP),2019,Hawai'i,0,3,3,0.0
vs. Unranked (AP),2019,Hawai'i,10,2,12,0.8333333333333334
vs. FBS (I-A),2019,Hawai'i,9,5,14,0.6428571428571429
vs. FCS (I-AA),2019,Hawai'i,1,0,1,1.0
vs. FBS Winning,2019,Hawai'i,3,4,7,0.42857142857142855
vs. FBS Non-Winning,2019,Hawai'i,6,1,7,0.8571428571428571
vs. BCS AQ,2019,Hawai'i,2,1,3,0.6666666666666666
vs. BCS non-AQ,2019,Hawai'i,7,4,11,0.6363636363636364
vs. FBS Power 5,2019,Hawai'i,2,1,3,0.6666666666666666
vs. FBS non-Power 5,2019,Hawai'i,7,4,11,0.6363636363636364
in August/September,2019,Hawai'i,4,1,5,0.8
in October,2019,Hawai'i,1,2,3,0.3333333333333333
in November,2019,Hawai'i,4,1,5,0.8
in December/January,2019,Hawai'i,1,1,2,0.5
All Games,2020,Hawai'i,5,4,9,0.5555555555555556
at Home,2020,Hawai'i,3,2,5,0.6
on Road/Neutral Site,2020,Hawai'i,2,2,4,0.5
vs. Conference,2020,Hawai'i,4,4,8,0.5
vs. Non-Conference,2020,Hawai'i,1,0,1,1.0
vs. Ranked (AP),2020,Hawai'i,0,1,1,0.0
vs. Unranked (AP),2020,Hawai'i,5,3,8,0.625
vs. FBS (I-A),2020,Hawai'i,5,4,9,0.5555555555555556
vs. FCS (I-AA),2020,Hawai'i,0,0,0,
vs. FBS Winning,2020,Hawai'i,1,2,3,0.3333333333333333
vs. FBS Non-Winning,2020,Hawai'i,4,2,6,0.6666666666666666
vs. BCS AQ,2020,Hawai'i,1,0,1,1.0
vs. BCS non-AQ,2020,Hawai'i,4,4,8,0.5
vs. FBS Power 5,2020,Hawai'i,0,0,0,
vs. FBS non-Power 5,2020,Hawai'i,5,4,9,0.5555555555555556
in August/September,2020,Hawai'i,0,0,0,
in October,2020,Hawai'i,1,1,2,0.5
in November,2020,Hawai'i,2,2,4,0.5
in December/January,2020,Hawai'i,2,1,3,0.6666666666666666
All Games,2021,Hawai'i,6,7,13,0.46153846153846156
at Home,2021,Hawai'i,4,2,6,0.6666666666666666
on Road/Neutral Site,2021,Hawai'i,2,5,7,0.2857142857142857
vs. Conference,2021,Hawai'i,3,5,8,0.375
vs. Non-Conference,2021,Hawai'i,3,2,5,0.6
vs. Ranked (AP),2021,Hawai'i,0,2,2,0.0
vs. Unranked (AP),2021,Hawai'i,6,5,11,0.5454545454545454
vs. FBS (I-A),2021,Hawai'i,5,7,12,0.4166666666666667
vs. FCS (I-AA),2021,Hawai'i,1,0,1,1.0
vs. FBS Winning,2021,Hawai'i,2,5,7,0.2857142857142857
vs. FBS Non-Winning,2021,Hawai'i,3,2,5,0.6
vs. BCS AQ,2021,Hawai'i,0,2,2,0.0
vs. BCS non-AQ,2021,Hawai'i,5,5,10,0.5
vs. FBS Power 5,2021,Hawai'i,0,2,2,0.0
vs. FBS non-Power 5,2021,Hawai'i,5,5,10,0.5
in August/September,2021,Hawai'i,2,3,5,0.4
in October,2021,Hawai'i,2,2,4,0.5
in November,2021,Hawai'i,2,2,4,0.5
in December/January,2021,Hawai'i,0,0,0,
All Games,2022,Hawai'i,3,10,13,0.23076923076923078
at Home,2022,Hawai'i,3,4,7,0.42857142857142855
on Road/Neutral Site,2022,Hawai'i,0,6,6,0.0
vs. Conference,2022,Hawai'i,2,6,8,0.25
vs. Non-Conference,2022,Hawai'i,1,4,5,0.2
vs. Ranked (AP),2022,Hawai'i,0,2,2,0.0
vs. Unranked (AP),2022,Hawai'i,3,8,11,0.2727272727272727
vs. FBS (I-A),2022,Hawai'i,2,10,12,0.16666666666666666
vs. FCS (I-AA),2022,Hawai'i,1,0,1,1.0
vs. FBS Winning,2022,Hawai'i,0,7,7,0.0
vs. FBS Non-Winning,2022,Hawai'i,2,3,5,0.4
vs. BCS AQ,2022,Hawai'i,0,2,2,0.0
vs. BCS non-AQ,2022,Hawai'i,2,8,10,0.2
vs. FBS Power 5,2022,Hawai'i,0,2,2,0.0
vs. FBS non-Power 5,2022,Hawai'i,2,8,10,0.2
in August/September,2022,Hawai'i,1,4,5,0.2
in October,2022,Hawai'i,1,3,4,0.25
in November,2022,Hawai'i,1,3,4,0.25
in December/January,2022,Hawai'i,0,0,0,
All Games,2009,Houston,10,4,14,0.7142857142857143
at Home,2009,Houston,6,0,6,1.0
on Road/Neutral Site,2009,Houston,4,4,8,0.5
vs. Conference,2009,Houston,6,3,9,0.6666666666666666
vs. Non-Conference,2009,Houston,4,1,5,0.8
vs. Ranked (AP),2009,Houston,1,0,1,1.0
vs. Unranked (AP),2009,Houston,9,4,13,0.6923076923076923
vs. FBS (I-A),2009,Houston,9,4,13,0.6923076923076923
vs. FCS (I-AA),2009,Houston,1,0,1,1.0
vs. FBS Winning,2009,Houston,4,3,7,0.5714285714285714
vs. FBS Non-Winning,2009,Houston,5,1,6,0.8333333333333334
vs. BCS AQ,2009,Houston,3,0,3,1.0
vs. BCS non-AQ,2009,Houston,6,4,10,0.6
vs. FBS Power 5,2009,Houston,3,0,3,1.0
vs. FBS non-Power 5,2009,Houston,6,4,10,0.6
in August/September,2009,Houston,3,0,3,1.0
in October,2009,Houston,4,1,5,0.8
in November,2009,Houston,3,1,4,0.75
in December/January,2009,Houston,0,2,2,0.0
All Games,2010,Houston,5,7,12,0.4166666666666667
at Home,2010,Houston,3,3,6,0.5
on Road/Neutral Site,2010,Houston,2,4,6,0.3333333333333333
vs. Conference,2010,Houston,4,4,8,0.5
vs. Non-Conference,2010,Houston,1,3,4,0.25
vs. Ranked (AP),2010,Houston,0,3,3,0.0
vs. Unranked (AP),2010,Houston,5,4,9,0.5555555555555556
vs. FBS (I-A),2010,Houston,4,7,11,0.36363636363636365
vs. FCS (I-AA),2010,Houston,1,0,1,1.0
vs. FBS Winning,2010,Houston,0,5,5,0.0
vs. FBS Non-Winning,2010,Houston,4,2,6,0.6666666666666666
vs. BCS AQ,2010,Houston,0,3,3,0.0
vs. BCS non-AQ,2010,Houston,4,4,8,0.5
vs. FBS Power 5,2010,Houston,0,3,3,0.0
vs. FBS non-Power 5,2010,Houston,4,4,8,0.5
in August/September,2010,Houston,3,1,4,0.75
in October,2010,Houston,2,2,4,0.5
in November,2010,Houston,0,4,4,0.0
in December/January,2010,Houston,0,0,0,
All Games,2011,Houston,13,1,14,0.9285714285714286
at Home,2011,Houston,6,1,7,0.8571428571428571
on Road/Neutral Site,2011,Houston,7,0,7,1.0
vs. Conference,2011,Houston,8,1,9,0.8888888888888888
vs. Non-Conference,2011,Houston,5,0,5,1.0
vs. Ranked (AP),2011,Houston,0,1,1,0.0
vs. Unranked (AP),2011,Houston,13,0,13,1.0
vs. FBS (I-A),2011,Houston,12,1,13,0.9230769230769231
vs. FCS (I-AA),2011,Houston,1,0,1,1.0
vs. FBS Winning,2011,Houston,5,1,6,0.8333333333333334
vs. FBS Non-Winning,2011,Houston,7,0,7,1.0
vs. BCS AQ,2011,Houston,2,0,2,1.0
vs. BCS non-AQ,2011,Houston,10,1,11,0.9090909090909091
vs. FBS Power 5,2011,Houston,2,0,2,1.0
vs. FBS non-Power 5,2011,Houston,10,1,11,0.9090909090909091
in August/September,2011,Houston,5,0,5,1.0
in October,2011,Houston,3,0,3,1.0
in November,2011,Houston,4,0,4,1.0
in December/January,2011,Houston,1,1,2,0.5
All Games,2012,Houston,5,7,12,0.4166666666666667
at Home,2012,Houston,4,3,7,0.5714285714285714
on Road/Neutral Site,2012,Houston,1,4,5,0.2
vs. Conference,2012,Houston,4,4,8,0.5
vs. Non-Conference,2012,Houston,1,3,4,0.25
vs. Ranked (AP),2012,Houston,0,0,0,
vs. Unranked (AP),2012,Houston,5,7,12,0.4166666666666667
vs. FBS (I-A),2012,Houston,5,7,12,0.4166666666666667
vs. FCS (I-AA),2012,Houston,0,0,0,
vs. FBS Winning,2012,Houston,1,5,6,0.16666666666666666
vs. FBS Non-Winning,2012,Houston,4,2,6,0.6666666666666666
vs. BCS AQ,2012,Houston,0,1,1,0.0
vs. BCS non-AQ,2012,Houston,5,6,11,0.45454545454545453
vs. FBS Power 5,2012,Houston,0,1,1,0.0
vs. FBS non-Power 5,2012,Houston,5,6,11,0.45454545454545453
in August/September,2012,Houston,1,3,4,0.25
in October,2012,Houston,3,1,4,0.75
in November,2012,Houston,1,3,4,0.25
in December/January,2012,Houston,0,0,0,
All Games,2013,Houston,8,5,13,0.6153846153846154
at Home,2013,Houston,3,1,4,0.75
on Road/Neutral Site,2013,Houston,5,4,9,0.5555555555555556
vs. Conference,2013,Houston,5,3,8,0.625
vs. Non-Conference,2013,Houston,3,2,5,0.6
vs. Ranked (AP),2013,Houston,0,3,3,0.0
vs. Unranked (AP),2013,Houston,8,2,10,0.8
vs. FBS (I-A),2013,Houston,7,5,12,0.5833333333333334
vs. FCS (I-AA),2013,Houston,1,0,1,1.0
vs. FBS Winning,2013,Houston,2,5,7,0.2857142857142857
vs. FBS Non-Winning,2013,Houston,5,0,5,1.0
vs. BCS AQ,2013,Houston,5,4,9,0.5555555555555556
vs. BCS non-AQ,2013,Houston,2,1,3,0.6666666666666666
vs. FBS Power 5,2013,Houston,0,1,1,0.0
vs. FBS non-Power 5,2013,Houston,7,4,11,0.6363636363636364
in August/September,2013,Houston,4,0,4,1.0
in October,2013,Houston,3,1,4,0.75
in November,2013,Houston,1,3,4,0.25
in December/January,2013,Houston,0,1,1,0.0
All Games,2014,Houston,8,5,13,0.6153846153846154
at Home,2014,Houston,4,3,7,0.5714285714285714
on Road/Neutral Site,2014,Houston,4,2,6,0.6666666666666666
vs. Conference,2014,Houston,5,3,8,0.625
vs. Non-Conference,2014,Houston,3,2,5,0.6
vs. Ranked (AP),2014,Houston,1,0,1,1.0
vs. Unranked (AP),2014,Houston,7,5,12,0.5833333333333334
vs. FBS (I-A),2014,Houston,7,5,12,0.5833333333333334
vs. FCS (I-AA),2014,Houston,1,0,1,1.0
vs. FBS Winning,2014,Houston,1,3,4,0.25
vs. FBS Non-Winning,2014,Houston,6,2,8,0.75
vs. BCS AQ,2014,Houston,6,3,9,0.6666666666666666
vs. BCS non-AQ,2014,Houston,1,2,3,0.3333333333333333
vs. FBS Power 5,2014,Houston,1,0,1,1.0
vs. FBS non-Power 5,2014,Houston,6,5,11,0.5454545454545454
in August/September,2014,Houston,2,2,4,0.5
in October,2014,Houston,2,1,3,0.6666666666666666
in November,2014,Houston,3,1,4,0.75
in December/January,2014,Houston,1,1,2,0.5
All Games,2015,Houston,13,1,14,0.9285714285714286
at Home,2015,Houston,8,0,8,1.0
on Road/Neutral Site,2015,Houston,5,1,6,0.8333333333333334
vs. Conference,2015,Houston,8,1,9,0.8888888888888888
vs. Non-Conference,2015,Houston,5,0,5,1.0
vs. Ranked (AP),2015,Houston,2,0,2,1.0
vs. Unranked (AP),2015,Houston,11,1,12,0.9166666666666666
vs. FBS (I-A),2015,Houston,12,1,13,0.9230769230769231
vs. FCS (I-AA),2015,Houston,1,0,1,1.0
vs. FBS Winning,2015,Houston,6,0,6,1.0
vs. FBS Non-Winning,2015,Houston,6,1,7,0.8571428571428571
vs. BCS AQ,2015,Houston,11,1,12,0.9166666666666666
vs. BCS non-AQ,2015,Houston,1,0,1,1.0
vs. FBS Power 5,2015,Houston,3,0,3,1.0
vs. FBS non-Power 5,2015,Houston,9,1,10,0.9
in August/September,2015,Houston,3,0,3,1.0
in October,2015,Houston,5,0,5,1.0
in November,2015,Houston,3,1,4,0.75
in December/January,2015,Houston,2,0,2,1.0
All Games,2016,Houston,9,4,13,0.6923076923076923
at Home,2016,Houston,6,0,6,1.0
on Road/Neutral Site,2016,Houston,3,4,7,0.42857142857142855
vs. Conference,2016,Houston,5,3,8,0.625
vs. Non-Conference,2016,Houston,4,1,5,0.8
vs. Ranked (AP),2016,Houston,2,0,2,1.0
vs. Unranked (AP),2016,Houston,7,4,11,0.6363636363636364
vs. FBS (I-A),2016,Houston,8,4,12,0.6666666666666666
vs. FCS (I-AA),2016,Houston,1,0,1,1.0
vs. FBS Winning,2016,Houston,3,3,6,0.5
vs. FBS Non-Winning,2016,Houston,5,1,6,0.8333333333333334
vs. BCS AQ,2016,Houston,7,3,10,0.7
vs. BCS non-AQ,2016,Houston,1,1,2,0.5
vs. FBS Power 5,2016,Houston,2,0,2,1.0
vs. FBS non-Power 5,2016,Houston,6,4,10,0.6
in August/September,2016,Houston,5,0,5,1.0
in October,2016,Houston,2,2,4,0.5
in November,2016,Houston,2,1,3,0.6666666666666666
in December/January,2016,Houston,0,1,1,0.0
All Games,2017,Houston,7,5,12,0.5833333333333334
at Home,2017,Houston,4,2,6,0.6666666666666666
on Road/Neutral Site,2017,Houston,3,3,6,0.5
vs. Conference,2017,Houston,5,3,8,0.625
vs. Non-Conference,2017,Houston,2,2,4,0.5
vs. Ranked (AP),2017,Houston,1,1,2,0.5
vs. Unranked (AP),2017,Houston,6,4,10,0.6
vs. FBS (I-A),2017,Houston,7,5,12,0.5833333333333334
vs. FCS (I-AA),2017,Houston,0,0,0,
vs. FBS Winning,2017,Houston,5,2,7,0.7142857142857143
vs. FBS Non-Winning,2017,Houston,2,3,5,0.4
vs. BCS AQ,2017,Houston,6,4,10,0.6
vs. BCS non-AQ,2017,Houston,1,1,2,0.5
vs. FBS Power 5,2017,Houston,1,1,2,0.5
vs. FBS non-Power 5,2017,Houston,6,4,10,0.6
in August/September,2017,Houston,3,1,4,0.75
in October,2017,Houston,2,2,4,0.5
in November,2017,Houston,2,1,3,0.6666666666666666
in December/January,2017,Houston,0,1,1,0.0
All Games,2018,Houston,8,5,13,0.6153846153846154
at Home,2018,Houston,5,1,6,0.8333333333333334
on Road/Neutral Site,2018,Houston,3,4,7,0.42857142857142855
vs. Conference,2018,Houston,5,3,8,0.625
vs. Non-Conference,2018,Houston,3,2,5,0.6
vs. Ranked (AP),2018,Houston,0,1,1,0.0
vs. Unranked (AP),2018,Houston,8,4,12,0.6666666666666666
vs. FBS (I-A),2018,Houston,7,5,12,0.5833333333333334
vs. FCS (I-AA),2018,Houston,1,0,1,1.0
vs. FBS Winning,2018,Houston,2,3,5,0.4
vs. FBS Non-Winning,2018,Houston,5,2,7,0.7142857142857143
vs. BCS AQ,2018,Houston,6,4,10,0.6
vs. BCS non-AQ,2018,Houston,1,1,2,0.5
vs. FBS Power 5,2018,Houston,1,1,2,0.5
vs. FBS non-Power 5,2018,Houston,6,4,10,0.6
in August/September,2018,Houston,3,1,4,0.75
in October,2018,Houston,4,0,4,1.0
in November,2018,Houston,1,3,4,0.25
in December/January,2018,Houston,0,1,1,0.0
All Games,2019,Houston,4,8,12,0.3333333333333333
at Home,2019,Houston,1,4,5,0.2
on Road/Neutral Site,2019,Houston,3,4,7,0.42857142857142855
vs. Conference,2019,Houston,2,6,8,0.25
vs. Non-Conference,2019,Houston,2,2,4,0.5
vs. Ranked (AP),2019,Houston,0,5,5,0.0
vs. Unranked (AP),2019,Houston,4,3,7,0.5714285714285714
vs. FBS (I-A),2019,Houston,3,8,11,0.2727272727272727
vs. FCS (I-AA),2019,Houston,1,0,1,1.0
vs. FBS Winning,2019,Houston,0,7,7,0.0
vs. FBS Non-Winning,2019,Houston,3,1,4,0.75
vs. BCS AQ,2019,Houston,2,8,10,0.2
vs. BCS non-AQ,2019,Houston,1,0,1,1.0
vs. FBS Power 5,2019,Houston,0,2,2,0.0
vs. FBS non-Power 5,2019,Houston,3,6,9,0.3333333333333333
in August/September,2019,Houston,2,3,5,0.4
in October,2019,Houston,1,2,3,0.3333333333333333
in November,2019,Houston,1,3,4,0.25
in December/January,2019,Houston,0,0,0,
All Games,2020,Houston,3,5,8,0.375
at Home,2020,Houston,2,2,4,0.5
on Road/Neutral Site,2020,Houston,1,3,4,0.25
vs. Conference,2020,Houston,3,3,6,0.5
vs. Non-Conference,2020,Houston,0,2,2,0.0
vs. Ranked (AP),2020,Houston,0,2,2,0.0
vs. Unranked (AP),2020,Houston,3,3,6,0.5
vs. FBS (I-A),2020,Houston,3,5,8,0.375
vs. FCS (I-AA),2020,Houston,0,0,0,
vs. FBS Winning,2020,Houston,0,5,5,0.0
vs. FBS Non-Winning,2020,Houston,3,0,3,1.0
vs. BCS AQ,2020,Houston,3,3,6,0.5
vs. BCS non-AQ,2020,Houston,0,2,2,0.0
vs. FBS Power 5,2020,Houston,0,0,0,
vs. FBS non-Power 5,2020,Houston,3,5,8,0.375
in August/September,2020,Houston,0,0,0,
in October,2020,Houston,2,2,4,0.5
in November,2020,Houston,1,1,2,0.5
in December/January,2020,Houston,0,2,2,0.0
All Games,2021,Houston,12,2,14,0.8571428571428571
at Home,2021,Houston,5,0,5,1.0
on Road/Neutral Site,2021,Houston,7,2,9,0.7777777777777778
vs. Conference,2021,Houston,8,1,9,0.8888888888888888
vs. Non-Conference,2021,Houston,4,1,5,0.8
vs. Ranked (AP),2021,Houston,0,1,1,0.0
vs. Unranked (AP),2021,Houston,12,1,13,0.9230769230769231
vs. FBS (I-A),2021,Houston,11,2,13,0.8461538461538461
vs. FCS (I-AA),2021,Houston,1,0,1,1.0
vs. FBS Winning,2021,Houston,3,2,5,0.6
vs. FBS Non-Winning,2021,Houston,8,0,8,1.0
vs. BCS AQ,2021,Houston,9,2,11,0.8181818181818182
vs. BCS non-AQ,2021,Houston,2,0,2,1.0
vs. FBS Power 5,2021,Houston,1,1,2,0.5
vs. FBS non-Power 5,2021,Houston,10,1,11,0.9090909090909091
in August/September,2021,Houston,3,1,4,0.75
in October,2021,Houston,4,0,4,1.0
in November,2021,Houston,4,0,4,1.0
in December/January,2021,Houston,1,1,2,0.5
All Games,2022,Houston,8,5,13,0.6153846153846154
at Home,2022,Houston,3,3,6,0.5
on Road/Neutral Site,2022,Houston,5,2,7,0.7142857142857143
vs. Conference,2022,Houston,5,3,8,0.625
vs. Non-Conference,2022,Houston,3,2,5,0.6
vs. Ranked (AP),2022,Houston,0,1,1,0.0
vs. Unranked (AP),2022,Houston,8,4,12,0.6666666666666666
vs. FBS (I-A),2022,Houston,8,5,13,0.6153846153846154
vs. FCS (I-AA),2022,Houston,0,0,0,
vs. FBS Winning,2022,Houston,3,3,6,0.5
vs. FBS Non-Winning,2022,Houston,5,2,7,0.7142857142857143
vs. BCS AQ,2022,Houston,5,5,10,0.5
vs. BCS non-AQ,2022,Houston,3,0,3,1.0
vs. FBS Power 5,2022,Houston,0,2,2,0.0
vs. FBS non-Power 5,2022,Houston,8,3,11,0.7272727272727273
in August/September,2022,Houston,2,3,5,0.4
in October,2022,Houston,3,0,3,1.0
in November,2022,Houston,2,2,4,0.5
in December/January,2022,Houston,1,0,1,1.0
All Games,2009,Illinois,3,9,12,0.25
at Home,2009,Illinois,2,4,6,0.3333333333333333
on Road/Neutral Site,2009,Illinois,1,5,6,0.16666666666666666
vs. Conference,2009,Illinois,2,6,8,0.25
vs. Non-Conference,2009,Illinois,1,3,4,0.25
vs. Ranked (AP),2009,Illinois,0,3,3,0.0
vs. Unranked (AP),2009,Illinois,3,6,9,0.3333333333333333
vs. FBS (I-A),2009,Illinois,2,9,11,0.18181818181818182
vs. FCS (I-AA),2009,Illinois,1,0,1,1.0
vs. FBS Winning,2009,Illinois,0,6,6,0.0
vs. FBS Non-Winning,2009,Illinois,2,3,5,0.4
vs. BCS AQ,2009,Illinois,2,8,10,0.2
vs. BCS non-AQ,2009,Illinois,0,1,1,0.0
vs. FBS Power 5,2009,Illinois,2,7,9,0.2222222222222222
vs. FBS non-Power 5,2009,Illinois,0,2,2,0.0
in August/September,2009,Illinois,1,2,3,0.3333333333333333
in October,2009,Illinois,1,4,5,0.2
in November,2009,Illinois,1,2,3,0.3333333333333333
in December/January,2009,Illinois,0,1,1,0.0
All Games,2010,Illinois,7,6,13,0.5384615384615384
at Home,2010,Illinois,4,2,6,0.6666666666666666
on Road/Neutral Site,2010,Illinois,3,4,7,0.42857142857142855
vs. Conference,2010,Illinois,4,4,8,0.5
vs. Non-Conference,2010,Illinois,3,2,5,0.6
vs. Ranked (AP),2010,Illinois,0,3,3,0.0
vs. Unranked (AP),2010,Illinois,7,3,10,0.7
vs. FBS (I-A),2010,Illinois,6,6,12,0.5
vs. FCS (I-AA),2010,Illinois,1,0,1,1.0
vs. FBS Winning,2010,Illinois,4,5,9,0.4444444444444444
vs. FBS Non-Winning,2010,Illinois,2,1,3,0.6666666666666666
vs. BCS AQ,2010,Illinois,5,5,10,0.5
vs. BCS non-AQ,2010,Illinois,1,1,2,0.5
vs. FBS Power 5,2010,Illinois,5,5,10,0.5
vs. FBS non-Power 5,2010,Illinois,1,1,2,0.5
in August/September,2010,Illinois,2,1,3,0.6666666666666666
in October,2010,Illinois,3,2,5,0.6
in November,2010,Illinois,1,2,3,0.3333333333333333
in December/January,2010,Illinois,1,1,2,0.5
All Games,2011,Illinois,7,6,13,0.5384615384615384
at Home,2011,Illinois,5,3,8,0.625
on Road/Neutral Site,2011,Illinois,2,3,5,0.4
vs. Conference,2011,Illinois,2,6,8,0.25
vs. Non-Conference,2011,Illinois,5,0,5,1.0
vs. Ranked (AP),2011,Illinois,0,2,2,0.0
vs. Unranked (AP),2011,Illinois,7,4,11,0.6363636363636364
vs. FBS (I-A),2011,Illinois,6,6,12,0.5
vs. FCS (I-AA),2011,Illinois,1,0,1,1.0
vs. FBS Winning,2011,Illinois,2,4,6,0.3333333333333333
vs. FBS Non-Winning,2011,Illinois,4,2,6,0.6666666666666666
vs. BCS AQ,2011,Illinois,4,6,10,0.4
vs. BCS non-AQ,2011,Illinois,2,0,2,1.0
vs. FBS Power 5,2011,Illinois,4,6,10,0.4
vs. FBS non-Power 5,2011,Illinois,2,0,2,1.0
in August/September,2011,Illinois,4,0,4,1.0
in October,2011,Illinois,2,3,5,0.4
in November,2011,Illinois,0,3,3,0.0
in December/January,2011,Illinois,1,0,1,1.0
All Games,2012,Illinois,2,10,12,0.16666666666666666
at Home,2012,Illinois,2,5,7,0.2857142857142857
on Road/Neutral Site,2012,Illinois,0,5,5,0.0
vs. Conference,2012,Illinois,0,8,8,0.0
vs. Non-Conference,2012,Illinois,2,2,4,0.5
vs. Ranked (AP),2012,Illinois,0,3,3,0.0
vs. Unranked (AP),2012,Illinois,2,7,9,0.2222222222222222
vs. FBS (I-A),2012,Illinois,1,10,11,0.09090909090909091
vs. FCS (I-AA),2012,Illinois,1,0,1,1.0
vs. FBS Winning,2012,Illinois,0,7,7,0.0
vs. FBS Non-Winning,2012,Illinois,1,3,4,0.25
vs. BCS AQ,2012,Illinois,0,9,9,0.0
vs. BCS non-AQ,2012,Illinois,1,1,2,0.5
vs. FBS Power 5,2012,Illinois,0,9,9,0.0
vs. FBS non-Power 5,2012,Illinois,1,1,2,0.5
in August/September,2012,Illinois,2,3,5,0.4
in October,2012,Illinois,0,3,3,0.0
in November,2012,Illinois,0,4,4,0.0
in December/January,2012,Illinois,0,0,0,
All Games,2013,Illinois,4,8,12,0.3333333333333333
at Home,2013,Illinois,3,4,7,0.42857142857142855
on Road/Neutral Site,2013,Illinois,1,4,5,0.2
vs. Conference,2013,Illinois,1,7,8,0.125
vs. Non-Conference,2013,Illinois,3,1,4,0.75
vs. Ranked (AP),2013,Illinois,0,4,4,0.0
vs. Unranked (AP),2013,Illinois,4,4,8,0.5
vs. FBS (I-A),2013,Illinois,3,8,11,0.2727272727272727
vs. FCS (I-AA),2013,Illinois,1,0,1,1.0
vs. FBS Winning,2013,Illinois,1,6,7,0.14285714285714285
vs. FBS Non-Winning,2013,Illinois,2,2,4,0.5
vs. BCS AQ,2013,Illinois,2,8,10,0.2
vs. BCS non-AQ,2013,Illinois,1,0,1,1.0
vs. FBS Power 5,2013,Illinois,1,8,9,0.1111111111111111
vs. FBS non-Power 5,2013,Illinois,2,0,2,1.0
in August/September,2013,Illinois,3,1,4,0.75
in October,2013,Illinois,0,3,3,0.0
in November,2013,Illinois,1,4,5,0.2
in December/January,2013,Illinois,0,0,0,
All Games,2014,Illinois,6,7,13,0.46153846153846156
at Home,2014,Illinois,5,2,7,0.7142857142857143
on Road/Neutral Site,2014,Illinois,1,5,6,0.16666666666666666
vs. Conference,2014,Illinois,3,5,8,0.375
vs. Non-Conference,2014,Illinois,3,2,5,0.6
vs. Ranked (AP),2014,Illinois,0,2,2,0.0
vs. Unranked (AP),2014,Illinois,6,5,11,0.5454545454545454
vs. FBS (I-A),2014,Illinois,5,7,12,0.4166666666666667
vs. FCS (I-AA),2014,Illinois,1,0,1,1.0
vs. FBS Winning,2014,Illinois,4,6,10,0.4
vs. FBS Non-Winning,2014,Illinois,1,1,2,0.5
vs. BCS AQ,2014,Illinois,3,6,9,0.3333333333333333
vs. BCS non-AQ,2014,Illinois,2,1,3,0.6666666666666666
vs. FBS Power 5,2014,Illinois,3,6,9,0.3333333333333333
vs. FBS non-Power 5,2014,Illinois,2,1,3,0.6666666666666666
in August/September,2014,Illinois,3,2,5,0.6
in October,2014,Illinois,1,2,3,0.3333333333333333
in November,2014,Illinois,2,2,4,0.5
in December/January,2014,Illinois,0,1,1,0.0
All Games,2015,Illinois,5,7,12,0.4166666666666667
at Home,2015,Illinois,4,2,6,0.6666666666666666
on Road/Neutral Site,2015,Illinois,1,5,6,0.16666666666666666
vs. Conference,2015,Illinois,2,6,8,0.25
vs. Non-Conference,2015,Illinois,3,1,4,0.75
vs. Ranked (AP),2015,Illinois,0,5,5,0.0
vs. Unranked (AP),2015,Illinois,5,2,7,0.7142857142857143
vs. FBS (I-A),2015,Illinois,4,7,11,0.36363636363636365
vs. FCS (I-AA),2015,Illinois,1,0,1,1.0
vs. FBS Winning,2015,Illinois,1,6,7,0.14285714285714285
vs. FBS Non-Winning,2015,Illinois,3,1,4,0.75
vs. BCS AQ,2015,Illinois,2,7,9,0.2222222222222222
vs. BCS non-AQ,2015,Illinois,2,0,2,1.0
vs. FBS Power 5,2015,Illinois,2,7,9,0.2222222222222222
vs. FBS non-Power 5,2015,Illinois,2,0,2,1.0
in August/September,2015,Illinois,3,1,4,0.75
in October,2015,Illinois,1,3,4,0.25
in November,2015,Illinois,1,3,4,0.25
in December/January,2015,Illinois,0,0,0,
All Games,2016,Illinois,3,9,12,0.25
at Home,2016,Illinois,2,5,7,0.2857142857142857
on Road/Neutral Site,2016,Illinois,1,4,5,0.2
vs. Conference,2016,Illinois,2,7,9,0.2222222222222222
vs. Non-Conference,2016,Illinois,1,2,3,0.3333333333333333
vs. Ranked (AP),2016,Illinois,0,5,5,0.0
vs. Unranked (AP),2016,Illinois,3,4,7,0.42857142857142855
vs. FBS (I-A),2016,Illinois,2,9,11,0.18181818181818182
vs. FCS (I-AA),2016,Illinois,1,0,1,1.0
vs. FBS Winning,2016,Illinois,0,8,8,0.0
vs. FBS Non-Winning,2016,Illinois,2,1,3,0.6666666666666666
vs. BCS AQ,2016,Illinois,2,8,10,0.2
vs. BCS non-AQ,2016,Illinois,0,1,1,0.0
vs. FBS Power 5,2016,Illinois,2,8,10,0.2
vs. FBS non-Power 5,2016,Illinois,0,1,1,0.0
in August/September,2016,Illinois,1,2,3,0.3333333333333333
in October,2016,Illinois,1,4,5,0.2
in November,2016,Illinois,1,3,4,0.25
in December/January,2016,Illinois,0,0,0,
All Games,2017,Illinois,2,10,12,0.16666666666666666
at Home,2017,Illinois,2,5,7,0.2857142857142857
on Road/Neutral Site,2017,Illinois,0,5,5,0.0
vs. Conference,2017,Illinois,0,9,9,0.0
vs. Non-Conference,2017,Illinois,2,1,3,0.6666666666666666
vs. Ranked (AP),2017,Illinois,0,4,4,0.0
vs. Unranked (AP),2017,Illinois,2,6,8,0.25
vs. FBS (I-A),2017,Illinois,2,10,12,0.16666666666666666
vs. FCS (I-AA),2017,Illinois,0,0,0,
vs. FBS Winning,2017,Illinois,0,6,6,0.0
vs. FBS Non-Winning,2017,Illinois,2,4,6,0.3333333333333333
vs. BCS AQ,2017,Illinois,0,10,10,0.0
vs. BCS non-AQ,2017,Illinois,2,0,2,1.0
vs. FBS Power 5,2017,Illinois,0,9,9,0.0
vs. FBS non-Power 5,2017,Illinois,2,1,3,0.6666666666666666
in August/September,2017,Illinois,2,2,4,0.5
in October,2017,Illinois,0,4,4,0.0
in November,2017,Illinois,0,4,4,0.0
in December/January,2017,Illinois,0,0,0,
All Games,2018,Illinois,4,8,12,0.3333333333333333
at Home,2018,Illinois,3,3,6,0.5
on Road/Neutral Site,2018,Illinois,1,5,6,0.16666666666666666
vs. Conference,2018,Illinois,2,7,9,0.2222222222222222
vs. Non-Conference,2018,Illinois,2,1,3,0.6666666666666666
vs. Ranked (AP),2018,Illinois,0,3,3,0.0
vs. Unranked (AP),2018,Illinois,4,5,9,0.4444444444444444
vs. FBS (I-A),2018,Illinois,3,8,11,0.2727272727272727
vs. FCS (I-AA),2018,Illinois,1,0,1,1.0
vs. FBS Winning,2018,Illinois,1,5,6,0.16666666666666666
vs. FBS Non-Winning,2018,Illinois,2,3,5,0.4
vs. BCS AQ,2018,Illinois,2,8,10,0.2
vs. BCS non-AQ,2018,Illinois,1,0,1,1.0
vs. FBS Power 5,2018,Illinois,2,7,9,0.2222222222222222
vs. FBS non-Power 5,2018,Illinois,1,1,2,0.5
in August/September,2018,Illinois,2,2,4,0.5
in October,2018,Illinois,1,3,4,0.25
in November,2018,Illinois,1,3,4,0.25
in December/January,2018,Illinois,0,0,0,
All Games,2019,Illinois,6,7,13,0.46153846153846156
at Home,2019,Illinois,3,4,7,0.42857142857142855
on Road/Neutral Site,2019,Illinois,3,3,6,0.5
vs. Conference,2019,Illinois,4,5,9,0.4444444444444444
vs. Non-Conference,2019,Illinois,2,2,4,0.5
vs. Ranked (AP),2019,Illinois,1,3,4,0.25
vs. Unranked (AP),2019,Illinois,5,4,9,0.5555555555555556
vs. FBS (I-A),2019,Illinois,6,7,13,0.46153846153846156
vs. FCS (I-AA),2019,Illinois,0,0,0,
vs. FBS Winning,2019,Illinois,2,4,6,0.3333333333333333
vs. FBS Non-Winning,2019,Illinois,4,3,7,0.5714285714285714
vs. BCS AQ,2019,Illinois,5,6,11,0.45454545454545453
vs. BCS non-AQ,2019,Illinois,1,1,2,0.5
vs. FBS Power 5,2019,Illinois,4,6,10,0.4
vs. FBS non-Power 5,2019,Illinois,2,1,3,0.6666666666666666
in August/September,2019,Illinois,2,2,4,0.5
in October,2019,Illinois,2,2,4,0.5
in November,2019,Illinois,2,2,4,0.5
in December/January,2019,Illinois,0,1,1,0.0
All Games,2020,Illinois,2,6,8,0.25
at Home,2020,Illinois,0,3,3,0.0
on Road/Neutral Site,2020,Illinois,2,3,5,0.4
vs. Conference,2020,Illinois,2,6,8,0.25
vs. Non-Conference,2020,Illinois,0,0,0,
vs. Ranked (AP),2020,Illinois,0,2,2,0.0
vs. Unranked (AP),2020,Illinois,2,4,6,0.3333333333333333
vs. FBS (I-A),2020,Illinois,2,6,8,0.25
vs. FCS (I-AA),2020,Illinois,0,0,0,
vs. FBS Winning,2020,Illinois,0,3,3,0.0
vs. FBS Non-Winning,2020,Illinois,2,3,5,0.4
vs. BCS AQ,2020,Illinois,2,6,8,0.25
vs. BCS non-AQ,2020,Illinois,0,0,0,
vs. FBS Power 5,2020,Illinois,2,6,8,0.25
vs. FBS non-Power 5,2020,Illinois,0,0,0,
in August/September,2020,Illinois,0,0,0,
in October,2020,Illinois,0,2,2,0.0
in November,2020,Illinois,2,1,3,0.6666666666666666
in December/January,2020,Illinois,0,3,3,0.0
All Games,2021,Illinois,5,7,12,0.4166666666666667
at Home,2021,Illinois,3,4,7,0.42857142857142855
on Road/Neutral Site,2021,Illinois,2,3,5,0.4
vs. Conference,2021,Illinois,4,5,9,0.4444444444444444
vs. Non-Conference,2021,Illinois,1,2,3,0.3333333333333333
vs. Ranked (AP),2021,Illinois,0,1,1,0.0
vs. Unranked (AP),2021,Illinois,5,6,11,0.45454545454545453
vs. FBS (I-A),2021,Illinois,5,7,12,0.4166666666666667
vs. FCS (I-AA),2021,Illinois,0,0,0,
vs. FBS Winning,2021,Illinois,2,5,7,0.2857142857142857
vs. FBS Non-Winning,2021,Illinois,3,2,5,0.6
vs. BCS AQ,2021,Illinois,4,6,10,0.4
vs. BCS non-AQ,2021,Illinois,1,1,2,0.5
vs. FBS Power 5,2021,Illinois,4,6,10,0.4
vs. FBS non-Power 5,2021,Illinois,1,1,2,0.5
in August/September,2021,Illinois,1,4,5,0.2
in October,2021,Illinois,2,2,4,0.5
in November,2021,Illinois,2,1,3,0.6666666666666666
in December/January,2021,Illinois,0,0,0,
All Games,2022,Illinois,8,5,13,0.6153846153846154
at Home,2022,Illinois,5,2,7,0.7142857142857143
on Road/Neutral Site,2022,Illinois,3,3,6,0.5
vs. Conference,2022,Illinois,5,4,9,0.5555555555555556
vs. Non-Conference,2022,Illinois,3,1,4,0.75
vs. Ranked (AP),2022,Illinois,0,2,2,0.0
vs. Unranked (AP),2022,Illinois,8,3,11,0.7272727272727273
vs. FBS (I-A),2022,Illinois,7,5,12,0.5833333333333334
vs. FCS (I-AA),2022,Illinois,1,0,1,1.0
vs. FBS Winning,2022,Illinois,4,3,7,0.5714285714285714
vs. FBS Non-Winning,2022,Illinois,3,2,5,0.6
vs. BCS AQ,2022,Illinois,6,5,11,0.5454545454545454
vs. BCS non-AQ,2022,Illinois,1,0,1,1.0
vs. FBS Power 5,2022,Illinois,6,5,11,0.5454545454545454
vs. FBS non-Power 5,2022,Illinois,1,0,1,1.0
in August/September,2022,Illinois,3,1,4,0.75
in October,2022,Illinois,4,0,4,1.0
in November,2022,Illinois,1,3,4,0.25
in December/January,2022,Illinois,0,1,1,0.0
All Games,2009,Indiana,4,8,12,0.3333333333333333
at Home,2009,Indiana,3,3,6,0.5
on Road/Neutral Site,2009,Indiana,1,5,6,0.16666666666666666
vs. Conference,2009,Indiana,1,7,8,0.125
vs. Non-Conference,2009,Indiana,3,1,4,0.75
vs. Ranked (AP),2009,Indiana,0,4,4,0.0
vs. Unranked (AP),2009,Indiana,4,4,8,0.5
vs. FBS (I-A),2009,Indiana,3,8,11,0.2727272727272727
vs. FCS (I-AA),2009,Indiana,1,0,1,1.0
vs. FBS Winning,2009,Indiana,0,5,5,0.0
vs. FBS Non-Winning,2009,Indiana,3,3,6,0.5
vs. BCS AQ,2009,Indiana,1,8,9,0.1111111111111111
vs. BCS non-AQ,2009,Indiana,2,0,2,1.0
vs. FBS Power 5,2009,Indiana,1,8,9,0.1111111111111111
vs. FBS non-Power 5,2009,Indiana,2,0,2,1.0
in August/September,2009,Indiana,3,1,4,0.75
in October,2009,Indiana,1,4,5,0.2
in November,2009,Indiana,0,3,3,0.0
in December/January,2009,Indiana,0,0,0,
All Games,2010,Indiana,5,7,12,0.4166666666666667
at Home,2010,Indiana,3,3,6,0.5
on Road/Neutral Site,2010,Indiana,2,4,6,0.3333333333333333
vs. Conference,2010,Indiana,1,7,8,0.125
vs. Non-Conference,2010,Indiana,4,0,4,1.0
vs. Ranked (AP),2010,Indiana,0,2,2,0.0
vs. Unranked (AP),2010,Indiana,5,5,10,0.5
vs. FBS (I-A),2010,Indiana,4,7,11,0.36363636363636365
vs. FCS (I-AA),2010,Indiana,1,0,1,1.0
vs. FBS Winning,2010,Indiana,0,7,7,0.0
vs. FBS Non-Winning,2010,Indiana,4,0,4,1.0
vs. BCS AQ,2010,Indiana,1,7,8,0.125
vs. BCS non-AQ,2010,Indiana,3,0,3,1.0
vs. FBS Power 5,2010,Indiana,1,7,8,0.125
vs. FBS non-Power 5,2010,Indiana,3,0,3,1.0
in August/September,2010,Indiana,3,0,3,1.0
in October,2010,Indiana,1,4,5,0.2
in November,2010,Indiana,1,3,4,0.25
in December/January,2010,Indiana,0,0,0,
All Games,2011,Indiana,1,11,12,0.08333333333333333
at Home,2011,Indiana,1,5,6,0.16666666666666666
on Road/Neutral Site,2011,Indiana,0,6,6,0.0
vs. Conference,2011,Indiana,0,8,8,0.0
vs. Non-Conference,2011,Indiana,1,3,4,0.25
vs. Ranked (AP),2011,Indiana,0,2,2,0.0
vs. Unranked (AP),2011,Indiana,1,9,10,0.1
vs. FBS (I-A),2011,Indiana,0,11,11,0.0
vs. FCS (I-AA),2011,Indiana,1,0,1,1.0
vs. FBS Winning,2011,Indiana,0,7,7,0.0
vs. FBS Non-Winning,2011,Indiana,0,4,4,0.0
vs. BCS AQ,2011,Indiana,0,9,9,0.0
vs. BCS non-AQ,2011,Indiana,0,2,2,0.0
vs. FBS Power 5,2011,Indiana,0,9,9,0.0
vs. FBS non-Power 5,2011,Indiana,0,2,2,0.0
in August/September,2011,Indiana,1,3,4,0.25
in October,2011,Indiana,0,5,5,0.0
in November,2011,Indiana,0,3,3,0.0
in December/January,2011,Indiana,0,0,0,
All Games,2012,Indiana,4,8,12,0.3333333333333333
at Home,2012,Indiana,2,4,6,0.3333333333333333
on Road/Neutral Site,2012,Indiana,2,4,6,0.3333333333333333
vs. Conference,2012,Indiana,2,6,8,0.25
vs. Non-Conference,2012,Indiana,2,2,4,0.5
vs. Ranked (AP),2012,Indiana,0,2,2,0.0
vs. Unranked (AP),2012,Indiana,4,6,10,0.4
vs. FBS (I-A),2012,Indiana,3,8,11,0.2727272727272727
vs. FCS (I-AA),2012,Indiana,1,0,1,1.0
vs. FBS Winning,2012,Indiana,0,7,7,0.0
vs. FBS Non-Winning,2012,Indiana,3,1,4,0.75
vs. BCS AQ,2012,Indiana,2,6,8,0.25
vs. BCS non-AQ,2012,Indiana,1,2,3,0.3333333333333333
vs. FBS Power 5,2012,Indiana,2,6,8,0.25
vs. FBS non-Power 5,2012,Indiana,1,2,3,0.3333333333333333
in August/September,2012,Indiana,2,2,4,0.5
in October,2012,Indiana,1,3,4,0.25
in November,2012,Indiana,1,3,4,0.25
in December/January,2012,Indiana,0,0,0,
All Games,2013,Indiana,5,7,12,0.4166666666666667
at Home,2013,Indiana,5,3,8,0.625
on Road/Neutral Site,2013,Indiana,0,4,4,0.0
vs. Conference,2013,Indiana,3,5,8,0.375
vs. Non-Conference,2013,Indiana,2,2,4,0.5
vs. Ranked (AP),2013,Indiana,0,4,4,0.0
vs. Unranked (AP),2013,Indiana,5,3,8,0.625
vs. FBS (I-A),2013,Indiana,4,7,11,0.36363636363636365
vs. FCS (I-AA),2013,Indiana,1,0,1,1.0
vs. FBS Winning,2013,Indiana,2,7,9,0.2222222222222222
vs. FBS Non-Winning,2013,Indiana,2,0,2,1.0
vs. BCS AQ,2013,Indiana,3,6,9,0.3333333333333333
vs. BCS non-AQ,2013,Indiana,1,1,2,0.5
vs. FBS Power 5,2013,Indiana,3,6,9,0.3333333333333333
vs. FBS non-Power 5,2013,Indiana,1,1,2,0.5
in August/September,2013,Indiana,2,2,4,0.5
in October,2013,Indiana,1,2,3,0.3333333333333333
in November,2013,Indiana,2,3,5,0.4
in December/January,2013,Indiana,0,0,0,
All Games,2014,Indiana,4,8,12,0.3333333333333333
at Home,2014,Indiana,3,3,6,0.5
on Road/Neutral Site,2014,Indiana,1,5,6,0.16666666666666666
vs. Conference,2014,Indiana,1,7,8,0.125
vs. Non-Conference,2014,Indiana,3,1,4,0.75
vs. Ranked (AP),2014,Indiana,1,2,3,0.3333333333333333
vs. Unranked (AP),2014,Indiana,3,6,9,0.3333333333333333
vs. FBS (I-A),2014,Indiana,3,8,11,0.2727272727272727
vs. FCS (I-AA),2014,Indiana,1,0,1,1.0
vs. FBS Winning,2014,Indiana,1,7,8,0.125
vs. FBS Non-Winning,2014,Indiana,2,1,3,0.6666666666666666
vs. BCS AQ,2014,Indiana,2,7,9,0.2222222222222222
vs. BCS non-AQ,2014,Indiana,1,1,2,0.5
vs. FBS Power 5,2014,Indiana,2,7,9,0.2222222222222222
vs. FBS non-Power 5,2014,Indiana,1,1,2,0.5
in August/September,2014,Indiana,2,2,4,0.5
in October,2014,Indiana,1,2,3,0.3333333333333333
in November,2014,Indiana,1,4,5,0.2
in December/January,2014,Indiana,0,0,0,
All Games,2015,Indiana,6,7,13,0.46153846153846156
at Home,2015,Indiana,3,4,7,0.42857142857142855
on Road/Neutral Site,2015,Indiana,3,3,6,0.5
vs. Conference,2015,Indiana,2,6,8,0.25
vs. Non-Conference,2015,Indiana,4,1,5,0.8
vs. Ranked (AP),2015,Indiana,1,4,5,0.2
vs. Unranked (AP),2015,Indiana,5,3,8,0.625
vs. FBS (I-A),2015,Indiana,5,7,12,0.4166666666666667
vs. FCS (I-AA),2015,Indiana,1,0,1,1.0
vs. FBS Winning,2015,Indiana,1,6,7,0.14285714285714285
vs. FBS Non-Winning,2015,Indiana,4,1,5,0.8
vs. BCS AQ,2015,Indiana,3,7,10,0.3
vs. BCS non-AQ,2015,Indiana,2,0,2,1.0
vs. FBS Power 5,2015,Indiana,3,7,10,0.3
vs. FBS non-Power 5,2015,Indiana,2,0,2,1.0
in August/September,2015,Indiana,4,0,4,1.0
in October,2015,Indiana,0,4,4,0.0
in November,2015,Indiana,2,2,4,0.5
in December/January,2015,Indiana,0,1,1,0.0
All Games,2016,Indiana,6,7,13,0.46153846153846156
at Home,2016,Indiana,4,3,7,0.5714285714285714
on Road/Neutral Site,2016,Indiana,2,4,6,0.3333333333333333
vs. Conference,2016,Indiana,4,5,9,0.4444444444444444
vs. Non-Conference,2016,Indiana,2,2,4,0.5
vs. Ranked (AP),2016,Indiana,0,4,4,0.0
vs. Unranked (AP),2016,Indiana,6,3,9,0.6666666666666666
vs. FBS (I-A),2016,Indiana,6,7,13,0.46153846153846156
vs. FCS (I-AA),2016,Indiana,0,0,0,
vs. FBS Winning,2016,Indiana,0,7,7,0.0
vs. FBS Non-Winning,2016,Indiana,6,0,6,1.0
vs. BCS AQ,2016,Indiana,4,7,11,0.36363636363636365
vs. BCS non-AQ,2016,Indiana,2,0,2,1.0
vs. FBS Power 5,2016,Indiana,4,7,11,0.36363636363636365
vs. FBS non-Power 5,2016,Indiana,2,0,2,1.0
in August/September,2016,Indiana,2,1,3,0.6666666666666666
in October,2016,Indiana,2,3,5,0.4
in November,2016,Indiana,2,2,4,0.5
in December/January,2016,Indiana,0,1,1,0.0
All Games,2017,Indiana,5,7,12,0.4166666666666667
at Home,2017,Indiana,3,3,6,0.5
on Road/Neutral Site,2017,Indiana,2,4,6,0.3333333333333333
vs. Conference,2017,Indiana,2,7,9,0.2222222222222222
vs. Non-Conference,2017,Indiana,3,0,3,1.0
vs. Ranked (AP),2017,Indiana,0,4,4,0.0
vs. Unranked (AP),2017,Indiana,5,3,8,0.625
vs. FBS (I-A),2017,Indiana,4,7,11,0.36363636363636365
vs. FCS (I-AA),2017,Indiana,1,0,1,1.0
vs. FBS Winning,2017,Indiana,0,6,6,0.0
vs. FBS Non-Winning,2017,Indiana,4,1,5,0.8
vs. BCS AQ,2017,Indiana,3,7,10,0.3
vs. BCS non-AQ,2017,Indiana,1,0,1,1.0
vs. FBS Power 5,2017,Indiana,3,7,10,0.3
vs. FBS non-Power 5,2017,Indiana,1,0,1,1.0
in August/September,2017,Indiana,2,2,4,0.5
in October,2017,Indiana,1,3,4,0.25
in November,2017,Indiana,2,2,4,0.5
in December/January,2017,Indiana,0,0,0,
All Games,2018,Indiana,5,7,12,0.4166666666666667
at Home,2018,Indiana,3,4,7,0.42857142857142855
on Road/Neutral Site,2018,Indiana,2,3,5,0.4
vs. Conference,2018,Indiana,2,7,9,0.2222222222222222
vs. Non-Conference,2018,Indiana,3,0,3,1.0
vs. Ranked (AP),2018,Indiana,0,4,4,0.0
vs. Unranked (AP),2018,Indiana,5,3,8,0.625
vs. FBS (I-A),2018,Indiana,5,7,12,0.4166666666666667
vs. FCS (I-AA),2018,Indiana,0,0,0,
vs. FBS Winning,2018,Indiana,2,6,8,0.25
vs. FBS Non-Winning,2018,Indiana,3,1,4,0.75
vs. BCS AQ,2018,Indiana,3,7,10,0.3
vs. BCS non-AQ,2018,Indiana,2,0,2,1.0
vs. FBS Power 5,2018,Indiana,3,7,10,0.3
vs. FBS non-Power 5,2018,Indiana,2,0,2,1.0
in August/September,2018,Indiana,4,1,5,0.8
in October,2018,Indiana,0,4,4,0.0
in November,2018,Indiana,1,2,3,0.3333333333333333
in December/January,2018,Indiana,0,0,0,
All Games,2019,Indiana,8,5,13,0.6153846153846154
at Home,2019,Indiana,4,2,6,0.6666666666666666
on Road/Neutral Site,2019,Indiana,4,3,7,0.5714285714285714
vs. Conference,2019,Indiana,5,4,9,0.5555555555555556
vs. Non-Conference,2019,Indiana,3,1,4,0.75
vs. Ranked (AP),2019,Indiana,0,3,3,0.0
vs. Unranked (AP),2019,Indiana,8,2,10,0.8
vs. FBS (I-A),2019,Indiana,7,5,12,0.5833333333333334
vs. FCS (I-AA),2019,Indiana,1,0,1,1.0
vs. FBS Winning,2019,Indiana,0,5,5,0.0
vs. FBS Non-Winning,2019,Indiana,7,0,7,1.0
vs. BCS AQ,2019,Indiana,6,5,11,0.5454545454545454
vs. BCS non-AQ,2019,Indiana,1,0,1,1.0
vs. FBS Power 5,2019,Indiana,5,5,10,0.5
vs. FBS non-Power 5,2019,Indiana,2,0,2,1.0
in August/September,2019,Indiana,3,2,5,0.6
in October,2019,Indiana,3,0,3,1.0
in November,2019,Indiana,2,2,4,0.5
in December/January,2019,Indiana,0,1,1,0.0
All Games,2020,Indiana,6,2,8,0.75
at Home,2020,Indiana,3,0,3,1.0
on Road/Neutral Site,2020,Indiana,3,2,5,0.6
vs. Conference,2020,Indiana,6,1,7,0.8571428571428571
vs. Non-Conference,2020,Indiana,0,1,1,0.0
vs. Ranked (AP),2020,Indiana,0,1,1,0.0
vs. Unranked (AP),2020,Indiana,6,1,7,0.8571428571428571
vs. FBS (I-A),2020,Indiana,6,2,8,0.75
vs. FCS (I-AA),2020,Indiana,0,0,0,
vs. FBS Winning,2020,Indiana,1,1,2,0.5
vs. FBS Non-Winning,2020,Indiana,5,1,6,0.8333333333333334
vs. BCS AQ,2020,Indiana,6,2,8,0.75
vs. BCS non-AQ,2020,Indiana,0,0,0,
vs. FBS Power 5,2020,Indiana,6,2,8,0.75
vs. FBS non-Power 5,2020,Indiana,0,0,0,
in August/September,2020,Indiana,0,0,0,
in October,2020,Indiana,2,0,2,1.0
in November,2020,Indiana,3,1,4,0.75
in December/January,2020,Indiana,1,1,2,0.5
All Games,2021,Indiana,2,10,12,0.16666666666666666
at Home,2021,Indiana,1,5,6,0.16666666666666666
on Road/Neutral Site,2021,Indiana,1,5,6,0.16666666666666666
vs. Conference,2021,Indiana,0,9,9,0.0
vs. Non-Conference,2021,Indiana,2,1,3,0.6666666666666666
vs. Ranked (AP),2021,Indiana,0,5,5,0.0
vs. Unranked (AP),2021,Indiana,2,5,7,0.2857142857142857
vs. FBS (I-A),2021,Indiana,1,10,11,0.09090909090909091
vs. FCS (I-AA),2021,Indiana,1,0,1,1.0
vs. FBS Winning,2021,Indiana,1,9,10,0.1
vs. FBS Non-Winning,2021,Indiana,0,1,1,0.0
vs. BCS AQ,2021,Indiana,0,10,10,0.0
vs. BCS non-AQ,2021,Indiana,1,0,1,1.0
vs. FBS Power 5,2021,Indiana,0,9,9,0.0
vs. FBS non-Power 5,2021,Indiana,1,1,2,0.5
in August/September,2021,Indiana,2,2,4,0.5
in October,2021,Indiana,0,4,4,0.0
in November,2021,Indiana,0,4,4,0.0
in December/January,2021,Indiana,0,0,0,
All Games,2022,Indiana,4,8,12,0.3333333333333333
at Home,2022,Indiana,3,4,7,0.42857142857142855
on Road/Neutral Site,2022,Indiana,1,4,5,0.2
vs. Conference,2022,Indiana,2,7,9,0.2222222222222222
vs. Non-Conference,2022,Indiana,2,1,3,0.6666666666666666
vs. Ranked (AP),2022,Indiana,0,3,3,0.0
vs. Unranked (AP),2022,Indiana,4,5,9,0.4444444444444444
vs. FBS (I-A),2022,Indiana,3,8,11,0.2727272727272727
vs. FCS (I-AA),2022,Indiana,1,0,1,1.0
vs. FBS Winning,2022,Indiana,2,6,8,0.25
vs. FBS Non-Winning,2022,Indiana,1,2,3,0.3333333333333333
vs. BCS AQ,2022,Indiana,2,8,10,0.2
vs. BCS non-AQ,2022,Indiana,1,0,1,1.0
vs. FBS Power 5,2022,Indiana,2,7,9,0.2222222222222222
vs. FBS non-Power 5,2022,Indiana,1,1,2,0.5
in August/September,2022,Indiana,3,1,4,0.75
in October,2022,Indiana,0,4,4,0.0
in November,2022,Indiana,1,3,4,0.25
in December/January,2022,Indiana,0,0,0,
All Games,2009,Iowa,11,2,13,0.8461538461538461
at Home,2009,Iowa,6,1,7,0.8571428571428571
on Road/Neutral Site,2009,Iowa,5,1,6,0.8333333333333334
vs. Conference,2009,Iowa,6,2,8,0.75
vs. Non-Conference,2009,Iowa,5,0,5,1.0
vs. Ranked (AP),2009,Iowa,3,1,4,0.75
vs. Unranked (AP),2009,Iowa,8,1,9,0.8888888888888888
vs. FBS (I-A),2009,Iowa,10,2,12,0.8333333333333334
vs. FCS (I-AA),2009,Iowa,1,0,1,1.0
vs. FBS Winning,2009,Iowa,5,2,7,0.7142857142857143
vs. FBS Non-Winning,2009,Iowa,5,0,5,1.0
vs. BCS AQ,2009,Iowa,9,2,11,0.8181818181818182
vs. BCS non-AQ,2009,Iowa,1,0,1,1.0
vs. FBS Power 5,2009,Iowa,9,2,11,0.8181818181818182
vs. FBS non-Power 5,2009,Iowa,1,0,1,1.0
in August/September,2009,Iowa,4,0,4,1.0
in October,2009,Iowa,5,0,5,1.0
in November,2009,Iowa,1,2,3,0.3333333333333333
in December/January,2009,Iowa,1,0,1,1.0
All Games,2010,Iowa,8,5,13,0.6153846153846154
at Home,2010,Iowa,5,2,7,0.7142857142857143
on Road/Neutral Site,2010,Iowa,3,3,6,0.5
vs. Conference,2010,Iowa,4,4,8,0.5
vs. Non-Conference,2010,Iowa,4,1,5,0.8
vs. Ranked (AP),2010,Iowa,2,2,4,0.5
vs. Unranked (AP),2010,Iowa,6,3,9,0.6666666666666666
vs. FBS (I-A),2010,Iowa,7,5,12,0.5833333333333334
vs. FCS (I-AA),2010,Iowa,1,0,1,1.0
vs. FBS Winning,2010,Iowa,4,4,8,0.5
vs. FBS Non-Winning,2010,Iowa,3,1,4,0.75
vs. BCS AQ,2010,Iowa,6,5,11,0.5454545454545454
vs. BCS non-AQ,2010,Iowa,1,0,1,1.0
vs. FBS Power 5,2010,Iowa,6,5,11,0.5454545454545454
vs. FBS non-Power 5,2010,Iowa,1,0,1,1.0
in August/September,2010,Iowa,3,1,4,0.75
in October,2010,Iowa,3,1,4,0.75
in November,2010,Iowa,1,3,4,0.25
in December/January,2010,Iowa,1,0,1,1.0
All Games,2011,Iowa,7,6,13,0.5384615384615384
at Home,2011,Iowa,6,1,7,0.8571428571428571
on Road/Neutral Site,2011,Iowa,1,5,6,0.16666666666666666
vs. Conference,2011,Iowa,4,4,8,0.5
vs. Non-Conference,2011,Iowa,3,2,5,0.6
vs. Ranked (AP),2011,Iowa,1,3,4,0.25
vs. Unranked (AP),2011,Iowa,6,3,9,0.6666666666666666
vs. FBS (I-A),2011,Iowa,6,6,12,0.5
vs. FCS (I-AA),2011,Iowa,1,0,1,1.0
vs. FBS Winning,2011,Iowa,2,4,6,0.3333333333333333
vs. FBS Non-Winning,2011,Iowa,4,2,6,0.6666666666666666
vs. BCS AQ,2011,Iowa,5,6,11,0.45454545454545453
vs. BCS non-AQ,2011,Iowa,1,0,1,1.0
vs. FBS Power 5,2011,Iowa,4,6,10,0.4
vs. FBS non-Power 5,2011,Iowa,2,0,2,1.0
in August/September,2011,Iowa,3,1,4,0.75
in October,2011,Iowa,2,2,4,0.5
in November,2011,Iowa,2,2,4,0.5
in December/January,2011,Iowa,0,1,1,0.0
All Games,2012,Iowa,4,8,12,0.3333333333333333
at Home,2012,Iowa,2,5,7,0.2857142857142857
on Road/Neutral Site,2012,Iowa,2,3,5,0.4
vs. Conference,2012,Iowa,2,6,8,0.25
vs. Non-Conference,2012,Iowa,2,2,4,0.5
vs. Ranked (AP),2012,Iowa,1,3,4,0.25
vs. Unranked (AP),2012,Iowa,3,5,8,0.375
vs. FBS (I-A),2012,Iowa,3,8,11,0.2727272727272727
vs. FCS (I-AA),2012,Iowa,1,0,1,1.0
vs. FBS Winning,2012,Iowa,2,5,7,0.2857142857142857
vs. FBS Non-Winning,2012,Iowa,1,3,4,0.25
vs. BCS AQ,2012,Iowa,2,7,9,0.2222222222222222
vs. BCS non-AQ,2012,Iowa,1,1,2,0.5
vs. FBS Power 5,2012,Iowa,2,7,9,0.2222222222222222
vs. FBS non-Power 5,2012,Iowa,1,1,2,0.5
in August/September,2012,Iowa,3,2,5,0.6
in October,2012,Iowa,1,2,3,0.3333333333333333
in November,2012,Iowa,0,4,4,0.0
in December/January,2012,Iowa,0,0,0,
All Games,2013,Iowa,8,5,13,0.6153846153846154
at Home,2013,Iowa,4,3,7,0.5714285714285714
on Road/Neutral Site,2013,Iowa,4,2,6,0.6666666666666666
vs. Conference,2013,Iowa,5,3,8,0.625
vs. Non-Conference,2013,Iowa,3,2,5,0.6
vs. Ranked (AP),2013,Iowa,0,4,4,0.0
vs. Unranked (AP),2013,Iowa,8,1,9,0.8888888888888888
vs. FBS (I-A),2013,Iowa,7,5,12,0.5833333333333334
vs. FCS (I-AA),2013,Iowa,1,0,1,1.0
vs. FBS Winning,2013,Iowa,3,5,8,0.375
vs. FBS Non-Winning,2013,Iowa,4,0,4,1.0
vs. BCS AQ,2013,Iowa,6,4,10,0.6
vs. BCS non-AQ,2013,Iowa,1,1,2,0.5
vs. FBS Power 5,2013,Iowa,6,4,10,0.6
vs. FBS non-Power 5,2013,Iowa,1,1,2,0.5
in August/September,2013,Iowa,4,1,5,0.8
in October,2013,Iowa,1,2,3,0.3333333333333333
in November,2013,Iowa,3,1,4,0.75
in December/January,2013,Iowa,0,1,1,0.0
All Games,2014,Iowa,7,6,13,0.5384615384615384
at Home,2014,Iowa,4,3,7,0.5714285714285714
on Road/Neutral Site,2014,Iowa,3,3,6,0.5
vs. Conference,2014,Iowa,4,4,8,0.5
vs. Non-Conference,2014,Iowa,3,2,5,0.6
vs. Ranked (AP),2014,Iowa,0,1,1,0.0
vs. Unranked (AP),2014,Iowa,7,5,12,0.5833333333333334
vs. FBS (I-A),2014,Iowa,6,6,12,0.5
vs. FCS (I-AA),2014,Iowa,1,0,1,1.0
vs. FBS Winning,2014,Iowa,0,5,5,0.0
vs. FBS Non-Winning,2014,Iowa,6,1,7,0.8571428571428571
vs. BCS AQ,2014,Iowa,5,6,11,0.45454545454545453
vs. BCS non-AQ,2014,Iowa,1,0,1,1.0
vs. FBS Power 5,2014,Iowa,5,6,11,0.45454545454545453
vs. FBS non-Power 5,2014,Iowa,1,0,1,1.0
in August/September,2014,Iowa,4,1,5,0.8
in October,2014,Iowa,1,1,2,0.5
in November,2014,Iowa,2,3,5,0.4
in December/January,2014,Iowa,0,1,1,0.0
All Games,2015,Iowa,12,2,14,0.8571428571428571
at Home,2015,Iowa,7,0,7,1.0
on Road/Neutral Site,2015,Iowa,5,2,7,0.7142857142857143
vs. Conference,2015,Iowa,8,1,9,0.8888888888888888
vs. Non-Conference,2015,Iowa,4,1,5,0.8
vs. Ranked (AP),2015,Iowa,2,2,4,0.5
vs. Unranked (AP),2015,Iowa,10,0,10,1.0
vs. FBS (I-A),2015,Iowa,11,2,13,0.8461538461538461
vs. FCS (I-AA),2015,Iowa,1,0,1,1.0
vs. FBS Winning,2015,Iowa,3,2,5,0.6
vs. FBS Non-Winning,2015,Iowa,8,0,8,1.0
vs. BCS AQ,2015,Iowa,10,2,12,0.8333333333333334
vs. BCS non-AQ,2015,Iowa,1,0,1,1.0
vs. FBS Power 5,2015,Iowa,10,2,12,0.8333333333333334
vs. FBS non-Power 5,2015,Iowa,1,0,1,1.0
in August/September,2015,Iowa,4,0,4,1.0
in October,2015,Iowa,4,0,4,1.0
in November,2015,Iowa,4,0,4,1.0
in December/January,2015,Iowa,0,2,2,0.0
All Games,2016,Iowa,8,5,13,0.6153846153846154
at Home,2016,Iowa,4,3,7,0.5714285714285714
on Road/Neutral Site,2016,Iowa,4,2,6,0.6666666666666666
vs. Conference,2016,Iowa,6,3,9,0.6666666666666666
vs. Non-Conference,2016,Iowa,2,2,4,0.5
vs. Ranked (AP),2016,Iowa,2,3,5,0.4
vs. Unranked (AP),2016,Iowa,6,2,8,0.75
vs. FBS (I-A),2016,Iowa,8,4,12,0.6666666666666666
vs. FCS (I-AA),2016,Iowa,0,1,1,0.0
vs. FBS Winning,2016,Iowa,3,4,7,0.42857142857142855
vs. FBS Non-Winning,2016,Iowa,5,0,5,1.0
vs. BCS AQ,2016,Iowa,7,4,11,0.6363636363636364
vs. BCS non-AQ,2016,Iowa,1,0,1,1.0
vs. FBS Power 5,2016,Iowa,7,4,11,0.6363636363636364
vs. FBS non-Power 5,2016,Iowa,1,0,1,1.0
in August/September,2016,Iowa,3,1,4,0.75
in October,2016,Iowa,2,2,4,0.5
in November,2016,Iowa,3,1,4,0.75
in December/January,2016,Iowa,0,1,1,0.0
All Games,2017,Iowa,8,5,13,0.6153846153846154
at Home,2017,Iowa,5,2,7,0.7142857142857143
on Road/Neutral Site,2017,Iowa,3,3,6,0.5
vs. Conference,2017,Iowa,4,5,9,0.4444444444444444
vs. Non-Conference,2017,Iowa,4,0,4,1.0
vs. Ranked (AP),2017,Iowa,1,4,5,0.2
vs. Unranked (AP),2017,Iowa,7,1,8,0.875
vs. FBS (I-A),2017,Iowa,8,5,13,0.6153846153846154
vs. FCS (I-AA),2017,Iowa,0,0,0,
vs. FBS Winning,2017,Iowa,5,5,10,0.5
vs. FBS Non-Winning,2017,Iowa,3,0,3,1.0
vs. BCS AQ,2017,Iowa,6,5,11,0.5454545454545454
vs. BCS non-AQ,2017,Iowa,2,0,2,1.0
vs. FBS Power 5,2017,Iowa,6,5,11,0.5454545454545454
vs. FBS non-Power 5,2017,Iowa,2,0,2,1.0
in August/September,2017,Iowa,3,2,5,0.6
in October,2017,Iowa,2,1,3,0.6666666666666666
in November,2017,Iowa,2,2,4,0.5
in December/January,2017,Iowa,1,0,1,1.0
All Games,2018,Iowa,9,4,13,0.6923076923076923
at Home,2018,Iowa,5,2,7,0.7142857142857143
on Road/Neutral Site,2018,Iowa,4,2,6,0.6666666666666666
vs. Conference,2018,Iowa,5,4,9,0.5555555555555556
vs. Non-Conference,2018,Iowa,4,0,4,1.0
vs. Ranked (AP),2018,Iowa,0,2,2,0.0
vs. Unranked (AP),2018,Iowa,9,2,11,0.8181818181818182
vs. FBS (I-A),2018,Iowa,8,4,12,0.6666666666666666
vs. FCS (I-AA),2018,Iowa,1,0,1,1.0
vs. FBS Winning,2018,Iowa,4,3,7,0.5714285714285714
vs. FBS Non-Winning,2018,Iowa,4,1,5,0.8
vs. BCS AQ,2018,Iowa,7,4,11,0.6363636363636364
vs. BCS non-AQ,2018,Iowa,1,0,1,1.0
vs. FBS Power 5,2018,Iowa,7,4,11,0.6363636363636364
vs. FBS non-Power 5,2018,Iowa,1,0,1,1.0
in August/September,2018,Iowa,3,1,4,0.75
in October,2018,Iowa,3,1,4,0.75
in November,2018,Iowa,2,2,4,0.5
in December/January,2018,Iowa,1,0,1,1.0
All Games,2019,Iowa,10,3,13,0.7692307692307693
at Home,2019,Iowa,6,1,7,0.8571428571428571
on Road/Neutral Site,2019,Iowa,4,2,6,0.6666666666666666
vs. Conference,2019,Iowa,6,3,9,0.6666666666666666
vs. Non-Conference,2019,Iowa,4,0,4,1.0
vs. Ranked (AP),2019,Iowa,1,3,4,0.25
vs. Unranked (AP),2019,Iowa,9,0,9,1.0
vs. FBS (I-A),2019,Iowa,10,3,13,0.7692307692307693
vs. FCS (I-AA),2019,Iowa,0,0,0,
vs. FBS Winning,2019,Iowa,4,3,7,0.5714285714285714
vs. FBS Non-Winning,2019,Iowa,6,0,6,1.0
vs. BCS AQ,2019,Iowa,8,3,11,0.7272727272727273
vs. BCS non-AQ,2019,Iowa,2,0,2,1.0
vs. FBS Power 5,2019,Iowa,8,3,11,0.7272727272727273
vs. FBS non-Power 5,2019,Iowa,2,0,2,1.0
in August/September,2019,Iowa,4,0,4,1.0
in October,2019,Iowa,2,2,4,0.5
in November,2019,Iowa,3,1,4,0.75
in December/January,2019,Iowa,1,0,1,1.0
All Games,2020,Iowa,6,2,8,0.75
at Home,2020,Iowa,3,1,4,0.75
on Road/Neutral Site,2020,Iowa,3,1,4,0.75
vs. Conference,2020,Iowa,6,2,8,0.75
vs. Non-Conference,2020,Iowa,0,0,0,
vs. Ranked (AP),2020,Iowa,0,1,1,0.0
vs. Unranked (AP),2020,Iowa,6,1,7,0.8571428571428571
vs. FBS (I-A),2020,Iowa,6,2,8,0.75
vs. FCS (I-AA),2020,Iowa,0,0,0,
vs. FBS Winning,2020,Iowa,1,1,2,0.5
vs. FBS Non-Winning,2020,Iowa,5,1,6,0.8333333333333334
vs. BCS AQ,2020,Iowa,6,2,8,0.75
vs. BCS non-AQ,2020,Iowa,0,0,0,
vs. FBS Power 5,2020,Iowa,6,2,8,0.75
vs. FBS non-Power 5,2020,Iowa,0,0,0,
in August/September,2020,Iowa,0,0,0,
in October,2020,Iowa,0,2,2,0.0
in November,2020,Iowa,4,0,4,1.0
in December/January,2020,Iowa,2,0,2,1.0
All Games,2021,Iowa,10,4,14,0.7142857142857143
at Home,2021,Iowa,6,1,7,0.8571428571428571
on Road/Neutral Site,2021,Iowa,4,3,7,0.5714285714285714
vs. Conference,2021,Iowa,7,3,10,0.7
vs. Non-Conference,2021,Iowa,3,1,4,0.75
vs. Ranked (AP),2021,Iowa,0,2,2,0.0
vs. Unranked (AP),2021,Iowa,10,2,12,0.8333333333333334
vs. FBS (I-A),2021,Iowa,10,4,14,0.7142857142857143
vs. FCS (I-AA),2021,Iowa,0,0,0,
vs. FBS Winning,2021,Iowa,4,4,8,0.5
vs. FBS Non-Winning,2021,Iowa,6,0,6,1.0
vs. BCS AQ,2021,Iowa,8,4,12,0.6666666666666666
vs. BCS non-AQ,2021,Iowa,2,0,2,1.0
vs. FBS Power 5,2021,Iowa,8,4,12,0.6666666666666666
vs. FBS non-Power 5,2021,Iowa,2,0,2,1.0
in August/September,2021,Iowa,4,0,4,1.0
in October,2021,Iowa,2,2,4,0.5
in November,2021,Iowa,4,0,4,1.0
in December/January,2021,Iowa,0,2,2,0.0
All Games,2022,Iowa,8,5,13,0.6153846153846154
at Home,2022,Iowa,4,3,7,0.5714285714285714
on Road/Neutral Site,2022,Iowa,4,2,6,0.6666666666666666
vs. Conference,2022,Iowa,5,4,9,0.5555555555555556
vs. Non-Conference,2022,Iowa,3,1,4,0.75
vs. Ranked (AP),2022,Iowa,0,2,2,0.0
vs. Unranked (AP),2022,Iowa,8,3,11,0.7272727272727273
vs. FBS (I-A),2022,Iowa,7,5,12,0.5833333333333334
vs. FCS (I-AA),2022,Iowa,1,0,1,1.0
vs. FBS Winning,2022,Iowa,4,3,7,0.5714285714285714
vs. FBS Non-Winning,2022,Iowa,3,2,5,0.6
vs. BCS AQ,2022,Iowa,6,5,11,0.5454545454545454
vs. BCS non-AQ,2022,Iowa,1,0,1,1.0
vs. FBS Power 5,2022,Iowa,6,5,11,0.5454545454545454
vs. FBS non-Power 5,2022,Iowa,1,0,1,1.0
in August/September,2022,Iowa,3,1,4,0.75
in October,2022,Iowa,1,3,4,0.25
in November,2022,Iowa,3,1,4,0.75
in December/January,2022,Iowa,1,0,1,1.0
All Games,2009,Iowa State,7,6,13,0.5384615384615384
at Home,2009,Iowa State,4,2,6,0.6666666666666666
on Road/Neutral Site,2009,Iowa State,3,4,7,0.42857142857142855
vs. Conference,2009,Iowa State,3,5,8,0.375
vs. Non-Conference,2009,Iowa State,4,1,5,0.8
vs. Ranked (AP),2009,Iowa State,1,1,2,0.5
vs. Unranked (AP),2009,Iowa State,6,5,11,0.5454545454545454
vs. FBS (I-A),2009,Iowa State,6,6,12,0.5
vs. FCS (I-AA),2009,Iowa State,1,0,1,1.0
vs. FBS Winning,2009,Iowa State,1,3,4,0.25
vs. FBS Non-Winning,2009,Iowa State,5,3,8,0.625
vs. BCS AQ,2009,Iowa State,4,6,10,0.4
vs. BCS non-AQ,2009,Iowa State,2,0,2,1.0
vs. FBS Power 5,2009,Iowa State,4,6,10,0.4
vs. FBS non-Power 5,2009,Iowa State,2,0,2,1.0
in August/September,2009,Iowa State,3,1,4,0.75
in October,2009,Iowa State,2,3,5,0.4
in November,2009,Iowa State,1,2,3,0.3333333333333333
in December/January,2009,Iowa State,1,0,1,1.0
All Games,2010,Iowa State,5,7,12,0.4166666666666667
at Home,2010,Iowa State,4,3,7,0.5714285714285714
on Road/Neutral Site,2010,Iowa State,1,4,5,0.2
vs. Conference,2010,Iowa State,3,5,8,0.375
vs. Non-Conference,2010,Iowa State,2,2,4,0.5
vs. Ranked (AP),2010,Iowa State,0,3,3,0.0
vs. Unranked (AP),2010,Iowa State,5,4,9,0.5555555555555556
vs. FBS (I-A),2010,Iowa State,4,7,11,0.36363636363636365
vs. FCS (I-AA),2010,Iowa State,1,0,1,1.0
vs. FBS Winning,2010,Iowa State,2,6,8,0.25
vs. FBS Non-Winning,2010,Iowa State,2,1,3,0.6666666666666666
vs. BCS AQ,2010,Iowa State,3,6,9,0.3333333333333333
vs. BCS non-AQ,2010,Iowa State,1,1,2,0.5
vs. FBS Power 5,2010,Iowa State,3,6,9,0.3333333333333333
vs. FBS non-Power 5,2010,Iowa State,1,1,2,0.5
in August/September,2010,Iowa State,2,2,4,0.5
in October,2010,Iowa State,3,2,5,0.6
in November,2010,Iowa State,0,3,3,0.0
in December/January,2010,Iowa State,0,0,0,
All Games,2011,Iowa State,6,7,13,0.46153846153846156
at Home,2011,Iowa State,4,2,6,0.6666666666666666
on Road/Neutral Site,2011,Iowa State,2,5,7,0.2857142857142857
vs. Conference,2011,Iowa State,3,6,9,0.3333333333333333
vs. Non-Conference,2011,Iowa State,3,1,4,0.75
vs. Ranked (AP),2011,Iowa State,1,3,4,0.25
vs. Unranked (AP),2011,Iowa State,5,4,9,0.5555555555555556
vs. FBS (I-A),2011,Iowa State,5,7,12,0.4166666666666667
vs. FCS (I-AA),2011,Iowa State,1,0,1,1.0
vs. FBS Winning,2011,Iowa State,2,7,9,0.2222222222222222
vs. FBS Non-Winning,2011,Iowa State,3,0,3,1.0
vs. BCS AQ,2011,Iowa State,5,7,12,0.4166666666666667
vs. BCS non-AQ,2011,Iowa State,0,0,0,
vs. FBS Power 5,2011,Iowa State,4,6,10,0.4
vs. FBS non-Power 5,2011,Iowa State,1,1,2,0.5
in August/September,2011,Iowa State,3,0,3,1.0
in October,2011,Iowa State,1,4,5,0.2
in November,2011,Iowa State,2,1,3,0.6666666666666666
in December/January,2011,Iowa State,0,2,2,0.0
All Games,2012,Iowa State,6,7,13,0.46153846153846156
at Home,2012,Iowa State,3,4,7,0.42857142857142855
on Road/Neutral Site,2012,Iowa State,3,3,6,0.5
vs. Conference,2012,Iowa State,3,6,9,0.3333333333333333
vs. Non-Conference,2012,Iowa State,3,1,4,0.75
vs. Ranked (AP),2012,Iowa State,0,3,3,0.0
vs. Unranked (AP),2012,Iowa State,6,4,10,0.6
vs. FBS (I-A),2012,Iowa State,5,7,12,0.4166666666666667
vs. FCS (I-AA),2012,Iowa State,1,0,1,1.0
vs. FBS Winning,2012,Iowa State,3,7,10,0.3
vs. FBS Non-Winning,2012,Iowa State,2,0,2,1.0
vs. BCS AQ,2012,Iowa State,4,6,10,0.4
vs. BCS non-AQ,2012,Iowa State,1,1,2,0.5
vs. FBS Power 5,2012,Iowa State,4,6,10,0.4
vs. FBS non-Power 5,2012,Iowa State,1,1,2,0.5
in August/September,2012,Iowa State,3,1,4,0.75
in October,2012,Iowa State,2,2,4,0.5
in November,2012,Iowa State,1,3,4,0.25
in December/January,2012,Iowa State,0,1,1,0.0
All Games,2013,Iowa State,3,9,12,0.25
at Home,2013,Iowa State,1,5,6,0.16666666666666666
on Road/Neutral Site,2013,Iowa State,2,4,6,0.3333333333333333
vs. Conference,2013,Iowa State,2,7,9,0.2222222222222222
vs. Non-Conference,2013,Iowa State,1,2,3,0.3333333333333333
vs. Ranked (AP),2013,Iowa State,0,3,3,0.0
vs. Unranked (AP),2013,Iowa State,3,6,9,0.3333333333333333
vs. FBS (I-A),2013,Iowa State,3,8,11,0.2727272727272727
vs. FCS (I-AA),2013,Iowa State,0,1,1,0.0
vs. FBS Winning,2013,Iowa State,0,7,7,0.0
vs. FBS Non-Winning,2013,Iowa State,3,1,4,0.75
vs. BCS AQ,2013,Iowa State,2,8,10,0.2
vs. BCS non-AQ,2013,Iowa State,1,0,1,1.0
vs. FBS Power 5,2013,Iowa State,2,8,10,0.2
vs. FBS non-Power 5,2013,Iowa State,1,0,1,1.0
in August/September,2013,Iowa State,1,2,3,0.3333333333333333
in October,2013,Iowa State,0,4,4,0.0
in November,2013,Iowa State,2,3,5,0.4
in December/January,2013,Iowa State,0,0,0,
All Games,2014,Iowa State,2,10,12,0.16666666666666666
at Home,2014,Iowa State,1,6,7,0.14285714285714285
on Road/Neutral Site,2014,Iowa State,1,4,5,0.2
vs. Conference,2014,Iowa State,0,9,9,0.0
vs. Non-Conference,2014,Iowa State,2,1,3,0.6666666666666666
vs. Ranked (AP),2014,Iowa State,0,3,3,0.0
vs. Unranked (AP),2014,Iowa State,2,7,9,0.2222222222222222
vs. FBS (I-A),2014,Iowa State,2,9,11,0.18181818181818182
vs. FCS (I-AA),2014,Iowa State,0,1,1,0.0
vs. FBS Winning,2014,Iowa State,2,6,8,0.25
vs. FBS Non-Winning,2014,Iowa State,0,3,3,0.0
vs. BCS AQ,2014,Iowa State,1,9,10,0.1
vs. BCS non-AQ,2014,Iowa State,1,0,1,1.0
vs. FBS Power 5,2014,Iowa State,1,9,10,0.1
vs. FBS non-Power 5,2014,Iowa State,1,0,1,1.0
in August/September,2014,Iowa State,1,3,4,0.25
in October,2014,Iowa State,1,2,3,0.3333333333333333
in November,2014,Iowa State,0,4,4,0.0
in December/January,2014,Iowa State,0,1,1,0.0
All Games,2015,Iowa State,3,9,12,0.25
at Home,2015,Iowa State,3,3,6,0.5
on Road/Neutral Site,2015,Iowa State,0,6,6,0.0
vs. Conference,2015,Iowa State,2,7,9,0.2222222222222222
vs. Non-Conference,2015,Iowa State,1,2,3,0.3333333333333333
vs. Ranked (AP),2015,Iowa State,0,5,5,0.0
vs. Unranked (AP),2015,Iowa State,3,4,7,0.42857142857142855
vs. FBS (I-A),2015,Iowa State,2,9,11,0.18181818181818182
vs. FCS (I-AA),2015,Iowa State,1,0,1,1.0
vs. FBS Winning,2015,Iowa State,0,8,8,0.0
vs. FBS Non-Winning,2015,Iowa State,2,1,3,0.6666666666666666
vs. BCS AQ,2015,Iowa State,2,8,10,0.2
vs. BCS non-AQ,2015,Iowa State,0,1,1,0.0
vs. FBS Power 5,2015,Iowa State,2,8,10,0.2
vs. FBS non-Power 5,2015,Iowa State,0,1,1,0.0
in August/September,2015,Iowa State,1,2,3,0.3333333333333333
in October,2015,Iowa State,2,3,5,0.4
in November,2015,Iowa State,0,4,4,0.0
in December/January,2015,Iowa State,0,0,0,
All Games,2016,Iowa State,3,9,12,0.25
at Home,2016,Iowa State,2,5,7,0.2857142857142857
on Road/Neutral Site,2016,Iowa State,1,4,5,0.2
vs. Conference,2016,Iowa State,2,7,9,0.2222222222222222
vs. Non-Conference,2016,Iowa State,1,2,3,0.3333333333333333
vs. Ranked (AP),2016,Iowa State,0,4,4,0.0
vs. Unranked (AP),2016,Iowa State,3,5,8,0.375
vs. FBS (I-A),2016,Iowa State,3,8,11,0.2727272727272727
vs. FCS (I-AA),2016,Iowa State,0,1,1,0.0
vs. FBS Winning,2016,Iowa State,0,6,6,0.0
vs. FBS Non-Winning,2016,Iowa State,3,2,5,0.6
vs. BCS AQ,2016,Iowa State,2,8,10,0.2
vs. BCS non-AQ,2016,Iowa State,1,0,1,1.0
vs. FBS Power 5,2016,Iowa State,2,8,10,0.2
vs. FBS non-Power 5,2016,Iowa State,1,0,1,1.0
in August/September,2016,Iowa State,1,3,4,0.25
in October,2016,Iowa State,0,4,4,0.0
in November,2016,Iowa State,2,2,4,0.5
in December/January,2016,Iowa State,0,0,0,
All Games,2017,Iowa State,8,5,13,0.6153846153846154
at Home,2017,Iowa State,3,3,6,0.5
on Road/Neutral Site,2017,Iowa State,5,2,7,0.7142857142857143
vs. Conference,2017,Iowa State,5,4,9,0.5555555555555556
vs. Non-Conference,2017,Iowa State,3,1,4,0.75
vs. Ranked (AP),2017,Iowa State,3,1,4,0.75
vs. Unranked (AP),2017,Iowa State,5,4,9,0.5555555555555556
vs. FBS (I-A),2017,Iowa State,7,5,12,0.5833333333333334
vs. FCS (I-AA),2017,Iowa State,1,0,1,1.0
vs. FBS Winning,2017,Iowa State,3,5,8,0.375
vs. FBS Non-Winning,2017,Iowa State,4,0,4,1.0
vs. BCS AQ,2017,Iowa State,6,5,11,0.5454545454545454
vs. BCS non-AQ,2017,Iowa State,1,0,1,1.0
vs. FBS Power 5,2017,Iowa State,5,5,10,0.5
vs. FBS non-Power 5,2017,Iowa State,2,0,2,1.0
in August/September,2017,Iowa State,2,2,4,0.5
in October,2017,Iowa State,4,0,4,1.0
in November,2017,Iowa State,1,3,4,0.25
in December/January,2017,Iowa State,1,0,1,1.0
All Games,2018,Iowa State,8,5,13,0.6153846153846154
at Home,2018,Iowa State,6,1,7,0.8571428571428571
on Road/Neutral Site,2018,Iowa State,2,4,6,0.3333333333333333
vs. Conference,2018,Iowa State,6,3,9,0.6666666666666666
vs. Non-Conference,2018,Iowa State,2,2,4,0.5
vs. Ranked (AP),2018,Iowa State,1,4,5,0.2
vs. Unranked (AP),2018,Iowa State,7,1,8,0.875
vs. FBS (I-A),2018,Iowa State,7,5,12,0.5833333333333334
vs. FCS (I-AA),2018,Iowa State,1,0,1,1.0
vs. FBS Winning,2018,Iowa State,3,5,8,0.375
vs. FBS Non-Winning,2018,Iowa State,4,0,4,1.0
vs. BCS AQ,2018,Iowa State,6,5,11,0.5454545454545454
vs. BCS non-AQ,2018,Iowa State,1,0,1,1.0
vs. FBS Power 5,2018,Iowa State,6,5,11,0.5454545454545454
vs. FBS non-Power 5,2018,Iowa State,1,0,1,1.0
in August/September,2018,Iowa State,1,3,4,0.25
in October,2018,Iowa State,3,0,3,1.0
in November,2018,Iowa State,3,1,4,0.75
in December/January,2018,Iowa State,1,1,2,0.5
All Games,2019,Iowa State,7,6,13,0.5384615384615384
at Home,2019,Iowa State,5,2,7,0.7142857142857143
on Road/Neutral Site,2019,Iowa State,2,4,6,0.3333333333333333
vs. Conference,2019,Iowa State,5,4,9,0.5555555555555556
vs. Non-Conference,2019,Iowa State,2,2,4,0.5
vs. Ranked (AP),2019,Iowa State,1,4,5,0.2
vs. Unranked (AP),2019,Iowa State,6,2,8,0.75
vs. FBS (I-A),2019,Iowa State,6,6,12,0.5
vs. FCS (I-AA),2019,Iowa State,1,0,1,1.0
vs. FBS Winning,2019,Iowa State,1,6,7,0.14285714285714285
vs. FBS Non-Winning,2019,Iowa State,5,0,5,1.0
vs. BCS AQ,2019,Iowa State,5,6,11,0.45454545454545453
vs. BCS non-AQ,2019,Iowa State,1,0,1,1.0
vs. FBS Power 5,2019,Iowa State,5,5,10,0.5
vs. FBS non-Power 5,2019,Iowa State,1,1,2,0.5
in August/September,2019,Iowa State,2,2,4,0.5
in October,2019,Iowa State,3,1,4,0.75
in November,2019,Iowa State,2,2,4,0.5
in December/January,2019,Iowa State,0,1,1,0.0
All Games,2020,Iowa State,9,3,12,0.75
at Home,2020,Iowa State,5,1,6,0.8333333333333334
on Road/Neutral Site,2020,Iowa State,4,2,6,0.6666666666666666
vs. Conference,2020,Iowa State,8,2,10,0.8
vs. Non-Conference,2020,Iowa State,1,1,2,0.5
vs. Ranked (AP),2020,Iowa State,3,2,5,0.6
vs. Unranked (AP),2020,Iowa State,6,1,7,0.8571428571428571
vs. FBS (I-A),2020,Iowa State,9,3,12,0.75
vs. FCS (I-AA),2020,Iowa State,0,0,0,
vs. FBS Winning,2020,Iowa State,5,3,8,0.625
vs. FBS Non-Winning,2020,Iowa State,4,0,4,1.0
vs. BCS AQ,2020,Iowa State,9,2,11,0.8181818181818182
vs. BCS non-AQ,2020,Iowa State,0,1,1,0.0
vs. FBS Power 5,2020,Iowa State,9,2,11,0.8181818181818182
vs. FBS non-Power 5,2020,Iowa State,0,1,1,0.0
in August/September,2020,Iowa State,1,1,2,0.5
in October,2020,Iowa State,3,1,4,0.75
in November,2020,Iowa State,3,0,3,1.0
in December/January,2020,Iowa State,2,1,3,0.6666666666666666
All Games,2021,Iowa State,7,6,13,0.5384615384615384
at Home,2021,Iowa State,5,1,6,0.8333333333333334
on Road/Neutral Site,2021,Iowa State,2,5,7,0.2857142857142857
vs. Conference,2021,Iowa State,5,4,9,0.5555555555555556
vs. Non-Conference,2021,Iowa State,2,2,4,0.5
vs. Ranked (AP),2021,Iowa State,1,4,5,0.2
vs. Unranked (AP),2021,Iowa State,6,2,8,0.75
vs. FBS (I-A),2021,Iowa State,6,6,12,0.5
vs. FCS (I-AA),2021,Iowa State,1,0,1,1.0
vs. FBS Winning,2021,Iowa State,2,5,7,0.2857142857142857
vs. FBS Non-Winning,2021,Iowa State,4,1,5,0.8
vs. BCS AQ,2021,Iowa State,5,6,11,0.45454545454545453
vs. BCS non-AQ,2021,Iowa State,1,0,1,1.0
vs. FBS Power 5,2021,Iowa State,5,6,11,0.45454545454545453
vs. FBS non-Power 5,2021,Iowa State,1,0,1,1.0
in August/September,2021,Iowa State,2,2,4,0.5
in October,2021,Iowa State,3,1,4,0.75
in November,2021,Iowa State,2,2,4,0.5
in December/January,2021,Iowa State,0,1,1,0.0
All Games,2022,Iowa State,4,8,12,0.3333333333333333
at Home,2022,Iowa State,3,4,7,0.42857142857142855
on Road/Neutral Site,2022,Iowa State,1,4,5,0.2
vs. Conference,2022,Iowa State,1,8,9,0.1111111111111111
vs. Non-Conference,2022,Iowa State,3,0,3,1.0
vs. Ranked (AP),2022,Iowa State,0,3,3,0.0
vs. Unranked (AP),2022,Iowa State,4,5,9,0.4444444444444444
vs. FBS (I-A),2022,Iowa State,3,8,11,0.2727272727272727
vs. FCS (I-AA),2022,Iowa State,1,0,1,1.0
vs. FBS Winning,2022,Iowa State,2,5,7,0.2857142857142857
vs. FBS Non-Winning,2022,Iowa State,1,3,4,0.25
vs. BCS AQ,2022,Iowa State,2,8,10,0.2
vs. BCS non-AQ,2022,Iowa State,1,0,1,1.0
vs. FBS Power 5,2022,Iowa State,2,8,10,0.2
vs. FBS non-Power 5,2022,Iowa State,1,0,1,1.0
in August/September,2022,Iowa State,3,1,4,0.75
in October,2022,Iowa State,0,4,4,0.0
in November,2022,Iowa State,1,3,4,0.25
in December/January,2022,Iowa State,0,0,0,
All Games,2022,James Madison,8,3,11,0.7272727272727273
at Home,2022,James Madison,5,1,6,0.8333333333333334
on Road/Neutral Site,2022,James Madison,3,2,5,0.6
vs. Conference,2022,James Madison,6,2,8,0.75
vs. Non-Conference,2022,James Madison,2,1,3,0.6666666666666666
vs. Ranked (AP),2022,James Madison,0,0,0,
vs. Unranked (AP),2022,James Madison,8,3,11,0.7272727272727273
vs. FBS (I-A),2022,James Madison,7,3,10,0.7
vs. FCS (I-AA),2022,James Madison,1,0,1,1.0
vs. FBS Winning,2022,James Madison,2,2,4,0.5
vs. FBS Non-Winning,2022,James Madison,5,1,6,0.8333333333333334
vs. BCS AQ,2022,James Madison,0,1,1,0.0
vs. BCS non-AQ,2022,James Madison,7,2,9,0.7777777777777778
vs. FBS Power 5,2022,James Madison,0,1,1,0.0
vs. FBS non-Power 5,2022,James Madison,7,2,9,0.7777777777777778
in August/September,2022,James Madison,3,0,3,1.0
in October,2022,James Madison,2,2,4,0.5
in November,2022,James Madison,3,1,4,0.75
in December/January,2022,James Madison,0,0,0,
All Games,2009,Kansas,5,7,12,0.4166666666666667
at Home,2009,Kansas,4,3,7,0.5714285714285714
on Road/Neutral Site,2009,Kansas,1,4,5,0.2
vs. Conference,2009,Kansas,1,7,8,0.125
vs. Non-Conference,2009,Kansas,4,0,4,1.0
vs. Ranked (AP),2009,Kansas,0,3,3,0.0
vs. Unranked (AP),2009,Kansas,5,4,9,0.5555555555555556
vs. FBS (I-A),2009,Kansas,4,7,11,0.36363636363636365
vs. FCS (I-AA),2009,Kansas,1,0,1,1.0
vs. FBS Winning,2009,Kansas,2,5,7,0.2857142857142857
vs. FBS Non-Winning,2009,Kansas,2,2,4,0.5
vs. BCS AQ,2009,Kansas,2,7,9,0.2222222222222222
vs. BCS non-AQ,2009,Kansas,2,0,2,1.0
vs. FBS Power 5,2009,Kansas,2,7,9,0.2222222222222222
vs. FBS non-Power 5,2009,Kansas,2,0,2,1.0
in August/September,2009,Kansas,4,0,4,1.0
in October,2009,Kansas,1,3,4,0.25
in November,2009,Kansas,0,4,4,0.0
in December/January,2009,Kansas,0,0,0,
All Games,2010,Kansas,3,9,12,0.25
at Home,2010,Kansas,3,4,7,0.42857142857142855
on Road/Neutral Site,2010,Kansas,0,5,5,0.0
vs. Conference,2010,Kansas,1,7,8,0.125
vs. Non-Conference,2010,Kansas,2,2,4,0.5
vs. Ranked (AP),2010,Kansas,0,4,4,0.0
vs. Unranked (AP),2010,Kansas,3,5,8,0.375
vs. FBS (I-A),2010,Kansas,3,8,11,0.2727272727272727
vs. FCS (I-AA),2010,Kansas,0,1,1,0.0
vs. FBS Winning,2010,Kansas,0,7,7,0.0
vs. FBS Non-Winning,2010,Kansas,3,1,4,0.75
vs. BCS AQ,2010,Kansas,2,7,9,0.2222222222222222
vs. BCS non-AQ,2010,Kansas,1,1,2,0.5
vs. FBS Power 5,2010,Kansas,2,7,9,0.2222222222222222
vs. FBS non-Power 5,2010,Kansas,1,1,2,0.5
in August/September,2010,Kansas,2,2,4,0.5
in October,2010,Kansas,0,4,4,0.0
in November,2010,Kansas,1,3,4,0.25
in December/January,2010,Kansas,0,0,0,
All Games,2011,Kansas,2,10,12,0.16666666666666666
at Home,2011,Kansas,2,4,6,0.3333333333333333
on Road/Neutral Site,2011,Kansas,0,6,6,0.0
vs. Conference,2011,Kansas,0,9,9,0.0
vs. Non-Conference,2011,Kansas,2,1,3,0.6666666666666666
vs. Ranked (AP),2011,Kansas,0,4,4,0.0
vs. Unranked (AP),2011,Kansas,2,6,8,0.25
vs. FBS (I-A),2011,Kansas,1,10,11,0.09090909090909091
vs. FCS (I-AA),2011,Kansas,1,0,1,1.0
vs. FBS Winning,2011,Kansas,1,8,9,0.1111111111111111
vs. FBS Non-Winning,2011,Kansas,0,2,2,0.0
vs. BCS AQ,2011,Kansas,0,10,10,0.0
vs. BCS non-AQ,2011,Kansas,1,0,1,1.0
vs. FBS Power 5,2011,Kansas,0,10,10,0.0
vs. FBS non-Power 5,2011,Kansas,1,0,1,1.0
in August/September,2011,Kansas,2,1,3,0.6666666666666666
in October,2011,Kansas,0,5,5,0.0
in November,2011,Kansas,0,4,4,0.0
in December/January,2011,Kansas,0,0,0,
All Games,2012,Kansas,1,11,12,0.08333333333333333
at Home,2012,Kansas,1,5,6,0.16666666666666666
on Road/Neutral Site,2012,Kansas,0,6,6,0.0
vs. Conference,2012,Kansas,0,9,9,0.0
vs. Non-Conference,2012,Kansas,1,2,3,0.3333333333333333
vs. Ranked (AP),2012,Kansas,0,4,4,0.0
vs. Unranked (AP),2012,Kansas,1,7,8,0.125
vs. FBS (I-A),2012,Kansas,0,11,11,0.0
vs. FCS (I-AA),2012,Kansas,1,0,1,1.0
vs. FBS Winning,2012,Kansas,0,10,10,0.0
vs. FBS Non-Winning,2012,Kansas,0,1,1,0.0
vs. BCS AQ,2012,Kansas,0,9,9,0.0
vs. BCS non-AQ,2012,Kansas,0,2,2,0.0
vs. FBS Power 5,2012,Kansas,0,9,9,0.0
vs. FBS non-Power 5,2012,Kansas,0,2,2,0.0
in August/September,2012,Kansas,1,3,4,0.25
in October,2012,Kansas,0,4,4,0.0
in November,2012,Kansas,0,3,3,0.0
in December/January,2012,Kansas,0,1,1,0.0
All Games,2013,Kansas,3,9,12,0.25
at Home,2013,Kansas,3,4,7,0.42857142857142855
on Road/Neutral Site,2013,Kansas,0,5,5,0.0
vs. Conference,2013,Kansas,1,8,9,0.1111111111111111
vs. Non-Conference,2013,Kansas,2,1,3,0.6666666666666666
vs. Ranked (AP),2013,Kansas,0,3,3,0.0
vs. Unranked (AP),2013,Kansas,3,6,9,0.3333333333333333
vs. FBS (I-A),2013,Kansas,2,9,11,0.18181818181818182
vs. FCS (I-AA),2013,Kansas,1,0,1,1.0
vs. FBS Winning,2013,Kansas,0,7,7,0.0
vs. FBS Non-Winning,2013,Kansas,2,2,4,0.5
vs. BCS AQ,2013,Kansas,1,8,9,0.1111111111111111
vs. BCS non-AQ,2013,Kansas,1,1,2,0.5
vs. FBS Power 5,2013,Kansas,1,8,9,0.1111111111111111
vs. FBS non-Power 5,2013,Kansas,1,1,2,0.5
in August/September,2013,Kansas,2,1,3,0.6666666666666666
in October,2013,Kansas,0,4,4,0.0
in November,2013,Kansas,1,4,5,0.2
in December/January,2013,Kansas,0,0,0,
All Games,2014,Kansas,3,9,12,0.25
at Home,2014,Kansas,3,3,6,0.5
on Road/Neutral Site,2014,Kansas,0,6,6,0.0
vs. Conference,2014,Kansas,1,8,9,0.1111111111111111
vs. Non-Conference,2014,Kansas,2,1,3,0.6666666666666666
vs. Ranked (AP),2014,Kansas,0,3,3,0.0
vs. Unranked (AP),2014,Kansas,3,6,9,0.3333333333333333
vs. FBS (I-A),2014,Kansas,2,9,11,0.18181818181818182
vs. FCS (I-AA),2014,Kansas,1,0,1,1.0
vs. FBS Winning,2014,Kansas,1,7,8,0.125
vs. FBS Non-Winning,2014,Kansas,1,2,3,0.3333333333333333
vs. BCS AQ,2014,Kansas,1,9,10,0.1
vs. BCS non-AQ,2014,Kansas,1,0,1,1.0
vs. FBS Power 5,2014,Kansas,1,9,10,0.1
vs. FBS non-Power 5,2014,Kansas,1,0,1,1.0
in August/September,2014,Kansas,2,2,4,0.5
in October,2014,Kansas,0,3,3,0.0
in November,2014,Kansas,1,4,5,0.2
in December/January,2014,Kansas,0,0,0,
All Games,2015,Kansas,0,12,12,0.0
at Home,2015,Kansas,0,7,7,0.0
on Road/Neutral Site,2015,Kansas,0,5,5,0.0
vs. Conference,2015,Kansas,0,9,9,0.0
vs. Non-Conference,2015,Kansas,0,3,3,0.0
vs. Ranked (AP),2015,Kansas,0,4,4,0.0
vs. Unranked (AP),2015,Kansas,0,8,8,0.0
vs. FBS (I-A),2015,Kansas,0,11,11,0.0
vs. FCS (I-AA),2015,Kansas,0,1,1,0.0
vs. FBS Winning,2015,Kansas,0,7,7,0.0
vs. FBS Non-Winning,2015,Kansas,0,4,4,0.0
vs. BCS AQ,2015,Kansas,0,11,11,0.0
vs. BCS non-AQ,2015,Kansas,0,0,0,
vs. FBS Power 5,2015,Kansas,0,10,10,0.0
vs. FBS non-Power 5,2015,Kansas,0,1,1,0.0
in August/September,2015,Kansas,0,3,3,0.0
in October,2015,Kansas,0,5,5,0.0
in November,2015,Kansas,0,4,4,0.0
in December/January,2015,Kansas,0,0,0,
All Games,2016,Kansas,2,10,12,0.16666666666666666
at Home,2016,Kansas,2,4,6,0.3333333333333333
on Road/Neutral Site,2016,Kansas,0,6,6,0.0
vs. Conference,2016,Kansas,1,8,9,0.1111111111111111
vs. Non-Conference,2016,Kansas,1,2,3,0.3333333333333333
vs. Ranked (AP),2016,Kansas,0,3,3,0.0
vs. Unranked (AP),2016,Kansas,2,7,9,0.2222222222222222
vs. FBS (I-A),2016,Kansas,1,10,11,0.09090909090909091
vs. FCS (I-AA),2016,Kansas,1,0,1,1.0
vs. FBS Winning,2016,Kansas,0,7,7,0.0
vs. FBS Non-Winning,2016,Kansas,1,3,4,0.25
vs. BCS AQ,2016,Kansas,1,9,10,0.1
vs. BCS non-AQ,2016,Kansas,0,1,1,0.0
vs. FBS Power 5,2016,Kansas,1,8,9,0.1111111111111111
vs. FBS non-Power 5,2016,Kansas,0,2,2,0.0
in August/September,2016,Kansas,1,3,4,0.25
in October,2016,Kansas,0,4,4,0.0
in November,2016,Kansas,1,3,4,0.25
in December/January,2016,Kansas,0,0,0,
All Games,2017,Kansas,1,11,12,0.08333333333333333
at Home,2017,Kansas,1,6,7,0.14285714285714285
on Road/Neutral Site,2017,Kansas,0,5,5,0.0
vs. Conference,2017,Kansas,0,9,9,0.0
vs. Non-Conference,2017,Kansas,1,2,3,0.3333333333333333
vs. Ranked (AP),2017,Kansas,0,3,3,0.0
vs. Unranked (AP),2017,Kansas,1,8,9,0.1111111111111111
vs. FBS (I-A),2017,Kansas,0,11,11,0.0
vs. FCS (I-AA),2017,Kansas,1,0,1,1.0
vs. FBS Winning,2017,Kansas,0,9,9,0.0
vs. FBS Non-Winning,2017,Kansas,0,2,2,0.0
vs. BCS AQ,2017,Kansas,0,9,9,0.0
vs. BCS non-AQ,2017,Kansas,0,2,2,0.0
vs. FBS Power 5,2017,Kansas,0,9,9,0.0
vs. FBS non-Power 5,2017,Kansas,0,2,2,0.0
in August/September,2017,Kansas,1,3,4,0.25
in October,2017,Kansas,0,4,4,0.0
in November,2017,Kansas,0,4,4,0.0
in December/January,2017,Kansas,0,0,0,
All Games,2018,Kansas,3,9,12,0.25
at Home,2018,Kansas,2,4,6,0.3333333333333333
on Road/Neutral Site,2018,Kansas,1,5,6,0.16666666666666666
vs. Conference,2018,Kansas,1,8,9,0.1111111111111111
vs. Non-Conference,2018,Kansas,2,1,3,0.6666666666666666
vs. Ranked (AP),2018,Kansas,0,3,3,0.0
vs. Unranked (AP),2018,Kansas,3,6,9,0.3333333333333333
vs. FBS (I-A),2018,Kansas,3,8,11,0.2727272727272727
vs. FCS (I-AA),2018,Kansas,0,1,1,0.0
vs. FBS Winning,2018,Kansas,1,6,7,0.14285714285714285
vs. FBS Non-Winning,2018,Kansas,2,2,4,0.5
vs. BCS AQ,2018,Kansas,2,8,10,0.2
vs. BCS non-AQ,2018,Kansas,1,0,1,1.0
vs. FBS Power 5,2018,Kansas,2,8,10,0.2
vs. FBS non-Power 5,2018,Kansas,1,0,1,1.0
in August/September,2018,Kansas,2,3,5,0.4
in October,2018,Kansas,1,2,3,0.3333333333333333
in November,2018,Kansas,0,4,4,0.0
in December/January,2018,Kansas,0,0,0,
All Games,2019,Kansas,3,9,12,0.25
at Home,2019,Kansas,2,5,7,0.2857142857142857
on Road/Neutral Site,2019,Kansas,1,4,5,0.2
vs. Conference,2019,Kansas,1,8,9,0.1111111111111111
vs. Non-Conference,2019,Kansas,2,1,3,0.6666666666666666
vs. Ranked (AP),2019,Kansas,0,3,3,0.0
vs. Unranked (AP),2019,Kansas,3,6,9,0.3333333333333333
vs. FBS (I-A),2019,Kansas,2,9,11,0.18181818181818182
vs. FCS (I-AA),2019,Kansas,1,0,1,1.0
vs. FBS Winning,2019,Kansas,0,6,6,0.0
vs. FBS Non-Winning,2019,Kansas,2,3,5,0.4
vs. BCS AQ,2019,Kansas,2,8,10,0.2
vs. BCS non-AQ,2019,Kansas,0,1,1,0.0
vs. FBS Power 5,2019,Kansas,2,8,10,0.2
vs. FBS non-Power 5,2019,Kansas,0,1,1,0.0
in August/September,2019,Kansas,2,3,5,0.4
in October,2019,Kansas,1,2,3,0.3333333333333333
in November,2019,Kansas,0,4,4,0.0
in December/January,2019,Kansas,0,0,0,
All Games,2020,Kansas,0,9,9,0.0
at Home,2020,Kansas,0,4,4,0.0
on Road/Neutral Site,2020,Kansas,0,5,5,0.0
vs. Conference,2020,Kansas,0,8,8,0.0
vs. Non-Conference,2020,Kansas,0,1,1,0.0
vs. Ranked (AP),2020,Kansas,0,3,3,0.0
vs. Unranked (AP),2020,Kansas,0,6,6,0.0
vs. FBS (I-A),2020,Kansas,0,9,9,0.0
vs. FCS (I-AA),2020,Kansas,0,0,0,
vs. FBS Winning,2020,Kansas,0,6,6,0.0
vs. FBS Non-Winning,2020,Kansas,0,3,3,0.0
vs. BCS AQ,2020,Kansas,0,8,8,0.0
vs. BCS non-AQ,2020,Kansas,0,1,1,0.0
vs. FBS Power 5,2020,Kansas,0,8,8,0.0
vs. FBS non-Power 5,2020,Kansas,0,1,1,0.0
in August/September,2020,Kansas,0,2,2,0.0
in October,2020,Kansas,0,4,4,0.0
in November,2020,Kansas,0,2,2,0.0
in December/January,2020,Kansas,0,1,1,0.0
All Games,2021,Kansas,2,10,12,0.16666666666666666
at Home,2021,Kansas,1,5,6,0.16666666666666666
on Road/Neutral Site,2021,Kansas,1,5,6,0.16666666666666666
vs. Conference,2021,Kansas,1,8,9,0.1111111111111111
vs. Non-Conference,2021,Kansas,1,2,3,0.3333333333333333
vs. Ranked (AP),2021,Kansas,0,3,3,0.0
vs. Unranked (AP),2021,Kansas,2,7,9,0.2222222222222222
vs. FBS (I-A),2021,Kansas,1,10,11,0.09090909090909091
vs. FCS (I-AA),2021,Kansas,1,0,1,1.0
vs. FBS Winning,2021,Kansas,0,7,7,0.0
vs. FBS Non-Winning,2021,Kansas,1,3,4,0.25
vs. BCS AQ,2021,Kansas,1,9,10,0.1
vs. BCS non-AQ,2021,Kansas,0,1,1,0.0
vs. FBS Power 5,2021,Kansas,1,9,10,0.1
vs. FBS non-Power 5,2021,Kansas,0,1,1,0.0
in August/September,2021,Kansas,1,3,4,0.25
in October,2021,Kansas,0,4,4,0.0
in November,2021,Kansas,1,3,4,0.25
in December/January,2021,Kansas,0,0,0,
All Games,2022,Kansas,6,7,13,0.46153846153846156
at Home,2022,Kansas,4,2,6,0.6666666666666666
on Road/Neutral Site,2022,Kansas,2,5,7,0.2857142857142857
vs. Conference,2022,Kansas,3,6,9,0.3333333333333333
vs. Non-Conference,2022,Kansas,3,1,4,0.75
vs. Ranked (AP),2022,Kansas,0,3,3,0.0
vs. Unranked (AP),2022,Kansas,6,4,10,0.6
vs. FBS (I-A),2022,Kansas,5,7,12,0.4166666666666667
vs. FCS (I-AA),2022,Kansas,1,0,1,1.0
vs. FBS Winning,2022,Kansas,3,5,8,0.375
vs. FBS Non-Winning,2022,Kansas,2,2,4,0.5
vs. BCS AQ,2022,Kansas,5,7,12,0.4166666666666667
vs. BCS non-AQ,2022,Kansas,0,0,0,
vs. FBS Power 5,2022,Kansas,4,7,11,0.36363636363636365
vs. FBS non-Power 5,2022,Kansas,1,0,1,1.0
in August/September,2022,Kansas,4,0,4,1.0
in October,2022,Kansas,1,3,4,0.25
in November,2022,Kansas,1,3,4,0.25
in December/January,2022,Kansas,0,1,1,0.0
All Games,2009,Kansas State,6,6,12,0.5
at Home,2009,Kansas State,5,1,6,0.8333333333333334
on Road/Neutral Site,2009,Kansas State,1,5,6,0.16666666666666666
vs. Conference,2009,Kansas State,4,4,8,0.5
vs. Non-Conference,2009,Kansas State,2,2,4,0.5
vs. Ranked (AP),2009,Kansas State,0,2,2,0.0
vs. Unranked (AP),2009,Kansas State,6,4,10,0.6
vs. FBS (I-A),2009,Kansas State,4,6,10,0.4
vs. FCS (I-AA),2009,Kansas State,2,0,2,1.0
vs. FBS Winning,2009,Kansas State,1,5,6,0.16666666666666666
vs. FBS Non-Winning,2009,Kansas State,3,1,4,0.75
vs. BCS AQ,2009,Kansas State,4,5,9,0.4444444444444444
vs. BCS non-AQ,2009,Kansas State,0,1,1,0.0
vs. FBS Power 5,2009,Kansas State,4,5,9,0.4444444444444444
vs. FBS non-Power 5,2009,Kansas State,0,1,1,0.0
in August/September,2009,Kansas State,2,2,4,0.5
in October,2009,Kansas State,3,2,5,0.6
in November,2009,Kansas State,1,2,3,0.3333333333333333
in December/January,2009,Kansas State,0,0,0,
All Games,2010,Kansas State,7,6,13,0.5384615384615384
at Home,2010,Kansas State,4,2,6,0.6666666666666666
on Road/Neutral Site,2010,Kansas State,3,4,7,0.42857142857142855
vs. Conference,2010,Kansas State,3,5,8,0.375
vs. Non-Conference,2010,Kansas State,4,1,5,0.8
vs. Ranked (AP),2010,Kansas State,1,3,4,0.25
vs. Unranked (AP),2010,Kansas State,6,3,9,0.6666666666666666
vs. FBS (I-A),2010,Kansas State,6,6,12,0.5
vs. FCS (I-AA),2010,Kansas State,1,0,1,1.0
vs. FBS Winning,2010,Kansas State,1,5,6,0.16666666666666666
vs. FBS Non-Winning,2010,Kansas State,5,1,6,0.8333333333333334
vs. BCS AQ,2010,Kansas State,4,6,10,0.4
vs. BCS non-AQ,2010,Kansas State,2,0,2,1.0
vs. FBS Power 5,2010,Kansas State,4,5,9,0.4444444444444444
vs. FBS non-Power 5,2010,Kansas State,2,1,3,0.6666666666666666
in August/September,2010,Kansas State,4,0,4,1.0
in October,2010,Kansas State,1,3,4,0.25
in November,2010,Kansas State,2,2,4,0.5
in December/January,2010,Kansas State,0,1,1,0.0
All Games,2011,Kansas State,10,3,13,0.7692307692307693
at Home,2011,Kansas State,6,1,7,0.8571428571428571
on Road/Neutral Site,2011,Kansas State,4,2,6,0.6666666666666666
vs. Conference,2011,Kansas State,7,2,9,0.7777777777777778
vs. Non-Conference,2011,Kansas State,3,1,4,0.75
vs. Ranked (AP),2011,Kansas State,1,3,4,0.25
vs. Unranked (AP),2011,Kansas State,9,0,9,1.0
vs. FBS (I-A),2011,Kansas State,9,3,12,0.75
vs. FCS (I-AA),2011,Kansas State,1,0,1,1.0
vs. FBS Winning,2011,Kansas State,4,3,7,0.5714285714285714
vs. FBS Non-Winning,2011,Kansas State,5,0,5,1.0
vs. BCS AQ,2011,Kansas State,8,3,11,0.7272727272727273
vs. BCS non-AQ,2011,Kansas State,1,0,1,1.0
vs. FBS Power 5,2011,Kansas State,8,3,11,0.7272727272727273
vs. FBS non-Power 5,2011,Kansas State,1,0,1,1.0
in August/September,2011,Kansas State,3,0,3,1.0
in October,2011,Kansas State,4,1,5,0.8
in November,2011,Kansas State,2,1,3,0.6666666666666666
in December/January,2011,Kansas State,1,1,2,0.5
All Games,2012,Kansas State,11,2,13,0.8461538461538461
at Home,2012,Kansas State,7,0,7,1.0
on Road/Neutral Site,2012,Kansas State,4,2,6,0.6666666666666666
vs. Conference,2012,Kansas State,8,1,9,0.8888888888888888
vs. Non-Conference,2012,Kansas State,3,1,4,0.75
vs. Ranked (AP),2012,Kansas State,2,1,3,0.6666666666666666
vs. Unranked (AP),2012,Kansas State,9,1,10,0.9
vs. FBS (I-A),2012,Kansas State,10,2,12,0.8333333333333334
vs. FCS (I-AA),2012,Kansas State,1,0,1,1.0
vs. FBS Winning,2012,Kansas State,7,2,9,0.7777777777777778
vs. FBS Non-Winning,2012,Kansas State,3,0,3,1.0
vs. BCS AQ,2012,Kansas State,9,2,11,0.8181818181818182
vs. BCS non-AQ,2012,Kansas State,1,0,1,1.0
vs. FBS Power 5,2012,Kansas State,9,2,11,0.8181818181818182
vs. FBS non-Power 5,2012,Kansas State,1,0,1,1.0
in August/September,2012,Kansas State,4,0,4,1.0
in October,2012,Kansas State,4,0,4,1.0
in November,2012,Kansas State,2,1,3,0.6666666666666666
in December/January,2012,Kansas State,1,1,2,0.5
All Games,2013,Kansas State,8,5,13,0.6153846153846154
at Home,2013,Kansas State,5,3,8,0.625
on Road/Neutral Site,2013,Kansas State,3,2,5,0.6
vs. Conference,2013,Kansas State,5,4,9,0.5555555555555556
vs. Non-Conference,2013,Kansas State,3,1,4,0.75
vs. Ranked (AP),2013,Kansas State,0,3,3,0.0
vs. Unranked (AP),2013,Kansas State,8,2,10,0.8
vs. FBS (I-A),2013,Kansas State,8,4,12,0.6666666666666666
vs. FCS (I-AA),2013,Kansas State,0,1,1,0.0
vs. FBS Winning,2013,Kansas State,3,4,7,0.42857142857142855
vs. FBS Non-Winning,2013,Kansas State,5,0,5,1.0
vs. BCS AQ,2013,Kansas State,6,4,10,0.6
vs. BCS non-AQ,2013,Kansas State,2,0,2,1.0
vs. FBS Power 5,2013,Kansas State,6,4,10,0.6
vs. FBS non-Power 5,2013,Kansas State,2,0,2,1.0
in August/September,2013,Kansas State,2,2,4,0.5
in October,2013,Kansas State,1,2,3,0.3333333333333333
in November,2013,Kansas State,4,1,5,0.8
in December/January,2013,Kansas State,1,0,1,1.0
All Games,2014,Kansas State,9,4,13,0.6923076923076923
at Home,2014,Kansas State,6,1,7,0.8571428571428571
on Road/Neutral Site,2014,Kansas State,3,3,6,0.5
vs. Conference,2014,Kansas State,7,2,9,0.7777777777777778
vs. Non-Conference,2014,Kansas State,2,2,4,0.5
vs. Ranked (AP),2014,Kansas State,0,4,4,0.0
vs. Unranked (AP),2014,Kansas State,9,0,9,1.0
vs. FBS (I-A),2014,Kansas State,8,4,12,0.6666666666666666
vs. FCS (I-AA),2014,Kansas State,1,0,1,1.0
vs. FBS Winning,2014,Kansas State,4,4,8,0.5
vs. FBS Non-Winning,2014,Kansas State,4,0,4,1.0
vs. BCS AQ,2014,Kansas State,7,4,11,0.6363636363636364
vs. BCS non-AQ,2014,Kansas State,1,0,1,1.0
vs. FBS Power 5,2014,Kansas State,7,4,11,0.6363636363636364
vs. FBS non-Power 5,2014,Kansas State,1,0,1,1.0
in August/September,2014,Kansas State,3,1,4,0.75
in October,2014,Kansas State,3,0,3,1.0
in November,2014,Kansas State,3,1,4,0.75
in December/January,2014,Kansas State,0,2,2,0.0
All Games,2015,Kansas State,6,7,13,0.46153846153846156
at Home,2015,Kansas State,4,3,7,0.5714285714285714
on Road/Neutral Site,2015,Kansas State,2,4,6,0.3333333333333333
vs. Conference,2015,Kansas State,3,6,9,0.3333333333333333
vs. Non-Conference,2015,Kansas State,3,1,4,0.75
vs. Ranked (AP),2015,Kansas State,0,4,4,0.0
vs. Unranked (AP),2015,Kansas State,6,3,9,0.6666666666666666
vs. FBS (I-A),2015,Kansas State,5,7,12,0.4166666666666667
vs. FCS (I-AA),2015,Kansas State,1,0,1,1.0
vs. FBS Winning,2015,Kansas State,2,6,8,0.25
vs. FBS Non-Winning,2015,Kansas State,3,1,4,0.75
vs. BCS AQ,2015,Kansas State,3,7,10,0.3
vs. BCS non-AQ,2015,Kansas State,2,0,2,1.0
vs. FBS Power 5,2015,Kansas State,3,7,10,0.3
vs. FBS non-Power 5,2015,Kansas State,2,0,2,1.0
in August/September,2015,Kansas State,3,0,3,1.0
in October,2015,Kansas State,0,4,4,0.0
in November,2015,Kansas State,2,2,4,0.5
in December/January,2015,Kansas State,1,1,2,0.5
All Games,2016,Kansas State,9,4,13,0.6923076923076923
at Home,2016,Kansas State,5,1,6,0.8333333333333334
on Road/Neutral Site,2016,Kansas State,4,3,7,0.5714285714285714
vs. Conference,2016,Kansas State,6,3,9,0.6666666666666666
vs. Non-Conference,2016,Kansas State,3,1,4,0.75
vs. Ranked (AP),2016,Kansas State,0,4,4,0.0
vs. Unranked (AP),2016,Kansas State,9,0,9,1.0
vs. FBS (I-A),2016,Kansas State,8,4,12,0.6666666666666666
vs. FCS (I-AA),2016,Kansas State,1,0,1,1.0
vs. FBS Winning,2016,Kansas State,2,4,6,0.3333333333333333
vs. FBS Non-Winning,2016,Kansas State,6,0,6,1.0
vs. BCS AQ,2016,Kansas State,7,4,11,0.6363636363636364
vs. BCS non-AQ,2016,Kansas State,1,0,1,1.0
vs. FBS Power 5,2016,Kansas State,7,4,11,0.6363636363636364
vs. FBS non-Power 5,2016,Kansas State,1,0,1,1.0
in August/September,2016,Kansas State,2,1,3,0.6666666666666666
in October,2016,Kansas State,3,2,5,0.6
in November,2016,Kansas State,2,1,3,0.6666666666666666
in December/January,2016,Kansas State,2,0,2,1.0
All Games,2017,Kansas State,8,5,13,0.6153846153846154
at Home,2017,Kansas State,4,3,7,0.5714285714285714
on Road/Neutral Site,2017,Kansas State,4,2,6,0.6666666666666666
vs. Conference,2017,Kansas State,5,4,9,0.5555555555555556
vs. Non-Conference,2017,Kansas State,3,1,4,0.75
vs. Ranked (AP),2017,Kansas State,1,2,3,0.3333333333333333
vs. Unranked (AP),2017,Kansas State,7,3,10,0.7
vs. FBS (I-A),2017,Kansas State,7,5,12,0.5833333333333334
vs. FCS (I-AA),2017,Kansas State,1,0,1,1.0
vs. FBS Winning,2017,Kansas State,2,4,6,0.3333333333333333
vs. FBS Non-Winning,2017,Kansas State,5,1,6,0.8333333333333334
vs. BCS AQ,2017,Kansas State,6,5,11,0.5454545454545454
vs. BCS non-AQ,2017,Kansas State,1,0,1,1.0
vs. FBS Power 5,2017,Kansas State,6,5,11,0.5454545454545454
vs. FBS non-Power 5,2017,Kansas State,1,0,1,1.0
in August/September,2017,Kansas State,3,1,4,0.75
in October,2017,Kansas State,1,3,4,0.25
in November,2017,Kansas State,3,1,4,0.75
in December/January,2017,Kansas State,1,0,1,1.0
All Games,2018,Kansas State,5,7,12,0.4166666666666667
at Home,2018,Kansas State,5,2,7,0.7142857142857143
on Road/Neutral Site,2018,Kansas State,0,5,5,0.0
vs. Conference,2018,Kansas State,3,6,9,0.3333333333333333
vs. Non-Conference,2018,Kansas State,2,1,3,0.6666666666666666
vs. Ranked (AP),2018,Kansas State,0,3,3,0.0
vs. Unranked (AP),2018,Kansas State,5,4,9,0.5555555555555556
vs. FBS (I-A),2018,Kansas State,4,7,11,0.36363636363636365
vs. FCS (I-AA),2018,Kansas State,1,0,1,1.0
vs. FBS Winning,2018,Kansas State,1,7,8,0.125
vs. FBS Non-Winning,2018,Kansas State,3,0,3,1.0
vs. BCS AQ,2018,Kansas State,3,7,10,0.3
vs. BCS non-AQ,2018,Kansas State,1,0,1,1.0
vs. FBS Power 5,2018,Kansas State,3,7,10,0.3
vs. FBS non-Power 5,2018,Kansas State,1,0,1,1.0
in August/September,2018,Kansas State,2,3,5,0.4
in October,2018,Kansas State,1,2,3,0.3333333333333333
in November,2018,Kansas State,2,2,4,0.5
in December/January,2018,Kansas State,0,0,0,
All Games,2019,Kansas State,8,5,13,0.6153846153846154
at Home,2019,Kansas State,5,2,7,0.7142857142857143
on Road/Neutral Site,2019,Kansas State,3,3,6,0.5
vs. Conference,2019,Kansas State,5,4,9,0.5555555555555556
vs. Non-Conference,2019,Kansas State,3,1,4,0.75
vs. Ranked (AP),2019,Kansas State,1,3,4,0.25
vs. Unranked (AP),2019,Kansas State,7,2,9,0.7777777777777778
vs. FBS (I-A),2019,Kansas State,7,5,12,0.5833333333333334
vs. FCS (I-AA),2019,Kansas State,1,0,1,1.0
vs. FBS Winning,2019,Kansas State,2,4,6,0.3333333333333333
vs. FBS Non-Winning,2019,Kansas State,5,1,6,0.8333333333333334
vs. BCS AQ,2019,Kansas State,6,5,11,0.5454545454545454
vs. BCS non-AQ,2019,Kansas State,1,0,1,1.0
vs. FBS Power 5,2019,Kansas State,6,4,10,0.6
vs. FBS non-Power 5,2019,Kansas State,1,1,2,0.5
in August/September,2019,Kansas State,3,1,4,0.75
in October,2019,Kansas State,2,1,3,0.6666666666666666
in November,2019,Kansas State,3,2,5,0.6
in December/January,2019,Kansas State,0,1,1,0.0
All Games,2020,Kansas State,4,6,10,0.4
at Home,2020,Kansas State,2,3,5,0.4
on Road/Neutral Site,2020,Kansas State,2,3,5,0.4
vs. Conference,2020,Kansas State,4,5,9,0.4444444444444444
vs. Non-Conference,2020,Kansas State,0,1,1,0.0
vs. Ranked (AP),2020,Kansas State,1,2,3,0.3333333333333333
vs. Unranked (AP),2020,Kansas State,3,4,7,0.42857142857142855
vs. FBS (I-A),2020,Kansas State,4,6,10,0.4
vs. FCS (I-AA),2020,Kansas State,0,0,0,
vs. FBS Winning,2020,Kansas State,2,4,6,0.3333333333333333
vs. FBS Non-Winning,2020,Kansas State,2,2,4,0.5
vs. BCS AQ,2020,Kansas State,4,5,9,0.4444444444444444
vs. BCS non-AQ,2020,Kansas State,0,1,1,0.0
vs. FBS Power 5,2020,Kansas State,4,5,9,0.4444444444444444
vs. FBS non-Power 5,2020,Kansas State,0,1,1,0.0
in August/September,2020,Kansas State,1,1,2,0.5
in October,2020,Kansas State,3,1,4,0.75
in November,2020,Kansas State,0,3,3,0.0
in December/January,2020,Kansas State,0,1,1,0.0
All Games,2021,Kansas State,8,5,13,0.6153846153846154
at Home,2021,Kansas State,4,3,7,0.5714285714285714
on Road/Neutral Site,2021,Kansas State,4,2,6,0.6666666666666666
vs. Conference,2021,Kansas State,4,5,9,0.4444444444444444
vs. Non-Conference,2021,Kansas State,4,0,4,1.0
vs. Ranked (AP),2021,Kansas State,0,3,3,0.0
vs. Unranked (AP),2021,Kansas State,8,2,10,0.8
vs. FBS (I-A),2021,Kansas State,7,5,12,0.5833333333333334
vs. FCS (I-AA),2021,Kansas State,1,0,1,1.0
vs. FBS Winning,2021,Kansas State,2,4,6,0.3333333333333333
vs. FBS Non-Winning,2021,Kansas State,5,1,6,0.8333333333333334
vs. BCS AQ,2021,Kansas State,6,5,11,0.5454545454545454
vs. BCS non-AQ,2021,Kansas State,1,0,1,1.0
vs. FBS Power 5,2021,Kansas State,6,5,11,0.5454545454545454
vs. FBS non-Power 5,2021,Kansas State,1,0,1,1.0
in August/September,2021,Kansas State,3,1,4,0.75
in October,2021,Kansas State,2,2,4,0.5
in November,2021,Kansas State,2,2,4,0.5
in December/January,2021,Kansas State,1,0,1,1.0
All Games,2022,Kansas State,10,4,14,0.7142857142857143
at Home,2022,Kansas State,5,2,7,0.7142857142857143
on Road/Neutral Site,2022,Kansas State,5,2,7,0.7142857142857143
vs. Conference,2022,Kansas State,8,2,10,0.8
vs. Non-Conference,2022,Kansas State,2,2,4,0.5
vs. Ranked (AP),2022,Kansas State,1,4,5,0.2
vs. Unranked (AP),2022,Kansas State,9,0,9,1.0
vs. FBS (I-A),2022,Kansas State,9,4,13,0.6923076923076923
vs. FCS (I-AA),2022,Kansas State,1,0,1,1.0
vs. FBS Winning,2022,Kansas State,3,4,7,0.42857142857142855
vs. FBS Non-Winning,2022,Kansas State,6,0,6,1.0
vs. BCS AQ,2022,Kansas State,9,4,13,0.6923076923076923
vs. BCS non-AQ,2022,Kansas State,0,0,0,
vs. FBS Power 5,2022,Kansas State,9,3,12,0.75
vs. FBS non-Power 5,2022,Kansas State,0,1,1,0.0
in August/September,2022,Kansas State,3,1,4,0.75
in October,2022,Kansas State,3,1,4,0.75
in November,2022,Kansas State,3,1,4,0.75
in December/January,2022,Kansas State,1,1,2,0.5
All Games,2009,Kent State,5,7,12,0.4166666666666667
at Home,2009,Kent State,3,3,6,0.5
on Road/Neutral Site,2009,Kent State,2,4,6,0.3333333333333333
vs. Conference,2009,Kent State,4,4,8,0.5
vs. Non-Conference,2009,Kent State,1,3,4,0.25
vs. Ranked (AP),2009,Kent State,0,0,0,
vs. Unranked (AP),2009,Kent State,5,7,12,0.4166666666666667
vs. FBS (I-A),2009,Kent State,4,7,11,0.36363636363636365
vs. FCS (I-AA),2009,Kent State,1,0,1,1.0
vs. FBS Winning,2009,Kent State,1,4,5,0.2
vs. FBS Non-Winning,2009,Kent State,3,3,6,0.5
vs. BCS AQ,2009,Kent State,0,3,3,0.0
vs. BCS non-AQ,2009,Kent State,4,4,8,0.5
vs. FBS Power 5,2009,Kent State,0,3,3,0.0
vs. FBS non-Power 5,2009,Kent State,4,4,8,0.5
in August/September,2009,Kent State,2,2,4,0.5
in October,2009,Kent State,3,2,5,0.6
in November,2009,Kent State,0,3,3,0.0
in December/January,2009,Kent State,0,0,0,
All Games,2010,Kent State,5,7,12,0.4166666666666667
at Home,2010,Kent State,4,2,6,0.6666666666666666
on Road/Neutral Site,2010,Kent State,1,5,6,0.16666666666666666
vs. Conference,2010,Kent State,4,4,8,0.5
vs. Non-Conference,2010,Kent State,1,3,4,0.25
vs. Ranked (AP),2010,Kent State,0,0,0,
vs. Unranked (AP),2010,Kent State,5,7,12,0.4166666666666667
vs. FBS (I-A),2010,Kent State,4,7,11,0.36363636363636365
vs. FCS (I-AA),2010,Kent State,1,0,1,1.0
vs. FBS Winning,2010,Kent State,1,6,7,0.14285714285714285
vs. FBS Non-Winning,2010,Kent State,3,1,4,0.75
vs. BCS AQ,2010,Kent State,0,2,2,0.0
vs. BCS non-AQ,2010,Kent State,4,5,9,0.4444444444444444
vs. FBS Power 5,2010,Kent State,0,2,2,0.0
vs. FBS non-Power 5,2010,Kent State,4,5,9,0.4444444444444444
in August/September,2010,Kent State,1,2,3,0.3333333333333333
in October,2010,Kent State,3,2,5,0.6
in November,2010,Kent State,1,3,4,0.25
in December/January,2010,Kent State,0,0,0,
All Games,2011,Kent State,5,7,12,0.4166666666666667
at Home,2011,Kent State,4,2,6,0.6666666666666666
on Road/Neutral Site,2011,Kent State,1,5,6,0.16666666666666666
vs. Conference,2011,Kent State,4,4,8,0.5
vs. Non-Conference,2011,Kent State,1,3,4,0.25
vs. Ranked (AP),2011,Kent State,0,2,2,0.0
vs. Unranked (AP),2011,Kent State,5,5,10,0.5
vs. FBS (I-A),2011,Kent State,4,7,11,0.36363636363636365
vs. FCS (I-AA),2011,Kent State,1,0,1,1.0
vs. FBS Winning,2011,Kent State,0,6,6,0.0
vs. FBS Non-Winning,2011,Kent State,4,1,5,0.8
vs. BCS AQ,2011,Kent State,0,2,2,0.0
vs. BCS non-AQ,2011,Kent State,4,5,9,0.4444444444444444
vs. FBS Power 5,2011,Kent State,0,2,2,0.0
vs. FBS non-Power 5,2011,Kent State,4,5,9,0.4444444444444444
in August/September,2011,Kent State,1,3,4,0.25
in October,2011,Kent State,1,3,4,0.25
in November,2011,Kent State,3,1,4,0.75
in December/January,2011,Kent State,0,0,0,
All Games,2012,Kent State,11,3,14,0.7857142857142857
at Home,2012,Kent State,5,0,5,1.0
on Road/Neutral Site,2012,Kent State,6,3,9,0.6666666666666666
vs. Conference,2012,Kent State,8,1,9,0.8888888888888888
vs. Non-Conference,2012,Kent State,3,2,5,0.6
vs. Ranked (AP),2012,Kent State,0,1,1,0.0
vs. Unranked (AP),2012,Kent State,11,2,13,0.8461538461538461
vs. FBS (I-A),2012,Kent State,10,3,13,0.7692307692307693
vs. FCS (I-AA),2012,Kent State,1,0,1,1.0
vs. FBS Winning,2012,Kent State,4,2,6,0.6666666666666666
vs. FBS Non-Winning,2012,Kent State,6,1,7,0.8571428571428571
vs. BCS AQ,2012,Kent State,1,1,2,0.5
vs. BCS non-AQ,2012,Kent State,9,2,11,0.8181818181818182
vs. FBS Power 5,2012,Kent State,0,1,1,0.0
vs. FBS non-Power 5,2012,Kent State,10,2,12,0.8333333333333334
in August/September,2012,Kent State,3,1,4,0.75
in October,2012,Kent State,4,0,4,1.0
in November,2012,Kent State,4,1,5,0.8
in December/January,2012,Kent State,0,1,1,0.0
All Games,2013,Kent State,4,8,12,0.3333333333333333
at Home,2013,Kent State,2,3,5,0.4
on Road/Neutral Site,2013,Kent State,2,5,7,0.2857142857142857
vs. Conference,2013,Kent State,3,5,8,0.375
vs. Non-Conference,2013,Kent State,1,3,4,0.25
vs. Ranked (AP),2013,Kent State,0,1,1,0.0
vs. Unranked (AP),2013,Kent State,4,7,11,0.36363636363636365
vs. FBS (I-A),2013,Kent State,3,8,11,0.2727272727272727
vs. FCS (I-AA),2013,Kent State,1,0,1,1.0
vs. FBS Winning,2013,Kent State,1,6,7,0.14285714285714285
vs. FBS Non-Winning,2013,Kent State,2,2,4,0.5
vs. BCS AQ,2013,Kent State,0,2,2,0.0
vs. BCS non-AQ,2013,Kent State,3,6,9,0.3333333333333333
vs. FBS Power 5,2013,Kent State,0,2,2,0.0
vs. FBS non-Power 5,2013,Kent State,3,6,9,0.3333333333333333
in August/September,2013,Kent State,2,3,5,0.4
in October,2013,Kent State,0,4,4,0.0
in November,2013,Kent State,2,1,3,0.6666666666666666
in December/January,2013,Kent State,0,0,0,
All Games,2014,Kent State,2,9,11,0.18181818181818182
at Home,2014,Kent State,2,4,6,0.3333333333333333
on Road/Neutral Site,2014,Kent State,0,5,5,0.0
vs. Conference,2014,Kent State,1,6,7,0.14285714285714285
vs. Non-Conference,2014,Kent State,1,3,4,0.25
vs. Ranked (AP),2014,Kent State,0,1,1,0.0
vs. Unranked (AP),2014,Kent State,2,8,10,0.2
vs. FBS (I-A),2014,Kent State,2,9,11,0.18181818181818182
vs. FCS (I-AA),2014,Kent State,0,0,0,
vs. FBS Winning,2014,Kent State,0,4,4,0.0
vs. FBS Non-Winning,2014,Kent State,2,5,7,0.2857142857142857
vs. BCS AQ,2014,Kent State,0,2,2,0.0
vs. BCS non-AQ,2014,Kent State,2,7,9,0.2222222222222222
vs. FBS Power 5,2014,Kent State,0,2,2,0.0
vs. FBS non-Power 5,2014,Kent State,2,7,9,0.2222222222222222
in August/September,2014,Kent State,0,4,4,0.0
in October,2014,Kent State,1,3,4,0.25
in November,2014,Kent State,1,2,3,0.3333333333333333
in December/January,2014,Kent State,0,0,0,
All Games,2015,Kent State,3,9,12,0.25
at Home,2015,Kent State,2,4,6,0.3333333333333333
on Road/Neutral Site,2015,Kent State,1,5,6,0.16666666666666666
vs. Conference,2015,Kent State,2,6,8,0.25
vs. Non-Conference,2015,Kent State,1,3,4,0.25
vs. Ranked (AP),2015,Kent State,0,0,0,
vs. Unranked (AP),2015,Kent State,3,9,12,0.25
vs. FBS (I-A),2015,Kent State,2,9,11,0.18181818181818182
vs. FCS (I-AA),2015,Kent State,1,0,1,1.0
vs. FBS Winning,2015,Kent State,0,6,6,0.0
vs. FBS Non-Winning,2015,Kent State,2,3,5,0.4
vs. BCS AQ,2015,Kent State,0,2,2,0.0
vs. BCS non-AQ,2015,Kent State,2,7,9,0.2222222222222222
vs. FBS Power 5,2015,Kent State,0,2,2,0.0
vs. FBS non-Power 5,2015,Kent State,2,7,9,0.2222222222222222
in August/September,2015,Kent State,1,3,4,0.25
in October,2015,Kent State,2,2,4,0.5
in November,2015,Kent State,0,4,4,0.0
in December/January,2015,Kent State,0,0,0,
All Games,2016,Kent State,3,9,12,0.25
at Home,2016,Kent State,1,5,6,0.16666666666666666
on Road/Neutral Site,2016,Kent State,2,4,6,0.3333333333333333
vs. Conference,2016,Kent State,2,6,8,0.25
vs. Non-Conference,2016,Kent State,1,3,4,0.25
vs. Ranked (AP),2016,Kent State,0,3,3,0.0
vs. Unranked (AP),2016,Kent State,3,6,9,0.3333333333333333
vs. FBS (I-A),2016,Kent State,2,8,10,0.2
vs. FCS (I-AA),2016,Kent State,1,1,2,0.5
vs. FBS Winning,2016,Kent State,0,4,4,0.0
vs. FBS Non-Winning,2016,Kent State,2,4,6,0.3333333333333333
vs. BCS AQ,2016,Kent State,0,2,2,0.0
vs. BCS non-AQ,2016,Kent State,2,6,8,0.25
vs. FBS Power 5,2016,Kent State,0,2,2,0.0
vs. FBS non-Power 5,2016,Kent State,2,6,8,0.25
in August/September,2016,Kent State,1,3,4,0.25
in October,2016,Kent State,2,3,5,0.4
in November,2016,Kent State,0,3,3,0.0
in December/January,2016,Kent State,0,0,0,
All Games,2017,Kent State,2,10,12,0.16666666666666666
at Home,2017,Kent State,2,3,5,0.4
on Road/Neutral Site,2017,Kent State,0,7,7,0.0
vs. Conference,2017,Kent State,1,7,8,0.125
vs. Non-Conference,2017,Kent State,1,3,4,0.25
vs. Ranked (AP),2017,Kent State,0,1,1,0.0
vs. Unranked (AP),2017,Kent State,2,9,11,0.18181818181818182
vs. FBS (I-A),2017,Kent State,1,10,11,0.09090909090909091
vs. FCS (I-AA),2017,Kent State,1,0,1,1.0
vs. FBS Winning,2017,Kent State,0,6,6,0.0
vs. FBS Non-Winning,2017,Kent State,1,4,5,0.2
vs. BCS AQ,2017,Kent State,0,2,2,0.0
vs. BCS non-AQ,2017,Kent State,1,8,9,0.1111111111111111
vs. FBS Power 5,2017,Kent State,0,2,2,0.0
vs. FBS non-Power 5,2017,Kent State,1,8,9,0.1111111111111111
in August/September,2017,Kent State,1,4,5,0.2
in October,2017,Kent State,1,3,4,0.25
in November,2017,Kent State,0,3,3,0.0
in December/January,2017,Kent State,0,0,0,
All Games,2018,Kent State,2,10,12,0.16666666666666666
at Home,2018,Kent State,1,4,5,0.2
on Road/Neutral Site,2018,Kent State,1,6,7,0.14285714285714285
vs. Conference,2018,Kent State,1,7,8,0.125
vs. Non-Conference,2018,Kent State,1,3,4,0.25
vs. Ranked (AP),2018,Kent State,0,1,1,0.0
vs. Unranked (AP),2018,Kent State,2,9,11,0.18181818181818182
vs. FBS (I-A),2018,Kent State,1,10,11,0.09090909090909091
vs. FCS (I-AA),2018,Kent State,1,0,1,1.0
vs. FBS Winning,2018,Kent State,0,5,5,0.0
vs. FBS Non-Winning,2018,Kent State,1,5,6,0.16666666666666666
vs. BCS AQ,2018,Kent State,0,3,3,0.0
vs. BCS non-AQ,2018,Kent State,1,7,8,0.125
vs. FBS Power 5,2018,Kent State,0,3,3,0.0
vs. FBS non-Power 5,2018,Kent State,1,7,8,0.125
in August/September,2018,Kent State,1,4,5,0.2
in October,2018,Kent State,1,3,4,0.25
in November,2018,Kent State,0,3,3,0.0
in December/January,2018,Kent State,0,0,0,
All Games,2019,Kent State,7,6,13,0.5384615384615384
at Home,2019,Kent State,4,1,5,0.8
on Road/Neutral Site,2019,Kent State,3,5,8,0.375
vs. Conference,2019,Kent State,5,3,8,0.625
vs. Non-Conference,2019,Kent State,2,3,5,0.4
vs. Ranked (AP),2019,Kent State,0,2,2,0.0
vs. Unranked (AP),2019,Kent State,7,4,11,0.6363636363636364
vs. FBS (I-A),2019,Kent State,6,6,12,0.5
vs. FCS (I-AA),2019,Kent State,1,0,1,1.0
vs. FBS Winning,2019,Kent State,2,5,7,0.2857142857142857
vs. FBS Non-Winning,2019,Kent State,4,1,5,0.8
vs. BCS AQ,2019,Kent State,0,3,3,0.0
vs. BCS non-AQ,2019,Kent State,6,3,9,0.6666666666666666
vs. FBS Power 5,2019,Kent State,0,3,3,0.0
vs. FBS non-Power 5,2019,Kent State,6,3,9,0.6666666666666666
in August/September,2019,Kent State,2,2,4,0.5
in October,2019,Kent State,1,3,4,0.25
in November,2019,Kent State,3,1,4,0.75
in December/January,2019,Kent State,1,0,1,1.0
All Games,2020,Kent State,3,1,4,0.75
at Home,2020,Kent State,2,0,2,1.0
on Road/Neutral Site,2020,Kent State,1,1,2,0.5
vs. Conference,2020,Kent State,3,1,4,0.75
vs. Non-Conference,2020,Kent State,0,0,0,
vs. Ranked (AP),2020,Kent State,0,0,0,
vs. Unranked (AP),2020,Kent State,3,1,4,0.75
vs. FBS (I-A),2020,Kent State,3,1,4,0.75
vs. FCS (I-AA),2020,Kent State,0,0,0,
vs. FBS Winning,2020,Kent State,0,1,1,0.0
vs. FBS Non-Winning,2020,Kent State,3,0,3,1.0
vs. BCS AQ,2020,Kent State,0,0,0,
vs. BCS non-AQ,2020,Kent State,3,1,4,0.75
vs. FBS Power 5,2020,Kent State,0,0,0,
vs. FBS non-Power 5,2020,Kent State,3,1,4,0.75
in August/September,2020,Kent State,0,0,0,
in October,2020,Kent State,0,0,0,
in November,2020,Kent State,3,1,4,0.75
in December/January,2020,Kent State,0,0,0,
All Games,2021,Kent State,7,7,14,0.5
at Home,2021,Kent State,5,0,5,1.0
on Road/Neutral Site,2021,Kent State,2,7,9,0.2222222222222222
vs. Conference,2021,Kent State,6,3,9,0.6666666666666666
vs. Non-Conference,2021,Kent State,1,4,5,0.2
vs. Ranked (AP),2021,Kent State,0,1,1,0.0
vs. Unranked (AP),2021,Kent State,7,6,13,0.5384615384615384
vs. FBS (I-A),2021,Kent State,6,7,13,0.46153846153846156
vs. FCS (I-AA),2021,Kent State,1,0,1,1.0
vs. FBS Winning,2021,Kent State,2,7,9,0.2222222222222222
vs. FBS Non-Winning,2021,Kent State,4,0,4,1.0
vs. BCS AQ,2021,Kent State,0,3,3,0.0
vs. BCS non-AQ,2021,Kent State,6,4,10,0.6
vs. FBS Power 5,2021,Kent State,0,3,3,0.0
vs. FBS non-Power 5,2021,Kent State,6,4,10,0.6
in August/September,2021,Kent State,1,3,4,0.25
in October,2021,Kent State,3,1,4,0.75
in November,2021,Kent State,3,1,4,0.75
in December/January,2021,Kent State,0,2,2,0.0
All Games,2022,Kent State,5,7,12,0.4166666666666667
at Home,2022,Kent State,3,2,5,0.6
on Road/Neutral Site,2022,Kent State,2,5,7,0.2857142857142857
vs. Conference,2022,Kent State,4,4,8,0.5
vs. Non-Conference,2022,Kent State,1,3,4,0.25
vs. Ranked (AP),2022,Kent State,0,2,2,0.0
vs. Unranked (AP),2022,Kent State,5,5,10,0.5
vs. FBS (I-A),2022,Kent State,4,7,11,0.36363636363636365
vs. FCS (I-AA),2022,Kent State,1,0,1,1.0
vs. FBS Winning,2022,Kent State,2,4,6,0.3333333333333333
vs. FBS Non-Winning,2022,Kent State,2,3,5,0.4
vs. BCS AQ,2022,Kent State,0,3,3,0.0
vs. BCS non-AQ,2022,Kent State,4,4,8,0.5
vs. FBS Power 5,2022,Kent State,0,3,3,0.0
vs. FBS non-Power 5,2022,Kent State,4,4,8,0.5
in August/September,2022,Kent State,1,3,4,0.25
in October,2022,Kent State,2,2,4,0.5
in November,2022,Kent State,2,2,4,0.5
in December/January,2022,Kent State,0,0,0,
All Games,2009,Kentucky,7,6,13,0.5384615384615384
at Home,2009,Kentucky,3,4,7,0.42857142857142855
on Road/Neutral Site,2009,Kentucky,4,2,6,0.6666666666666666
vs. Conference,2009,Kentucky,3,5,8,0.375
vs. Non-Conference,2009,Kentucky,4,1,5,0.8
vs. Ranked (AP),2009,Kentucky,0,3,3,0.0
vs. Unranked (AP),2009,Kentucky,7,3,10,0.7
vs. FBS (I-A),2009,Kentucky,6,6,12,0.5
vs. FCS (I-AA),2009,Kentucky,1,0,1,1.0
vs. FBS Winning,2009,Kentucky,2,5,7,0.2857142857142857
vs. FBS Non-Winning,2009,Kentucky,4,1,5,0.8
vs. BCS AQ,2009,Kentucky,4,6,10,0.4
vs. BCS non-AQ,2009,Kentucky,2,0,2,1.0
vs. FBS Power 5,2009,Kentucky,3,6,9,0.3333333333333333
vs. FBS non-Power 5,2009,Kentucky,3,0,3,1.0
in August/September,2009,Kentucky,2,1,3,0.6666666666666666
in October,2009,Kentucky,2,3,5,0.4
in November,2009,Kentucky,3,1,4,0.75
in December/January,2009,Kentucky,0,1,1,0.0
All Games,2010,Kentucky,6,7,13,0.46153846153846156
at Home,2010,Kentucky,5,2,7,0.7142857142857143
on Road/Neutral Site,2010,Kentucky,1,5,6,0.16666666666666666
vs. Conference,2010,Kentucky,2,6,8,0.25
vs. Non-Conference,2010,Kentucky,4,1,5,0.8
vs. Ranked (AP),2010,Kentucky,1,2,3,0.3333333333333333
vs. Unranked (AP),2010,Kentucky,5,5,10,0.5
vs. FBS (I-A),2010,Kentucky,5,7,12,0.4166666666666667
vs. FCS (I-AA),2010,Kentucky,1,0,1,1.0
vs. FBS Winning,2010,Kentucky,2,4,6,0.3333333333333333
vs. FBS Non-Winning,2010,Kentucky,3,3,6,0.5
vs. BCS AQ,2010,Kentucky,3,7,10,0.3
vs. BCS non-AQ,2010,Kentucky,2,0,2,1.0
vs. FBS Power 5,2010,Kentucky,2,6,8,0.25
vs. FBS non-Power 5,2010,Kentucky,3,1,4,0.75
in August/September,2010,Kentucky,3,1,4,0.75
in October,2010,Kentucky,1,4,5,0.2
in November,2010,Kentucky,2,1,3,0.6666666666666666
in December/January,2010,Kentucky,0,1,1,0.0
All Games,2011,Kentucky,5,7,12,0.4166666666666667
at Home,2011,Kentucky,4,3,7,0.5714285714285714
on Road/Neutral Site,2011,Kentucky,1,4,5,0.2
vs. Conference,2011,Kentucky,2,6,8,0.25
vs. Non-Conference,2011,Kentucky,3,1,4,0.75
vs. Ranked (AP),2011,Kentucky,0,3,3,0.0
vs. Unranked (AP),2011,Kentucky,5,4,9,0.5555555555555556
vs. FBS (I-A),2011,Kentucky,4,7,11,0.36363636363636365
vs. FCS (I-AA),2011,Kentucky,1,0,1,1.0
vs. FBS Winning,2011,Kentucky,1,6,7,0.14285714285714285
vs. FBS Non-Winning,2011,Kentucky,3,1,4,0.75
vs. BCS AQ,2011,Kentucky,2,7,9,0.2222222222222222
vs. BCS non-AQ,2011,Kentucky,2,0,2,1.0
vs. FBS Power 5,2011,Kentucky,2,6,8,0.25
vs. FBS non-Power 5,2011,Kentucky,2,1,3,0.6666666666666666
in August/September,2011,Kentucky,2,2,4,0.5
in October,2011,Kentucky,1,3,4,0.25
in November,2011,Kentucky,2,2,4,0.5
in December/January,2011,Kentucky,0,0,0,
All Games,2012,Kentucky,2,10,12,0.16666666666666666
at Home,2012,Kentucky,2,5,7,0.2857142857142857
on Road/Neutral Site,2012,Kentucky,0,5,5,0.0
vs. Conference,2012,Kentucky,0,8,8,0.0
vs. Non-Conference,2012,Kentucky,2,2,4,0.5
vs. Ranked (AP),2012,Kentucky,0,5,5,0.0
vs. Unranked (AP),2012,Kentucky,2,5,7,0.2857142857142857
vs. FBS (I-A),2012,Kentucky,1,10,11,0.09090909090909091
vs. FCS (I-AA),2012,Kentucky,1,0,1,1.0
vs. FBS Winning,2012,Kentucky,1,7,8,0.125
vs. FBS Non-Winning,2012,Kentucky,0,3,3,0.0
vs. BCS AQ,2012,Kentucky,0,9,9,0.0
vs. BCS non-AQ,2012,Kentucky,1,1,2,0.5
vs. FBS Power 5,2012,Kentucky,0,8,8,0.0
vs. FBS non-Power 5,2012,Kentucky,1,2,3,0.3333333333333333
in August/September,2012,Kentucky,1,4,5,0.2
in October,2012,Kentucky,0,4,4,0.0
in November,2012,Kentucky,1,2,3,0.3333333333333333
in December/January,2012,Kentucky,0,0,0,
All Games,2013,Kentucky,2,10,12,0.16666666666666666
at Home,2013,Kentucky,2,5,7,0.2857142857142857
on Road/Neutral Site,2013,Kentucky,0,5,5,0.0
vs. Conference,2013,Kentucky,0,8,8,0.0
vs. Non-Conference,2013,Kentucky,2,2,4,0.5
vs. Ranked (AP),2013,Kentucky,0,5,5,0.0
vs. Unranked (AP),2013,Kentucky,2,5,7,0.2857142857142857
vs. FBS (I-A),2013,Kentucky,1,10,11,0.09090909090909091
vs. FCS (I-AA),2013,Kentucky,1,0,1,1.0
vs. FBS Winning,2013,Kentucky,0,8,8,0.0
vs. FBS Non-Winning,2013,Kentucky,1,2,3,0.3333333333333333
vs. BCS AQ,2013,Kentucky,0,9,9,0.0
vs. BCS non-AQ,2013,Kentucky,1,1,2,0.5
vs. FBS Power 5,2013,Kentucky,0,8,8,0.0
vs. FBS non-Power 5,2013,Kentucky,1,2,3,0.3333333333333333
in August/September,2013,Kentucky,1,3,4,0.25
in October,2013,Kentucky,0,3,3,0.0
in November,2013,Kentucky,1,4,5,0.2
in December/January,2013,Kentucky,0,0,0,
All Games,2014,Kentucky,5,7,12,0.4166666666666667
at Home,2014,Kentucky,5,2,7,0.7142857142857143
on Road/Neutral Site,2014,Kentucky,0,5,5,0.0
vs. Conference,2014,Kentucky,2,6,8,0.25
vs. Non-Conference,2014,Kentucky,3,1,4,0.75
vs. Ranked (AP),2014,Kentucky,0,4,4,0.0
vs. Unranked (AP),2014,Kentucky,5,3,8,0.625
vs. FBS (I-A),2014,Kentucky,4,7,11,0.36363636363636365
vs. FCS (I-AA),2014,Kentucky,1,0,1,1.0
vs. FBS Winning,2014,Kentucky,1,7,8,0.125
vs. FBS Non-Winning,2014,Kentucky,3,0,3,1.0
vs. BCS AQ,2014,Kentucky,2,7,9,0.2222222222222222
vs. BCS non-AQ,2014,Kentucky,2,0,2,1.0
vs. FBS Power 5,2014,Kentucky,2,7,9,0.2222222222222222
vs. FBS non-Power 5,2014,Kentucky,2,0,2,1.0
in August/September,2014,Kentucky,3,1,4,0.75
in October,2014,Kentucky,2,2,4,0.5
in November,2014,Kentucky,0,4,4,0.0
in December/January,2014,Kentucky,0,0,0,
All Games,2015,Kentucky,5,7,12,0.4166666666666667
at Home,2015,Kentucky,4,4,8,0.5
on Road/Neutral Site,2015,Kentucky,1,3,4,0.25
vs. Conference,2015,Kentucky,2,6,8,0.25
vs. Non-Conference,2015,Kentucky,3,1,4,0.75
vs. Ranked (AP),2015,Kentucky,0,2,2,0.0
vs. Unranked (AP),2015,Kentucky,5,5,10,0.5
vs. FBS (I-A),2015,Kentucky,4,7,11,0.36363636363636365
vs. FCS (I-AA),2015,Kentucky,1,0,1,1.0
vs. FBS Winning,2015,Kentucky,0,6,6,0.0
vs. FBS Non-Winning,2015,Kentucky,4,1,5,0.8
vs. BCS AQ,2015,Kentucky,2,7,9,0.2222222222222222
vs. BCS non-AQ,2015,Kentucky,2,0,2,1.0
vs. FBS Power 5,2015,Kentucky,2,7,9,0.2222222222222222
vs. FBS non-Power 5,2015,Kentucky,2,0,2,1.0
in August/September,2015,Kentucky,3,1,4,0.75
in October,2015,Kentucky,1,3,4,0.25
in November,2015,Kentucky,1,3,4,0.25
in December/January,2015,Kentucky,0,0,0,
All Games,2016,Kentucky,7,6,13,0.5384615384615384
at Home,2016,Kentucky,5,2,7,0.7142857142857143
on Road/Neutral Site,2016,Kentucky,2,4,6,0.3333333333333333
vs. Conference,2016,Kentucky,4,4,8,0.5
vs. Non-Conference,2016,Kentucky,3,2,5,0.6
vs. Ranked (AP),2016,Kentucky,1,2,3,0.3333333333333333
vs. Unranked (AP),2016,Kentucky,6,4,10,0.6
vs. FBS (I-A),2016,Kentucky,6,6,12,0.5
vs. FCS (I-AA),2016,Kentucky,1,0,1,1.0
vs. FBS Winning,2016,Kentucky,1,6,7,0.14285714285714285
vs. FBS Non-Winning,2016,Kentucky,5,0,5,1.0
vs. BCS AQ,2016,Kentucky,5,5,10,0.5
vs. BCS non-AQ,2016,Kentucky,1,1,2,0.5
vs. FBS Power 5,2016,Kentucky,5,5,10,0.5
vs. FBS non-Power 5,2016,Kentucky,1,1,2,0.5
in August/September,2016,Kentucky,2,2,4,0.5
in October,2016,Kentucky,3,1,4,0.75
in November,2016,Kentucky,2,2,4,0.5
in December/January,2016,Kentucky,0,1,1,0.0
All Games,2017,Kentucky,7,6,13,0.5384615384615384
at Home,2017,Kentucky,4,3,7,0.5714285714285714
on Road/Neutral Site,2017,Kentucky,3,3,6,0.5
vs. Conference,2017,Kentucky,4,4,8,0.5
vs. Non-Conference,2017,Kentucky,3,2,5,0.6
vs. Ranked (AP),2017,Kentucky,0,3,3,0.0
vs. Unranked (AP),2017,Kentucky,7,3,10,0.7
vs. FBS (I-A),2017,Kentucky,6,6,12,0.5
vs. FCS (I-AA),2017,Kentucky,1,0,1,1.0
vs. FBS Winning,2017,Kentucky,3,4,7,0.42857142857142855
vs. FBS Non-Winning,2017,Kentucky,3,2,5,0.6
vs. BCS AQ,2017,Kentucky,4,6,10,0.4
vs. BCS non-AQ,2017,Kentucky,2,0,2,1.0
vs. FBS Power 5,2017,Kentucky,4,6,10,0.4
vs. FBS non-Power 5,2017,Kentucky,2,0,2,1.0
in August/September,2017,Kentucky,4,1,5,0.8
in October,2017,Kentucky,2,1,3,0.6666666666666666
in November,2017,Kentucky,1,3,4,0.25
in December/January,2017,Kentucky,0,1,1,0.0
All Games,2018,Kentucky,10,3,13,0.7692307692307693
at Home,2018,Kentucky,6,1,7,0.8571428571428571
on Road/Neutral Site,2018,Kentucky,4,2,6,0.6666666666666666
vs. Conference,2018,Kentucky,5,3,8,0.625
vs. Non-Conference,2018,Kentucky,5,0,5,1.0
vs. Ranked (AP),2018,Kentucky,2,2,4,0.5
vs. Unranked (AP),2018,Kentucky,8,1,9,0.8888888888888888
vs. FBS (I-A),2018,Kentucky,9,3,12,0.75
vs. FCS (I-AA),2018,Kentucky,1,0,1,1.0
vs. FBS Winning,2018,Kentucky,6,2,8,0.75
vs. FBS Non-Winning,2018,Kentucky,3,1,4,0.75
vs. BCS AQ,2018,Kentucky,7,3,10,0.7
vs. BCS non-AQ,2018,Kentucky,2,0,2,1.0
vs. FBS Power 5,2018,Kentucky,7,3,10,0.7
vs. FBS non-Power 5,2018,Kentucky,2,0,2,1.0
in August/September,2018,Kentucky,5,0,5,1.0
in October,2018,Kentucky,2,1,3,0.6666666666666666
in November,2018,Kentucky,2,2,4,0.5
in December/January,2018,Kentucky,1,0,1,1.0
All Games,2019,Kentucky,8,5,13,0.6153846153846154
at Home,2019,Kentucky,6,2,8,0.75
on Road/Neutral Site,2019,Kentucky,2,3,5,0.4
vs. Conference,2019,Kentucky,3,5,8,0.375
vs. Non-Conference,2019,Kentucky,5,0,5,1.0
vs. Ranked (AP),2019,Kentucky,0,2,2,0.0
vs. Unranked (AP),2019,Kentucky,8,3,11,0.7272727272727273
vs. FBS (I-A),2019,Kentucky,7,5,12,0.5833333333333334
vs. FCS (I-AA),2019,Kentucky,1,0,1,1.0
vs. FBS Winning,2019,Kentucky,2,3,5,0.4
vs. FBS Non-Winning,2019,Kentucky,5,2,7,0.7142857142857143
vs. BCS AQ,2019,Kentucky,5,5,10,0.5
vs. BCS non-AQ,2019,Kentucky,2,0,2,1.0
vs. FBS Power 5,2019,Kentucky,5,5,10,0.5
vs. FBS non-Power 5,2019,Kentucky,2,0,2,1.0
in August/September,2019,Kentucky,2,3,5,0.4
in October,2019,Kentucky,2,1,3,0.6666666666666666
in November,2019,Kentucky,3,1,4,0.75
in December/January,2019,Kentucky,1,0,1,1.0
All Games,2020,Kentucky,5,6,11,0.45454545454545453
at Home,2020,Kentucky,3,2,5,0.6
on Road/Neutral Site,2020,Kentucky,2,4,6,0.3333333333333333
vs. Conference,2020,Kentucky,4,6,10,0.4
vs. Non-Conference,2020,Kentucky,1,0,1,1.0
vs. Ranked (AP),2020,Kentucky,1,3,4,0.25
vs. Unranked (AP),2020,Kentucky,4,3,7,0.5714285714285714
vs. FBS (I-A),2020,Kentucky,5,6,11,0.45454545454545453
vs. FCS (I-AA),2020,Kentucky,0,0,0,
vs. FBS Winning,2020,Kentucky,1,4,5,0.2
vs. FBS Non-Winning,2020,Kentucky,4,2,6,0.6666666666666666
vs. BCS AQ,2020,Kentucky,5,6,11,0.45454545454545453
vs. BCS non-AQ,2020,Kentucky,0,0,0,
vs. FBS Power 5,2020,Kentucky,5,6,11,0.45454545454545453
vs. FBS non-Power 5,2020,Kentucky,0,0,0,
in August/September,2020,Kentucky,0,1,1,0.0
in October,2020,Kentucky,2,3,5,0.4
in November,2020,Kentucky,1,2,3,0.3333333333333333
in December/January,2020,Kentucky,2,0,2,1.0
All Games,2021,Kentucky,10,3,13,0.7692307692307693
at Home,2021,Kentucky,6,1,7,0.8571428571428571
on Road/Neutral Site,2021,Kentucky,4,2,6,0.6666666666666666
vs. Conference,2021,Kentucky,5,3,8,0.625
vs. Non-Conference,2021,Kentucky,5,0,5,1.0
vs. Ranked (AP),2021,Kentucky,1,1,2,0.5
vs. Unranked (AP),2021,Kentucky,9,2,11,0.8181818181818182
vs. FBS (I-A),2021,Kentucky,9,3,12,0.75
vs. FCS (I-AA),2021,Kentucky,1,0,1,1.0
vs. FBS Winning,2021,Kentucky,2,3,5,0.4
vs. FBS Non-Winning,2021,Kentucky,7,0,7,1.0
vs. BCS AQ,2021,Kentucky,7,3,10,0.7
vs. BCS non-AQ,2021,Kentucky,2,0,2,1.0
vs. FBS Power 5,2021,Kentucky,7,3,10,0.7
vs. FBS non-Power 5,2021,Kentucky,2,0,2,1.0
in August/September,2021,Kentucky,4,0,4,1.0
in October,2021,Kentucky,2,2,4,0.5
in November,2021,Kentucky,3,1,4,0.75
in December/January,2021,Kentucky,1,0,1,1.0
All Games,2022,Kentucky,7,6,13,0.5384615384615384
at Home,2022,Kentucky,5,3,8,0.625
on Road/Neutral Site,2022,Kentucky,2,3,5,0.4
vs. Conference,2022,Kentucky,3,5,8,0.375
vs. Non-Conference,2022,Kentucky,4,1,5,0.8
vs. Ranked (AP),2022,Kentucky,1,3,4,0.25
vs. Unranked (AP),2022,Kentucky,6,3,9,0.6666666666666666
vs. FBS (I-A),2022,Kentucky,6,6,12,0.5
vs. FCS (I-AA),2022,Kentucky,1,0,1,1.0
vs. FBS Winning,2022,Kentucky,2,5,7,0.2857142857142857
vs. FBS Non-Winning,2022,Kentucky,4,1,5,0.8
vs. BCS AQ,2022,Kentucky,4,6,10,0.4
vs. BCS non-AQ,2022,Kentucky,2,0,2,1.0
vs. FBS Power 5,2022,Kentucky,4,6,10,0.4
vs. FBS non-Power 5,2022,Kentucky,2,0,2,1.0
in August/September,2022,Kentucky,4,0,4,1.0
in October,2022,Kentucky,1,3,4,0.25
in November,2022,Kentucky,2,2,4,0.5
in December/January,2022,Kentucky,0,1,1,0.0
All Games,2009,LSU,9,4,13,0.6923076923076923
at Home,2009,LSU,6,1,7,0.8571428571428571
on Road/Neutral Site,2009,LSU,3,3,6,0.5
vs. Conference,2009,LSU,5,3,8,0.625
vs. Non-Conference,2009,LSU,4,1,5,0.8
vs. Ranked (AP),2009,LSU,0,4,4,0.0
vs. Unranked (AP),2009,LSU,9,0,9,1.0
vs. FBS (I-A),2009,LSU,9,4,13,0.6923076923076923
vs. FCS (I-AA),2009,LSU,0,0,0,
vs. FBS Winning,2009,LSU,3,4,7,0.42857142857142855
vs. FBS Non-Winning,2009,LSU,6,0,6,1.0
vs. BCS AQ,2009,LSU,6,4,10,0.6
vs. BCS non-AQ,2009,LSU,3,0,3,1.0
vs. FBS Power 5,2009,LSU,6,4,10,0.6
vs. FBS non-Power 5,2009,LSU,3,0,3,1.0
in August/September,2009,LSU,4,0,4,1.0
in October,2009,LSU,3,1,4,0.75
in November,2009,LSU,2,2,4,0.5
in December/January,2009,LSU,0,1,1,0.0
All Games,2010,LSU,11,2,13,0.8461538461538461
at Home,2010,LSU,7,0,7,1.0
on Road/Neutral Site,2010,LSU,4,2,6,0.6666666666666666
vs. Conference,2010,LSU,6,2,8,0.75
vs. Non-Conference,2010,LSU,5,0,5,1.0
vs. Ranked (AP),2010,LSU,3,2,5,0.6
vs. Unranked (AP),2010,LSU,8,0,8,1.0
vs. FBS (I-A),2010,LSU,10,2,12,0.8333333333333334
vs. FCS (I-AA),2010,LSU,1,0,1,1.0
vs. FBS Winning,2010,LSU,6,2,8,0.75
vs. FBS Non-Winning,2010,LSU,4,0,4,1.0
vs. BCS AQ,2010,LSU,9,2,11,0.8181818181818182
vs. BCS non-AQ,2010,LSU,1,0,1,1.0
vs. FBS Power 5,2010,LSU,8,2,10,0.8
vs. FBS non-Power 5,2010,LSU,2,0,2,1.0
in August/September,2010,LSU,4,0,4,1.0
in October,2010,LSU,3,1,4,0.75
in November,2010,LSU,3,1,4,0.75
in December/January,2010,LSU,1,0,1,1.0
All Games,2011,LSU,13,1,14,0.9285714285714286
at Home,2011,LSU,6,0,6,1.0
on Road/Neutral Site,2011,LSU,7,1,8,0.875
vs. Conference,2011,LSU,9,1,10,0.9
vs. Non-Conference,2011,LSU,4,0,4,1.0
vs. Ranked (AP),2011,LSU,5,1,6,0.8333333333333334
vs. Unranked (AP),2011,LSU,8,0,8,1.0
vs. FBS (I-A),2011,LSU,12,1,13,0.9230769230769231
vs. FCS (I-AA),2011,LSU,1,0,1,1.0
vs. FBS Winning,2011,LSU,9,1,10,0.9
vs. FBS Non-Winning,2011,LSU,3,0,3,1.0
vs. BCS AQ,2011,LSU,11,1,12,0.9166666666666666
vs. BCS non-AQ,2011,LSU,1,0,1,1.0
vs. FBS Power 5,2011,LSU,10,1,11,0.9090909090909091
vs. FBS non-Power 5,2011,LSU,2,0,2,1.0
in August/September,2011,LSU,4,0,4,1.0
in October,2011,LSU,4,0,4,1.0
in November,2011,LSU,4,0,4,1.0
in December/January,2011,LSU,1,1,2,0.5
All Games,2012,LSU,10,3,13,0.7692307692307693
at Home,2012,LSU,7,1,8,0.875
on Road/Neutral Site,2012,LSU,3,2,5,0.6
vs. Conference,2012,LSU,6,2,8,0.75
vs. Non-Conference,2012,LSU,4,1,5,0.8
vs. Ranked (AP),2012,LSU,2,3,5,0.4
vs. Unranked (AP),2012,LSU,8,0,8,1.0
vs. FBS (I-A),2012,LSU,9,3,12,0.75
vs. FCS (I-AA),2012,LSU,1,0,1,1.0
vs. FBS Winning,2012,LSU,5,3,8,0.625
vs. FBS Non-Winning,2012,LSU,4,0,4,1.0
vs. BCS AQ,2012,LSU,7,3,10,0.7
vs. BCS non-AQ,2012,LSU,2,0,2,1.0
vs. FBS Power 5,2012,LSU,7,3,10,0.7
vs. FBS non-Power 5,2012,LSU,2,0,2,1.0
in August/September,2012,LSU,5,0,5,1.0
in October,2012,LSU,2,1,3,0.6666666666666666
in November,2012,LSU,3,1,4,0.75
in December/January,2012,LSU,0,1,1,0.0
All Games,2013,LSU,10,3,13,0.7692307692307693
at Home,2013,LSU,7,0,7,1.0
on Road/Neutral Site,2013,LSU,3,3,6,0.5
vs. Conference,2013,LSU,5,3,8,0.625
vs. Non-Conference,2013,LSU,5,0,5,1.0
vs. Ranked (AP),2013,LSU,2,1,3,0.6666666666666666
vs. Unranked (AP),2013,LSU,8,2,10,0.8
vs. FBS (I-A),2013,LSU,9,3,12,0.75
vs. FCS (I-AA),2013,LSU,1,0,1,1.0
vs. FBS Winning,2013,LSU,4,3,7,0.5714285714285714
vs. FBS Non-Winning,2013,LSU,5,0,5,1.0
vs. BCS AQ,2013,LSU,7,3,10,0.7
vs. BCS non-AQ,2013,LSU,2,0,2,1.0
vs. FBS Power 5,2013,LSU,7,3,10,0.7
vs. FBS non-Power 5,2013,LSU,2,0,2,1.0
in August/September,2013,LSU,4,1,5,0.8
in October,2013,LSU,3,1,4,0.75
in November,2013,LSU,2,1,3,0.6666666666666666
in December/January,2013,LSU,1,0,1,1.0
All Games,2014,LSU,8,5,13,0.6153846153846154
at Home,2014,LSU,5,2,7,0.7142857142857143
on Road/Neutral Site,2014,LSU,3,3,6,0.5
vs. Conference,2014,LSU,4,4,8,0.5
vs. Non-Conference,2014,LSU,4,1,5,0.8
vs. Ranked (AP),2014,LSU,2,3,5,0.4
vs. Unranked (AP),2014,LSU,6,2,8,0.75
vs. FBS (I-A),2014,LSU,7,5,12,0.5833333333333334
vs. FCS (I-AA),2014,LSU,1,0,1,1.0
vs. FBS Winning,2014,LSU,4,5,9,0.4444444444444444
vs. FBS Non-Winning,2014,LSU,3,0,3,1.0
vs. BCS AQ,2014,LSU,5,5,10,0.5
vs. BCS non-AQ,2014,LSU,2,0,2,1.0
vs. FBS Power 5,2014,LSU,5,4,9,0.5555555555555556
vs. FBS non-Power 5,2014,LSU,2,1,3,0.6666666666666666
in August/September,2014,LSU,4,1,5,0.8
in October,2014,LSU,3,1,4,0.75
in November,2014,LSU,1,2,3,0.3333333333333333
in December/January,2014,LSU,0,1,1,0.0
All Games,2015,LSU,9,3,12,0.75
at Home,2015,LSU,6,1,7,0.8571428571428571
on Road/Neutral Site,2015,LSU,3,2,5,0.6
vs. Conference,2015,LSU,5,3,8,0.625
vs. Non-Conference,2015,LSU,4,0,4,1.0
vs. Ranked (AP),2015,LSU,2,2,4,0.5
vs. Unranked (AP),2015,LSU,7,1,8,0.875
vs. FBS (I-A),2015,LSU,9,3,12,0.75
vs. FCS (I-AA),2015,LSU,0,0,0,
vs. FBS Winning,2015,LSU,6,3,9,0.6666666666666666
vs. FBS Non-Winning,2015,LSU,3,0,3,1.0
vs. BCS AQ,2015,LSU,7,3,10,0.7
vs. BCS non-AQ,2015,LSU,2,0,2,1.0
vs. FBS Power 5,2015,LSU,7,3,10,0.7
vs. FBS non-Power 5,2015,LSU,2,0,2,1.0
in August/September,2015,LSU,3,0,3,1.0
in October,2015,LSU,4,0,4,1.0
in November,2015,LSU,1,3,4,0.25
in December/January,2015,LSU,1,0,1,1.0
All Games,2016,LSU,8,4,12,0.6666666666666666
at Home,2016,LSU,5,2,7,0.7142857142857143
on Road/Neutral Site,2016,LSU,3,2,5,0.6
vs. Conference,2016,LSU,5,3,8,0.625
vs. Non-Conference,2016,LSU,3,1,4,0.75
vs. Ranked (AP),2016,LSU,1,4,5,0.2
vs. Unranked (AP),2016,LSU,7,0,7,1.0
vs. FBS (I-A),2016,LSU,7,4,11,0.6363636363636364
vs. FCS (I-AA),2016,LSU,1,0,1,1.0
vs. FBS Winning,2016,LSU,4,4,8,0.5
vs. FBS Non-Winning,2016,LSU,3,0,3,1.0
vs. BCS AQ,2016,LSU,6,4,10,0.6
vs. BCS non-AQ,2016,LSU,1,0,1,1.0
vs. FBS Power 5,2016,LSU,6,4,10,0.6
vs. FBS non-Power 5,2016,LSU,1,0,1,1.0
in August/September,2016,LSU,2,2,4,0.5
in October,2016,LSU,3,0,3,1.0
in November,2016,LSU,2,2,4,0.5
in December/January,2016,LSU,1,0,1,1.0
All Games,2017,LSU,9,4,13,0.6923076923076923
at Home,2017,LSU,5,1,6,0.8333333333333334
on Road/Neutral Site,2017,LSU,4,3,7,0.5714285714285714
vs. Conference,2017,LSU,6,2,8,0.75
vs. Non-Conference,2017,LSU,3,2,5,0.6
vs. Ranked (AP),2017,LSU,1,3,4,0.25
vs. Unranked (AP),2017,LSU,8,1,9,0.8888888888888888
vs. FBS (I-A),2017,LSU,8,4,12,0.6666666666666666
vs. FCS (I-AA),2017,LSU,1,0,1,1.0
vs. FBS Winning,2017,LSU,2,4,6,0.3333333333333333
vs. FBS Non-Winning,2017,LSU,6,0,6,1.0
vs. BCS AQ,2017,LSU,7,3,10,0.7
vs. BCS non-AQ,2017,LSU,1,1,2,0.5
vs. FBS Power 5,2017,LSU,7,2,9,0.7777777777777778
vs. FBS non-Power 5,2017,LSU,1,2,3,0.3333333333333333
in August/September,2017,LSU,3,2,5,0.6
in October,2017,LSU,3,0,3,1.0
in November,2017,LSU,3,1,4,0.75
in December/January,2017,LSU,0,1,1,0.0
All Games,2018,LSU,10,3,13,0.7692307692307693
at Home,2018,LSU,6,1,7,0.8571428571428571
on Road/Neutral Site,2018,LSU,4,2,6,0.6666666666666666
vs. Conference,2018,LSU,5,3,8,0.625
vs. Non-Conference,2018,LSU,5,0,5,1.0
vs. Ranked (AP),2018,LSU,2,3,5,0.4
vs. Unranked (AP),2018,LSU,8,0,8,1.0
vs. FBS (I-A),2018,LSU,9,3,12,0.75
vs. FCS (I-AA),2018,LSU,1,0,1,1.0
vs. FBS Winning,2018,LSU,6,3,9,0.6666666666666666
vs. FBS Non-Winning,2018,LSU,3,0,3,1.0
vs. BCS AQ,2018,LSU,7,3,10,0.7
vs. BCS non-AQ,2018,LSU,2,0,2,1.0
vs. FBS Power 5,2018,LSU,6,3,9,0.6666666666666666
vs. FBS non-Power 5,2018,LSU,3,0,3,1.0
in August/September,2018,LSU,5,0,5,1.0
in October,2018,LSU,2,1,3,0.6666666666666666
in November,2018,LSU,2,2,4,0.5
in December/January,2018,LSU,1,0,1,1.0
All Games,2019,LSU,15,0,15,1.0
at Home,2019,LSU,7,0,7,1.0
on Road/Neutral Site,2019,LSU,8,0,8,1.0
vs. Conference,2019,LSU,9,0,9,1.0
vs. Non-Conference,2019,LSU,6,0,6,1.0
vs. Ranked (AP),2019,LSU,7,0,7,1.0
vs. Unranked (AP),2019,LSU,8,0,8,1.0
vs. FBS (I-A),2019,LSU,14,0,14,1.0
vs. FCS (I-AA),2019,LSU,1,0,1,1.0
vs. FBS Winning,2019,LSU,10,0,10,1.0
vs. FBS Non-Winning,2019,LSU,4,0,4,1.0
vs. BCS AQ,2019,LSU,12,0,12,1.0
vs. BCS non-AQ,2019,LSU,2,0,2,1.0
vs. FBS Power 5,2019,LSU,12,0,12,1.0
vs. FBS non-Power 5,2019,LSU,2,0,2,1.0
in August/September,2019,LSU,4,0,4,1.0
in October,2019,LSU,4,0,4,1.0
in November,2019,LSU,4,0,4,1.0
in December/January,2019,LSU,3,0,3,1.0
All Games,2020,LSU,5,5,10,0.5
at Home,2020,LSU,2,2,4,0.5
on Road/Neutral Site,2020,LSU,3,3,6,0.5
vs. Conference,2020,LSU,5,5,10,0.5
vs. Non-Conference,2020,LSU,0,0,0,
vs. Ranked (AP),2020,LSU,1,2,3,0.3333333333333333
vs. Unranked (AP),2020,LSU,4,3,7,0.5714285714285714
vs. FBS (I-A),2020,LSU,5,5,10,0.5
vs. FCS (I-AA),2020,LSU,0,0,0,
vs. FBS Winning,2020,LSU,1,3,4,0.25
vs. FBS Non-Winning,2020,LSU,4,2,6,0.6666666666666666
vs. BCS AQ,2020,LSU,5,5,10,0.5
vs. BCS non-AQ,2020,LSU,0,0,0,
vs. FBS Power 5,2020,LSU,5,5,10,0.5
vs. FBS non-Power 5,2020,LSU,0,0,0,
in August/September,2020,LSU,0,1,1,0.0
in October,2020,LSU,2,2,4,0.5
in November,2020,LSU,1,1,2,0.5
in December/January,2020,LSU,2,1,3,0.6666666666666666
All Games,2021,LSU,6,7,13,0.46153846153846156
at Home,2021,LSU,5,2,7,0.7142857142857143
on Road/Neutral Site,2021,LSU,1,5,6,0.16666666666666666
vs. Conference,2021,LSU,3,5,8,0.375
vs. Non-Conference,2021,LSU,3,2,5,0.6
vs. Ranked (AP),2021,LSU,0,4,4,0.0
vs. Unranked (AP),2021,LSU,6,3,9,0.6666666666666666
vs. FBS (I-A),2021,LSU,5,7,12,0.4166666666666667
vs. FCS (I-AA),2021,LSU,1,0,1,1.0
vs. FBS Winning,2021,LSU,3,6,9,0.3333333333333333
vs. FBS Non-Winning,2021,LSU,2,1,3,0.6666666666666666
vs. BCS AQ,2021,LSU,3,7,10,0.3
vs. BCS non-AQ,2021,LSU,2,0,2,1.0
vs. FBS Power 5,2021,LSU,3,7,10,0.3
vs. FBS non-Power 5,2021,LSU,2,0,2,1.0
in August/September,2021,LSU,3,1,4,0.75
in October,2021,LSU,1,3,4,0.25
in November,2021,LSU,2,2,4,0.5
in December/January,2021,LSU,0,1,1,0.0
All Games,2022,LSU,10,4,14,0.7142857142857143
at Home,2022,LSU,6,1,7,0.8571428571428571
on Road/Neutral Site,2022,LSU,4,3,7,0.5714285714285714
vs. Conference,2022,LSU,6,3,9,0.6666666666666666
vs. Non-Conference,2022,LSU,4,1,5,0.8
vs. Ranked (AP),2022,LSU,2,3,5,0.4
vs. Unranked (AP),2022,LSU,8,1,9,0.8888888888888888
vs. FBS (I-A),2022,LSU,9,4,13,0.6923076923076923
vs. FCS (I-AA),2022,LSU,1,0,1,1.0
vs. FBS Winning,2022,LSU,6,3,9,0.6666666666666666
vs. FBS Non-Winning,2022,LSU,3,1,4,0.75
vs. BCS AQ,2022,LSU,7,4,11,0.6363636363636364
vs. BCS non-AQ,2022,LSU,2,0,2,1.0
vs. FBS Power 5,2022,LSU,7,4,11,0.6363636363636364
vs. FBS non-Power 5,2022,LSU,2,0,2,1.0
in August/September,2022,LSU,3,1,4,0.75
in October,2022,LSU,3,1,4,0.75
in November,2022,LSU,3,1,4,0.75
in December/January,2022,LSU,1,1,2,0.5
All Games,2018,Liberty,6,6,12,0.5
at Home,2018,Liberty,5,1,6,0.8333333333333334
on Road/Neutral Site,2018,Liberty,1,5,6,0.16666666666666666
vs. Conference,2018,Liberty,1,3,4,0.25
vs. Non-Conference,2018,Liberty,5,3,8,0.625
vs. Ranked (AP),2018,Liberty,0,1,1,0.0
vs. Unranked (AP),2018,Liberty,6,5,11,0.5454545454545454
vs. FBS (I-A),2018,Liberty,4,6,10,0.4
vs. FCS (I-AA),2018,Liberty,2,0,2,1.0
vs. FBS Winning,2018,Liberty,1,4,5,0.2
vs. FBS Non-Winning,2018,Liberty,3,2,5,0.6
vs. BCS AQ,2018,Liberty,0,2,2,0.0
vs. BCS non-AQ,2018,Liberty,4,4,8,0.5
vs. FBS Power 5,2018,Liberty,0,2,2,0.0
vs. FBS non-Power 5,2018,Liberty,4,4,8,0.5
in August/September,2018,Liberty,2,2,4,0.5
in October,2018,Liberty,2,1,3,0.6666666666666666
in November,2018,Liberty,1,3,4,0.25
in December/January,2018,Liberty,1,0,1,1.0
All Games,2019,Liberty,8,5,13,0.6153846153846154
at Home,2019,Liberty,5,1,6,0.8333333333333334
on Road/Neutral Site,2019,Liberty,3,4,7,0.42857142857142855
vs. Conference,2019,Liberty,3,1,4,0.75
vs. Non-Conference,2019,Liberty,5,4,9,0.5555555555555556
vs. Ranked (AP),2019,Liberty,0,0,0,
vs. Unranked (AP),2019,Liberty,8,5,13,0.6153846153846154
vs. FBS (I-A),2019,Liberty,6,5,11,0.5454545454545454
vs. FCS (I-AA),2019,Liberty,2,0,2,1.0
vs. FBS Winning,2019,Liberty,2,3,5,0.4
vs. FBS Non-Winning,2019,Liberty,4,2,6,0.6666666666666666
vs. BCS AQ,2019,Liberty,0,3,3,0.0
vs. BCS non-AQ,2019,Liberty,6,2,8,0.75
vs. FBS Power 5,2019,Liberty,0,3,3,0.0
vs. FBS non-Power 5,2019,Liberty,6,2,8,0.75
in August/September,2019,Liberty,3,2,5,0.6
in October,2019,Liberty,2,1,3,0.6666666666666666
in November,2019,Liberty,2,2,4,0.5
in December/January,2019,Liberty,1,0,1,1.0
All Games,2020,Liberty,10,1,11,0.9090909090909091
at Home,2020,Liberty,6,0,6,1.0
on Road/Neutral Site,2020,Liberty,4,1,5,0.8
vs. Conference,2020,Liberty,1,0,1,1.0
vs. Non-Conference,2020,Liberty,9,1,10,0.9
vs. Ranked (AP),2020,Liberty,1,1,2,0.5
vs. Unranked (AP),2020,Liberty,9,0,9,1.0
vs. FBS (I-A),2020,Liberty,8,1,9,0.8888888888888888
vs. FCS (I-AA),2020,Liberty,2,0,2,1.0
vs. FBS Winning,2020,Liberty,1,1,2,0.5
vs. FBS Non-Winning,2020,Liberty,7,0,7,1.0
vs. BCS AQ,2020,Liberty,2,1,3,0.6666666666666666
vs. BCS non-AQ,2020,Liberty,6,0,6,1.0
vs. FBS Power 5,2020,Liberty,2,1,3,0.6666666666666666
vs. FBS non-Power 5,2020,Liberty,6,0,6,1.0
in August/September,2020,Liberty,2,0,2,1.0
in October,2020,Liberty,4,0,4,1.0
in November,2020,Liberty,3,1,4,0.75
in December/January,2020,Liberty,1,0,1,1.0
All Games,2021,Liberty,8,5,13,0.6153846153846154
at Home,2021,Liberty,4,2,6,0.6666666666666666
on Road/Neutral Site,2021,Liberty,4,3,7,0.5714285714285714
vs. Conference,2021,Liberty,1,1,2,0.5
vs. Non-Conference,2021,Liberty,7,4,11,0.6363636363636364
vs. Ranked (AP),2021,Liberty,0,2,2,0.0
vs. Unranked (AP),2021,Liberty,8,3,11,0.7272727272727273
vs. FBS (I-A),2021,Liberty,7,5,12,0.5833333333333334
vs. FCS (I-AA),2021,Liberty,1,0,1,1.0
vs. FBS Winning,2021,Liberty,3,3,6,0.5
vs. FBS Non-Winning,2021,Liberty,4,2,6,0.6666666666666666
vs. BCS AQ,2021,Liberty,0,2,2,0.0
vs. BCS non-AQ,2021,Liberty,7,3,10,0.7
vs. FBS Power 5,2021,Liberty,0,2,2,0.0
vs. FBS non-Power 5,2021,Liberty,7,3,10,0.7
in August/September,2021,Liberty,3,1,4,0.75
in October,2021,Liberty,4,1,5,0.8
in November,2021,Liberty,0,3,3,0.0
in December/January,2021,Liberty,1,0,1,1.0
All Games,2022,Liberty,8,5,13,0.6153846153846154
at Home,2022,Liberty,4,2,6,0.6666666666666666
on Road/Neutral Site,2022,Liberty,4,3,7,0.5714285714285714
vs. Conference,2022,Liberty,2,2,4,0.5
vs. Non-Conference,2022,Liberty,6,3,9,0.6666666666666666
vs. Ranked (AP),2022,Liberty,0,0,0,
vs. Unranked (AP),2022,Liberty,8,5,13,0.6153846153846154
vs. FBS (I-A),2022,Liberty,7,5,12,0.5833333333333334
vs. FCS (I-AA),2022,Liberty,1,0,1,1.0
vs. FBS Winning,2022,Liberty,4,3,7,0.5714285714285714
vs. FBS Non-Winning,2022,Liberty,3,2,5,0.6
vs. BCS AQ,2022,Liberty,1,2,3,0.3333333333333333
vs. BCS non-AQ,2022,Liberty,6,3,9,0.6666666666666666
vs. FBS Power 5,2022,Liberty,1,2,3,0.3333333333333333
vs. FBS non-Power 5,2022,Liberty,6,3,9,0.6666666666666666
in August/September,2022,Liberty,3,1,4,0.75
in October,2022,Liberty,4,0,4,1.0
in November,2022,Liberty,1,3,4,0.25
in December/January,2022,Liberty,0,1,1,0.0
All Games,2009,Louisiana Tech,4,8,12,0.3333333333333333
at Home,2009,Louisiana Tech,4,1,5,0.8
on Road/Neutral Site,2009,Louisiana Tech,0,7,7,0.0
vs. Conference,2009,Louisiana Tech,3,5,8,0.375
vs. Non-Conference,2009,Louisiana Tech,1,3,4,0.25
vs. Ranked (AP),2009,Louisiana Tech,0,2,2,0.0
vs. Unranked (AP),2009,Louisiana Tech,4,6,10,0.4
vs. FBS (I-A),2009,Louisiana Tech,3,8,11,0.2727272727272727
vs. FCS (I-AA),2009,Louisiana Tech,1,0,1,1.0
vs. FBS Winning,2009,Louisiana Tech,0,7,7,0.0
vs. FBS Non-Winning,2009,Louisiana Tech,3,1,4,0.75
vs. BCS AQ,2009,Louisiana Tech,0,2,2,0.0
vs. BCS non-AQ,2009,Louisiana Tech,3,6,9,0.3333333333333333
vs. FBS Power 5,2009,Louisiana Tech,0,2,2,0.0
vs. FBS non-Power 5,2009,Louisiana Tech,3,6,9,0.3333333333333333
in August/September,2009,Louisiana Tech,2,2,4,0.5
in October,2009,Louisiana Tech,1,3,4,0.25
in November,2009,Louisiana Tech,0,3,3,0.0
in December/January,2009,Louisiana Tech,1,0,1,1.0
All Games,2010,Louisiana Tech,5,7,12,0.4166666666666667
at Home,2010,Louisiana Tech,2,4,6,0.3333333333333333
on Road/Neutral Site,2010,Louisiana Tech,3,3,6,0.5
vs. Conference,2010,Louisiana Tech,4,4,8,0.5
vs. Non-Conference,2010,Louisiana Tech,1,3,4,0.25
vs. Ranked (AP),2010,Louisiana Tech,0,3,3,0.0
vs. Unranked (AP),2010,Louisiana Tech,5,4,9,0.5555555555555556
vs. FBS (I-A),2010,Louisiana Tech,4,7,11,0.36363636363636365
vs. FCS (I-AA),2010,Louisiana Tech,1,0,1,1.0
vs. FBS Winning,2010,Louisiana Tech,0,7,7,0.0
vs. FBS Non-Winning,2010,Louisiana Tech,4,0,4,1.0
vs. BCS AQ,2010,Louisiana Tech,0,1,1,0.0
vs. BCS non-AQ,2010,Louisiana Tech,4,6,10,0.4
vs. FBS Power 5,2010,Louisiana Tech,0,1,1,0.0
vs. FBS non-Power 5,2010,Louisiana Tech,4,6,10,0.4
in August/September,2010,Louisiana Tech,1,3,4,0.25
in October,2010,Louisiana Tech,2,2,4,0.5
in November,2010,Louisiana Tech,2,1,3,0.6666666666666666
in December/January,2010,Louisiana Tech,0,1,1,0.0
All Games,2011,Louisiana Tech,8,5,13,0.6153846153846154
at Home,2011,Louisiana Tech,3,2,5,0.6
on Road/Neutral Site,2011,Louisiana Tech,5,3,8,0.625
vs. Conference,2011,Louisiana Tech,6,1,7,0.8571428571428571
vs. Non-Conference,2011,Louisiana Tech,2,4,6,0.3333333333333333
vs. Ranked (AP),2011,Louisiana Tech,0,3,3,0.0
vs. Unranked (AP),2011,Louisiana Tech,8,2,10,0.8
vs. FBS (I-A),2011,Louisiana Tech,7,5,12,0.5833333333333334
vs. FCS (I-AA),2011,Louisiana Tech,1,0,1,1.0
vs. FBS Winning,2011,Louisiana Tech,2,4,6,0.3333333333333333
vs. FBS Non-Winning,2011,Louisiana Tech,5,1,6,0.8333333333333334
vs. BCS AQ,2011,Louisiana Tech,1,1,2,0.5
vs. BCS non-AQ,2011,Louisiana Tech,6,4,10,0.6
vs. FBS Power 5,2011,Louisiana Tech,1,1,2,0.5
vs. FBS non-Power 5,2011,Louisiana Tech,6,4,10,0.6
in August/September,2011,Louisiana Tech,1,3,4,0.25
in October,2011,Louisiana Tech,3,1,4,0.75
in November,2011,Louisiana Tech,4,0,4,1.0
in December/January,2011,Louisiana Tech,0,1,1,0.0
All Games,2012,Louisiana Tech,9,3,12,0.75
at Home,2012,Louisiana Tech,4,2,6,0.6666666666666666
on Road/Neutral Site,2012,Louisiana Tech,5,1,6,0.8333333333333334
vs. Conference,2012,Louisiana Tech,4,2,6,0.6666666666666666
vs. Non-Conference,2012,Louisiana Tech,5,1,6,0.8333333333333334
vs. Ranked (AP),2012,Louisiana Tech,0,3,3,0.0
vs. Unranked (AP),2012,Louisiana Tech,9,0,9,1.0
vs. FBS (I-A),2012,Louisiana Tech,9,3,12,0.75
vs. FCS (I-AA),2012,Louisiana Tech,0,0,0,
vs. FBS Winning,2012,Louisiana Tech,2,3,5,0.4
vs. FBS Non-Winning,2012,Louisiana Tech,7,0,7,1.0
vs. BCS AQ,2012,Louisiana Tech,2,1,3,0.6666666666666666
vs. BCS non-AQ,2012,Louisiana Tech,7,2,9,0.7777777777777778
vs. FBS Power 5,2012,Louisiana Tech,2,1,3,0.6666666666666666
vs. FBS non-Power 5,2012,Louisiana Tech,7,2,9,0.7777777777777778
in August/September,2012,Louisiana Tech,4,0,4,1.0
in October,2012,Louisiana Tech,3,1,4,0.75
in November,2012,Louisiana Tech,2,2,4,0.5
in December/January,2012,Louisiana Tech,0,0,0,
All Games,2013,Louisiana Tech,4,8,12,0.3333333333333333
at Home,2013,Louisiana Tech,2,3,5,0.4
on Road/Neutral Site,2013,Louisiana Tech,2,5,7,0.2857142857142857
vs. Conference,2013,Louisiana Tech,3,5,8,0.375
vs. Non-Conference,2013,Louisiana Tech,1,3,4,0.25
vs. Ranked (AP),2013,Louisiana Tech,0,0,0,
vs. Unranked (AP),2013,Louisiana Tech,4,8,12,0.3333333333333333
vs. FBS (I-A),2013,Louisiana Tech,3,8,11,0.2727272727272727
vs. FCS (I-AA),2013,Louisiana Tech,1,0,1,1.0
vs. FBS Winning,2013,Louisiana Tech,0,4,4,0.0
vs. FBS Non-Winning,2013,Louisiana Tech,3,4,7,0.42857142857142855
vs. BCS AQ,2013,Louisiana Tech,0,2,2,0.0
vs. BCS non-AQ,2013,Louisiana Tech,3,6,9,0.3333333333333333
vs. FBS Power 5,2013,Louisiana Tech,0,2,2,0.0
vs. FBS non-Power 5,2013,Louisiana Tech,3,6,9,0.3333333333333333
in August/September,2013,Louisiana Tech,1,4,5,0.2
in October,2013,Louisiana Tech,2,1,3,0.6666666666666666
in November,2013,Louisiana Tech,1,3,4,0.25
in December/January,2013,Louisiana Tech,0,0,0,
All Games,2014,Louisiana Tech,9,5,14,0.6428571428571429
at Home,2014,Louisiana Tech,4,1,5,0.8
on Road/Neutral Site,2014,Louisiana Tech,5,4,9,0.5555555555555556
vs. Conference,2014,Louisiana Tech,7,2,9,0.7777777777777778
vs. Non-Conference,2014,Louisiana Tech,2,3,5,0.4
vs. Ranked (AP),2014,Louisiana Tech,0,2,2,0.0
vs. Unranked (AP),2014,Louisiana Tech,9,3,12,0.75
vs. FBS (I-A),2014,Louisiana Tech,9,4,13,0.6923076923076923
vs. FCS (I-AA),2014,Louisiana Tech,0,1,1,0.0
vs. FBS Winning,2014,Louisiana Tech,4,3,7,0.5714285714285714
vs. FBS Non-Winning,2014,Louisiana Tech,5,1,6,0.8333333333333334
vs. BCS AQ,2014,Louisiana Tech,1,2,3,0.3333333333333333
vs. BCS non-AQ,2014,Louisiana Tech,8,2,10,0.8
vs. FBS Power 5,2014,Louisiana Tech,1,2,3,0.3333333333333333
vs. FBS non-Power 5,2014,Louisiana Tech,8,2,10,0.8
in August/September,2014,Louisiana Tech,2,3,5,0.4
in October,2014,Louisiana Tech,3,0,3,1.0
in November,2014,Louisiana Tech,3,1,4,0.75
in December/January,2014,Louisiana Tech,1,1,2,0.5
All Games,2015,Louisiana Tech,9,4,13,0.6923076923076923
at Home,2015,Louisiana Tech,5,1,6,0.8333333333333334
on Road/Neutral Site,2015,Louisiana Tech,4,3,7,0.5714285714285714
vs. Conference,2015,Louisiana Tech,6,2,8,0.75
vs. Non-Conference,2015,Louisiana Tech,3,2,5,0.6
vs. Ranked (AP),2015,Louisiana Tech,0,1,1,0.0
vs. Unranked (AP),2015,Louisiana Tech,9,3,12,0.75
vs. FBS (I-A),2015,Louisiana Tech,8,4,12,0.6666666666666666
vs. FCS (I-AA),2015,Louisiana Tech,1,0,1,1.0
vs. FBS Winning,2015,Louisiana Tech,2,3,5,0.4
vs. FBS Non-Winning,2015,Louisiana Tech,6,1,7,0.8571428571428571
vs. BCS AQ,2015,Louisiana Tech,0,2,2,0.0
vs. BCS non-AQ,2015,Louisiana Tech,8,2,10,0.8
vs. FBS Power 5,2015,Louisiana Tech,0,2,2,0.0
vs. FBS non-Power 5,2015,Louisiana Tech,8,2,10,0.8
in August/September,2015,Louisiana Tech,2,2,4,0.5
in October,2015,Louisiana Tech,4,1,5,0.8
in November,2015,Louisiana Tech,2,1,3,0.6666666666666666
in December/January,2015,Louisiana Tech,1,0,1,1.0
All Games,2016,Louisiana Tech,9,5,14,0.6428571428571429
at Home,2016,Louisiana Tech,5,0,5,1.0
on Road/Neutral Site,2016,Louisiana Tech,4,5,9,0.4444444444444444
vs. Conference,2016,Louisiana Tech,6,3,9,0.6666666666666666
vs. Non-Conference,2016,Louisiana Tech,3,2,5,0.6
vs. Ranked (AP),2016,Louisiana Tech,0,0,0,
vs. Unranked (AP),2016,Louisiana Tech,9,5,14,0.6428571428571429
vs. FBS (I-A),2016,Louisiana Tech,8,5,13,0.6153846153846154
vs. FCS (I-AA),2016,Louisiana Tech,1,0,1,1.0
vs. FBS Winning,2016,Louisiana Tech,2,4,6,0.3333333333333333
vs. FBS Non-Winning,2016,Louisiana Tech,6,1,7,0.8571428571428571
vs. BCS AQ,2016,Louisiana Tech,1,2,3,0.3333333333333333
vs. BCS non-AQ,2016,Louisiana Tech,7,3,10,0.7
vs. FBS Power 5,2016,Louisiana Tech,0,2,2,0.0
vs. FBS non-Power 5,2016,Louisiana Tech,8,3,11,0.7272727272727273
in August/September,2016,Louisiana Tech,1,3,4,0.25
in October,2016,Louisiana Tech,5,0,5,1.0
in November,2016,Louisiana Tech,2,1,3,0.6666666666666666
in December/January,2016,Louisiana Tech,1,1,2,0.5
All Games,2017,Louisiana Tech,7,6,13,0.5384615384615384
at Home,2017,Louisiana Tech,3,4,7,0.42857142857142855
on Road/Neutral Site,2017,Louisiana Tech,4,2,6,0.6666666666666666
vs. Conference,2017,Louisiana Tech,4,4,8,0.5
vs. Non-Conference,2017,Louisiana Tech,3,2,5,0.6
vs. Ranked (AP),2017,Louisiana Tech,0,1,1,0.0
vs. Unranked (AP),2017,Louisiana Tech,7,5,12,0.5833333333333334
vs. FBS (I-A),2017,Louisiana Tech,6,6,12,0.5
vs. FCS (I-AA),2017,Louisiana Tech,1,0,1,1.0
vs. FBS Winning,2017,Louisiana Tech,2,6,8,0.25
vs. FBS Non-Winning,2017,Louisiana Tech,4,0,4,1.0
vs. BCS AQ,2017,Louisiana Tech,1,2,3,0.3333333333333333
vs. BCS non-AQ,2017,Louisiana Tech,5,4,9,0.5555555555555556
vs. FBS Power 5,2017,Louisiana Tech,0,2,2,0.0
vs. FBS non-Power 5,2017,Louisiana Tech,6,4,10,0.6
in August/September,2017,Louisiana Tech,3,2,5,0.6
in October,2017,Louisiana Tech,1,2,3,0.3333333333333333
in November,2017,Louisiana Tech,2,2,4,0.5
in December/January,2017,Louisiana Tech,1,0,1,1.0
All Games,2018,Louisiana Tech,8,5,13,0.6153846153846154
at Home,2018,Louisiana Tech,3,2,5,0.6
on Road/Neutral Site,2018,Louisiana Tech,5,3,8,0.625
vs. Conference,2018,Louisiana Tech,5,3,8,0.625
vs. Non-Conference,2018,Louisiana Tech,3,2,5,0.6
vs. Ranked (AP),2018,Louisiana Tech,0,1,1,0.0
vs. Unranked (AP),2018,Louisiana Tech,8,4,12,0.6666666666666666
vs. FBS (I-A),2018,Louisiana Tech,7,5,12,0.5833333333333334
vs. FCS (I-AA),2018,Louisiana Tech,1,0,1,1.0
vs. FBS Winning,2018,Louisiana Tech,2,4,6,0.3333333333333333
vs. FBS Non-Winning,2018,Louisiana Tech,5,1,6,0.8333333333333334
vs. BCS AQ,2018,Louisiana Tech,0,2,2,0.0
vs. BCS non-AQ,2018,Louisiana Tech,7,3,10,0.7
vs. FBS Power 5,2018,Louisiana Tech,0,2,2,0.0
vs. FBS non-Power 5,2018,Louisiana Tech,7,3,10,0.7
in August/September,2018,Louisiana Tech,3,1,4,0.75
in October,2018,Louisiana Tech,3,1,4,0.75
in November,2018,Louisiana Tech,1,3,4,0.25
in December/January,2018,Louisiana Tech,1,0,1,1.0
All Games,2019,Louisiana Tech,10,3,13,0.7692307692307693
at Home,2019,Louisiana Tech,6,0,6,1.0
on Road/Neutral Site,2019,Louisiana Tech,4,3,7,0.5714285714285714
vs. Conference,2019,Louisiana Tech,6,2,8,0.75
vs. Non-Conference,2019,Louisiana Tech,4,1,5,0.8
vs. Ranked (AP),2019,Louisiana Tech,0,1,1,0.0
vs. Unranked (AP),2019,Louisiana Tech,10,2,12,0.8333333333333334
vs. FBS (I-A),2019,Louisiana Tech,9,3,12,0.75
vs. FCS (I-AA),2019,Louisiana Tech,1,0,1,1.0
vs. FBS Winning,2019,Louisiana Tech,1,3,4,0.25
vs. FBS Non-Winning,2019,Louisiana Tech,8,0,8,1.0
vs. BCS AQ,2019,Louisiana Tech,1,1,2,0.5
vs. BCS non-AQ,2019,Louisiana Tech,8,2,10,0.8
vs. FBS Power 5,2019,Louisiana Tech,1,1,2,0.5
vs. FBS non-Power 5,2019,Louisiana Tech,8,2,10,0.8
in August/September,2019,Louisiana Tech,4,1,5,0.8
in October,2019,Louisiana Tech,3,0,3,1.0
in November,2019,Louisiana Tech,2,2,4,0.5
in December/January,2019,Louisiana Tech,1,0,1,1.0
All Games,2020,Louisiana Tech,5,5,10,0.5
at Home,2020,Louisiana Tech,3,1,4,0.75
on Road/Neutral Site,2020,Louisiana Tech,2,4,6,0.3333333333333333
vs. Conference,2020,Louisiana Tech,4,2,6,0.6666666666666666
vs. Non-Conference,2020,Louisiana Tech,1,3,4,0.25
vs. Ranked (AP),2020,Louisiana Tech,0,1,1,0.0
vs. Unranked (AP),2020,Louisiana Tech,5,4,9,0.5555555555555556
vs. FBS (I-A),2020,Louisiana Tech,4,5,9,0.4444444444444444
vs. FCS (I-AA),2020,Louisiana Tech,1,0,1,1.0
vs. FBS Winning,2020,Louisiana Tech,1,5,6,0.16666666666666666
vs. FBS Non-Winning,2020,Louisiana Tech,3,0,3,1.0
vs. BCS AQ,2020,Louisiana Tech,0,1,1,0.0
vs. BCS non-AQ,2020,Louisiana Tech,4,4,8,0.5
vs. FBS Power 5,2020,Louisiana Tech,0,1,1,0.0
vs. FBS non-Power 5,2020,Louisiana Tech,4,4,8,0.5
in August/September,2020,Louisiana Tech,2,0,2,1.0
in October,2020,Louisiana Tech,2,3,5,0.4
in November,2020,Louisiana Tech,0,0,0,
in December/January,2020,Louisiana Tech,1,2,3,0.3333333333333333
All Games,2021,Louisiana Tech,3,9,12,0.25
at Home,2021,Louisiana Tech,3,3,6,0.5
on Road/Neutral Site,2021,Louisiana Tech,0,6,6,0.0
vs. Conference,2021,Louisiana Tech,2,6,8,0.25
vs. Non-Conference,2021,Louisiana Tech,1,3,4,0.25
vs. Ranked (AP),2021,Louisiana Tech,0,1,1,0.0
vs. Unranked (AP),2021,Louisiana Tech,3,8,11,0.2727272727272727
vs. FBS (I-A),2021,Louisiana Tech,2,9,11,0.18181818181818182
vs. FCS (I-AA),2021,Louisiana Tech,1,0,1,1.0
vs. FBS Winning,2021,Louisiana Tech,0,6,6,0.0
vs. FBS Non-Winning,2021,Louisiana Tech,2,3,5,0.4
vs. BCS AQ,2021,Louisiana Tech,0,3,3,0.0
vs. BCS non-AQ,2021,Louisiana Tech,2,6,8,0.25
vs. FBS Power 5,2021,Louisiana Tech,0,2,2,0.0
vs. FBS non-Power 5,2021,Louisiana Tech,2,7,9,0.2222222222222222
in August/September,2021,Louisiana Tech,2,2,4,0.5
in October,2021,Louisiana Tech,0,4,4,0.0
in November,2021,Louisiana Tech,1,3,4,0.25
in December/January,2021,Louisiana Tech,0,0,0,
All Games,2022,Louisiana Tech,3,9,12,0.25
at Home,2022,Louisiana Tech,3,2,5,0.6
on Road/Neutral Site,2022,Louisiana Tech,0,7,7,0.0
vs. Conference,2022,Louisiana Tech,2,6,8,0.25
vs. Non-Conference,2022,Louisiana Tech,1,3,4,0.25
vs. Ranked (AP),2022,Louisiana Tech,0,1,1,0.0
vs. Unranked (AP),2022,Louisiana Tech,3,8,11,0.2727272727272727
vs. FBS (I-A),2022,Louisiana Tech,2,9,11,0.18181818181818182
vs. FCS (I-AA),2022,Louisiana Tech,1,0,1,1.0
vs. FBS Winning,2022,Louisiana Tech,1,4,5,0.2
vs. FBS Non-Winning,2022,Louisiana Tech,1,5,6,0.16666666666666666
vs. BCS AQ,2022,Louisiana Tech,0,2,2,0.0
vs. BCS non-AQ,2022,Louisiana Tech,2,7,9,0.2222222222222222
vs. FBS Power 5,2022,Louisiana Tech,0,2,2,0.0
vs. FBS non-Power 5,2022,Louisiana Tech,2,7,9,0.2222222222222222
in August/September,2022,Louisiana Tech,1,3,4,0.25
in October,2022,Louisiana Tech,1,3,4,0.25
in November,2022,Louisiana Tech,1,3,4,0.25
in December/January,2022,Louisiana Tech,0,0,0,
All Games,2009,Louisiana-Lafayette,6,6,12,0.5
at Home,2009,Louisiana-Lafayette,4,2,6,0.6666666666666666
on Road/Neutral Site,2009,Louisiana-Lafayette,2,4,6,0.3333333333333333
vs. Conference,2009,Louisiana-Lafayette,4,4,8,0.5
vs. Non-Conference,2009,Louisiana-Lafayette,2,2,4,0.5
vs. Ranked (AP),2009,Louisiana-Lafayette,0,2,2,0.0
vs. Unranked (AP),2009,Louisiana-Lafayette,6,4,10,0.6
vs. FBS (I-A),2009,Louisiana-Lafayette,5,6,11,0.45454545454545453
vs. FCS (I-AA),2009,Louisiana-Lafayette,1,0,1,1.0
vs. FBS Winning,2009,Louisiana-Lafayette,0,4,4,0.0
vs. FBS Non-Winning,2009,Louisiana-Lafayette,5,2,7,0.7142857142857143
vs. BCS AQ,2009,Louisiana-Lafayette,1,2,3,0.3333333333333333
vs. BCS non-AQ,2009,Louisiana-Lafayette,4,4,8,0.5
vs. FBS Power 5,2009,Louisiana-Lafayette,1,2,3,0.3333333333333333
vs. FBS non-Power 5,2009,Louisiana-Lafayette,4,4,8,0.5
in August/September,2009,Louisiana-Lafayette,2,2,4,0.5
in October,2009,Louisiana-Lafayette,2,2,4,0.5
in November,2009,Louisiana-Lafayette,2,2,4,0.5
in December/January,2009,Louisiana-Lafayette,0,0,0,
All Games,2010,Louisiana-Lafayette,3,9,12,0.25
at Home,2010,Louisiana-Lafayette,1,4,5,0.2
on Road/Neutral Site,2010,Louisiana-Lafayette,2,5,7,0.2857142857142857
vs. Conference,2010,Louisiana-Lafayette,3,5,8,0.375
vs. Non-Conference,2010,Louisiana-Lafayette,0,4,4,0.0
vs. Ranked (AP),2010,Louisiana-Lafayette,0,1,1,0.0
vs. Unranked (AP),2010,Louisiana-Lafayette,3,8,11,0.2727272727272727
vs. FBS (I-A),2010,Louisiana-Lafayette,3,9,12,0.25
vs. FCS (I-AA),2010,Louisiana-Lafayette,0,0,0,
vs. FBS Winning,2010,Louisiana-Lafayette,0,4,4,0.0
vs. FBS Non-Winning,2010,Louisiana-Lafayette,3,5,8,0.375
vs. BCS AQ,2010,Louisiana-Lafayette,0,3,3,0.0
vs. BCS non-AQ,2010,Louisiana-Lafayette,3,6,9,0.3333333333333333
vs. FBS Power 5,2010,Louisiana-Lafayette,0,3,3,0.0
vs. FBS non-Power 5,2010,Louisiana-Lafayette,3,6,9,0.3333333333333333
in August/September,2010,Louisiana-Lafayette,1,2,3,0.3333333333333333
in October,2010,Louisiana-Lafayette,1,4,5,0.2
in November,2010,Louisiana-Lafayette,1,3,4,0.25
in December/January,2010,Louisiana-Lafayette,0,0,0,
All Games,2011,Louisiana-Lafayette,9,4,13,0.6923076923076923
at Home,2011,Louisiana-Lafayette,5,0,5,1.0
on Road/Neutral Site,2011,Louisiana-Lafayette,4,4,8,0.5
vs. Conference,2011,Louisiana-Lafayette,6,2,8,0.75
vs. Non-Conference,2011,Louisiana-Lafayette,3,2,5,0.6
vs. Ranked (AP),2011,Louisiana-Lafayette,0,1,1,0.0
vs. Unranked (AP),2011,Louisiana-Lafayette,9,3,12,0.75
vs. FBS (I-A),2011,Louisiana-Lafayette,8,4,12,0.6666666666666666
vs. FCS (I-AA),2011,Louisiana-Lafayette,1,0,1,1.0
vs. FBS Winning,2011,Louisiana-Lafayette,2,3,5,0.4
vs. FBS Non-Winning,2011,Louisiana-Lafayette,6,1,7,0.8571428571428571
vs. BCS AQ,2011,Louisiana-Lafayette,0,2,2,0.0
vs. BCS non-AQ,2011,Louisiana-Lafayette,8,2,10,0.8
vs. FBS Power 5,2011,Louisiana-Lafayette,0,2,2,0.0
vs. FBS non-Power 5,2011,Louisiana-Lafayette,8,2,10,0.8
in August/September,2011,Louisiana-Lafayette,3,1,4,0.75
in October,2011,Louisiana-Lafayette,4,1,5,0.8
in November,2011,Louisiana-Lafayette,1,2,3,0.3333333333333333
in December/January,2011,Louisiana-Lafayette,1,0,1,1.0
All Games,2012,Louisiana-Lafayette,9,4,13,0.6923076923076923
at Home,2012,Louisiana-Lafayette,5,1,6,0.8333333333333334
on Road/Neutral Site,2012,Louisiana-Lafayette,4,3,7,0.5714285714285714
vs. Conference,2012,Louisiana-Lafayette,6,2,8,0.75
vs. Non-Conference,2012,Louisiana-Lafayette,3,2,5,0.6
vs. Ranked (AP),2012,Louisiana-Lafayette,0,1,1,0.0
vs. Unranked (AP),2012,Louisiana-Lafayette,9,3,12,0.75
vs. FBS (I-A),2012,Louisiana-Lafayette,8,4,12,0.6666666666666666
vs. FCS (I-AA),2012,Louisiana-Lafayette,1,0,1,1.0
vs. FBS Winning,2012,Louisiana-Lafayette,3,3,6,0.5
vs. FBS Non-Winning,2012,Louisiana-Lafayette,5,1,6,0.8333333333333334
vs. BCS AQ,2012,Louisiana-Lafayette,0,2,2,0.0
vs. BCS non-AQ,2012,Louisiana-Lafayette,8,2,10,0.8
vs. FBS Power 5,2012,Louisiana-Lafayette,0,2,2,0.0
vs. FBS non-Power 5,2012,Louisiana-Lafayette,8,2,10,0.8
in August/September,2012,Louisiana-Lafayette,3,1,4,0.75
in October,2012,Louisiana-Lafayette,1,2,3,0.3333333333333333
in November,2012,Louisiana-Lafayette,3,1,4,0.75
in December/January,2012,Louisiana-Lafayette,2,0,2,1.0
All Games,2013,Louisiana-Lafayette,9,4,13,0.6923076923076923
at Home,2013,Louisiana-Lafayette,4,1,5,0.8
on Road/Neutral Site,2013,Louisiana-Lafayette,5,3,8,0.625
vs. Conference,2013,Louisiana-Lafayette,5,2,7,0.7142857142857143
vs. Non-Conference,2013,Louisiana-Lafayette,4,2,6,0.6666666666666666
vs. Ranked (AP),2013,Louisiana-Lafayette,0,0,0,
vs. Unranked (AP),2013,Louisiana-Lafayette,9,4,13,0.6923076923076923
vs. FBS (I-A),2013,Louisiana-Lafayette,8,4,12,0.6666666666666666
vs. FCS (I-AA),2013,Louisiana-Lafayette,1,0,1,1.0
vs. FBS Winning,2013,Louisiana-Lafayette,3,1,4,0.75
vs. FBS Non-Winning,2013,Louisiana-Lafayette,5,3,8,0.625
vs. BCS AQ,2013,Louisiana-Lafayette,0,2,2,0.0
vs. BCS non-AQ,2013,Louisiana-Lafayette,8,2,10,0.8
vs. FBS Power 5,2013,Louisiana-Lafayette,0,2,2,0.0
vs. FBS non-Power 5,2013,Louisiana-Lafayette,8,2,10,0.8
in August/September,2013,Louisiana-Lafayette,2,2,4,0.5
in October,2013,Louisiana-Lafayette,3,0,3,1.0
in November,2013,Louisiana-Lafayette,3,1,4,0.75
in December/January,2013,Louisiana-Lafayette,1,1,2,0.5
All Games,2014,Louisiana-Lafayette,9,4,13,0.6923076923076923
at Home,2014,Louisiana-Lafayette,4,2,6,0.6666666666666666
on Road/Neutral Site,2014,Louisiana-Lafayette,5,2,7,0.7142857142857143
vs. Conference,2014,Louisiana-Lafayette,7,1,8,0.875
vs. Non-Conference,2014,Louisiana-Lafayette,2,3,5,0.4
vs. Ranked (AP),2014,Louisiana-Lafayette,0,2,2,0.0
vs. Unranked (AP),2014,Louisiana-Lafayette,9,2,11,0.8181818181818182
vs. FBS (I-A),2014,Louisiana-Lafayette,8,4,12,0.6666666666666666
vs. FCS (I-AA),2014,Louisiana-Lafayette,1,0,1,1.0
vs. FBS Winning,2014,Louisiana-Lafayette,3,4,7,0.42857142857142855
vs. FBS Non-Winning,2014,Louisiana-Lafayette,5,0,5,1.0
vs. BCS AQ,2014,Louisiana-Lafayette,0,1,1,0.0
vs. BCS non-AQ,2014,Louisiana-Lafayette,8,3,11,0.7272727272727273
vs. FBS Power 5,2014,Louisiana-Lafayette,0,1,1,0.0
vs. FBS non-Power 5,2014,Louisiana-Lafayette,8,3,11,0.7272727272727273
in August/September,2014,Louisiana-Lafayette,1,3,4,0.25
in October,2014,Louisiana-Lafayette,3,0,3,1.0
in November,2014,Louisiana-Lafayette,4,1,5,0.8
in December/January,2014,Louisiana-Lafayette,1,0,1,1.0
All Games,2015,Louisiana-Lafayette,4,8,12,0.3333333333333333
at Home,2015,Louisiana-Lafayette,3,3,6,0.5
on Road/Neutral Site,2015,Louisiana-Lafayette,1,5,6,0.16666666666666666
vs. Conference,2015,Louisiana-Lafayette,3,5,8,0.375
vs. Non-Conference,2015,Louisiana-Lafayette,1,3,4,0.25
vs. Ranked (AP),2015,Louisiana-Lafayette,0,0,0,
vs. Unranked (AP),2015,Louisiana-Lafayette,4,8,12,0.3333333333333333
vs. FBS (I-A),2015,Louisiana-Lafayette,3,8,11,0.2727272727272727
vs. FCS (I-AA),2015,Louisiana-Lafayette,1,0,1,1.0
vs. FBS Winning,2015,Louisiana-Lafayette,0,4,4,0.0
vs. FBS Non-Winning,2015,Louisiana-Lafayette,3,4,7,0.42857142857142855
vs. BCS AQ,2015,Louisiana-Lafayette,0,1,1,0.0
vs. BCS non-AQ,2015,Louisiana-Lafayette,3,7,10,0.3
vs. FBS Power 5,2015,Louisiana-Lafayette,0,1,1,0.0
vs. FBS non-Power 5,2015,Louisiana-Lafayette,3,7,10,0.3
in August/September,2015,Louisiana-Lafayette,1,2,3,0.3333333333333333
in October,2015,Louisiana-Lafayette,2,2,4,0.5
in November,2015,Louisiana-Lafayette,1,3,4,0.25
in December/January,2015,Louisiana-Lafayette,0,1,1,0.0
All Games,2016,Louisiana-Lafayette,6,7,13,0.46153846153846156
at Home,2016,Louisiana-Lafayette,3,3,6,0.5
on Road/Neutral Site,2016,Louisiana-Lafayette,3,4,7,0.42857142857142855
vs. Conference,2016,Louisiana-Lafayette,5,3,8,0.625
vs. Non-Conference,2016,Louisiana-Lafayette,1,4,5,0.2
vs. Ranked (AP),2016,Louisiana-Lafayette,0,0,0,
vs. Unranked (AP),2016,Louisiana-Lafayette,6,7,13,0.46153846153846156
vs. FBS (I-A),2016,Louisiana-Lafayette,5,7,12,0.4166666666666667
vs. FCS (I-AA),2016,Louisiana-Lafayette,1,0,1,1.0
vs. FBS Winning,2016,Louisiana-Lafayette,1,5,6,0.16666666666666666
vs. FBS Non-Winning,2016,Louisiana-Lafayette,4,2,6,0.6666666666666666
vs. BCS AQ,2016,Louisiana-Lafayette,0,2,2,0.0
vs. BCS non-AQ,2016,Louisiana-Lafayette,5,5,10,0.5
vs. FBS Power 5,2016,Louisiana-Lafayette,0,1,1,0.0
vs. FBS non-Power 5,2016,Louisiana-Lafayette,5,6,11,0.45454545454545453
in August/September,2016,Louisiana-Lafayette,2,2,4,0.5
in October,2016,Louisiana-Lafayette,1,2,3,0.3333333333333333
in November,2016,Louisiana-Lafayette,2,2,4,0.5
in December/January,2016,Louisiana-Lafayette,1,1,2,0.5
All Games,2017,Louisiana-Lafayette,5,7,12,0.4166666666666667
at Home,2017,Louisiana-Lafayette,3,2,5,0.6
on Road/Neutral Site,2017,Louisiana-Lafayette,2,5,7,0.2857142857142857
vs. Conference,2017,Louisiana-Lafayette,4,4,8,0.5
vs. Non-Conference,2017,Louisiana-Lafayette,1,3,4,0.25
vs. Ranked (AP),2017,Louisiana-Lafayette,0,0,0,
vs. Unranked (AP),2017,Louisiana-Lafayette,5,7,12,0.4166666666666667
vs. FBS (I-A),2017,Louisiana-Lafayette,4,7,11,0.36363636363636365
vs. FCS (I-AA),2017,Louisiana-Lafayette,1,0,1,1.0
vs. FBS Winning,2017,Louisiana-Lafayette,1,3,4,0.25
vs. FBS Non-Winning,2017,Louisiana-Lafayette,3,4,7,0.42857142857142855
vs. BCS AQ,2017,Louisiana-Lafayette,0,3,3,0.0
vs. BCS non-AQ,2017,Louisiana-Lafayette,4,4,8,0.5
vs. FBS Power 5,2017,Louisiana-Lafayette,0,2,2,0.0
vs. FBS non-Power 5,2017,Louisiana-Lafayette,4,5,9,0.4444444444444444
in August/September,2017,Louisiana-Lafayette,1,3,4,0.25
in October,2017,Louisiana-Lafayette,2,1,3,0.6666666666666666
in November,2017,Louisiana-Lafayette,2,2,4,0.5
in December/January,2017,Louisiana-Lafayette,0,1,1,0.0
All Games,2018,Louisiana-Lafayette,7,7,14,0.5
at Home,2018,Louisiana-Lafayette,5,1,6,0.8333333333333334
on Road/Neutral Site,2018,Louisiana-Lafayette,2,6,8,0.25
vs. Conference,2018,Louisiana-Lafayette,5,4,9,0.5555555555555556
vs. Non-Conference,2018,Louisiana-Lafayette,2,3,5,0.4
vs. Ranked (AP),2018,Louisiana-Lafayette,0,1,1,0.0
vs. Unranked (AP),2018,Louisiana-Lafayette,7,6,13,0.5384615384615384
vs. FBS (I-A),2018,Louisiana-Lafayette,6,7,13,0.46153846153846156
vs. FCS (I-AA),2018,Louisiana-Lafayette,1,0,1,1.0
vs. FBS Winning,2018,Louisiana-Lafayette,1,6,7,0.14285714285714285
vs. FBS Non-Winning,2018,Louisiana-Lafayette,5,1,6,0.8333333333333334
vs. BCS AQ,2018,Louisiana-Lafayette,0,3,3,0.0
vs. BCS non-AQ,2018,Louisiana-Lafayette,6,4,10,0.6
vs. FBS Power 5,2018,Louisiana-Lafayette,0,2,2,0.0
vs. FBS non-Power 5,2018,Louisiana-Lafayette,6,5,11,0.5454545454545454
in August/September,2018,Louisiana-Lafayette,1,3,4,0.25
in October,2018,Louisiana-Lafayette,3,1,4,0.75
in November,2018,Louisiana-Lafayette,3,1,4,0.75
in December/January,2018,Louisiana-Lafayette,0,2,2,0.0
All Games,2019,Louisiana-Lafayette,11,3,14,0.7857142857142857
at Home,2019,Louisiana-Lafayette,5,1,6,0.8333333333333334
on Road/Neutral Site,2019,Louisiana-Lafayette,6,2,8,0.75
vs. Conference,2019,Louisiana-Lafayette,7,2,9,0.7777777777777778
vs. Non-Conference,2019,Louisiana-Lafayette,4,1,5,0.8
vs. Ranked (AP),2019,Louisiana-Lafayette,0,2,2,0.0
vs. Unranked (AP),2019,Louisiana-Lafayette,11,1,12,0.9166666666666666
vs. FBS (I-A),2019,Louisiana-Lafayette,10,3,13,0.7692307692307693
vs. FCS (I-AA),2019,Louisiana-Lafayette,1,0,1,1.0
vs. FBS Winning,2019,Louisiana-Lafayette,5,2,7,0.7142857142857143
vs. FBS Non-Winning,2019,Louisiana-Lafayette,5,1,6,0.8333333333333334
vs. BCS AQ,2019,Louisiana-Lafayette,0,1,1,0.0
vs. BCS non-AQ,2019,Louisiana-Lafayette,10,2,12,0.8333333333333334
vs. FBS Power 5,2019,Louisiana-Lafayette,0,1,1,0.0
vs. FBS non-Power 5,2019,Louisiana-Lafayette,10,2,12,0.8333333333333334
in August/September,2019,Louisiana-Lafayette,4,1,5,0.8
in October,2019,Louisiana-Lafayette,1,1,2,0.5
in November,2019,Louisiana-Lafayette,5,0,5,1.0
in December/January,2019,Louisiana-Lafayette,1,1,2,0.5
All Games,2020,Louisiana-Lafayette,10,1,11,0.9090909090909091
at Home,2020,Louisiana-Lafayette,3,1,4,0.75
on Road/Neutral Site,2020,Louisiana-Lafayette,7,0,7,1.0
vs. Conference,2020,Louisiana-Lafayette,7,1,8,0.875
vs. Non-Conference,2020,Louisiana-Lafayette,3,0,3,1.0
vs. Ranked (AP),2020,Louisiana-Lafayette,1,1,2,0.5
vs. Unranked (AP),2020,Louisiana-Lafayette,9,0,9,1.0
vs. FBS (I-A),2020,Louisiana-Lafayette,10,1,11,0.9090909090909091
vs. FCS (I-AA),2020,Louisiana-Lafayette,0,0,0,
vs. FBS Winning,2020,Louisiana-Lafayette,6,1,7,0.8571428571428571
vs. FBS Non-Winning,2020,Louisiana-Lafayette,4,0,4,1.0
vs. BCS AQ,2020,Louisiana-Lafayette,1,0,1,1.0
vs. BCS non-AQ,2020,Louisiana-Lafayette,9,1,10,0.9
vs. FBS Power 5,2020,Louisiana-Lafayette,1,0,1,1.0
vs. FBS non-Power 5,2020,Louisiana-Lafayette,9,1,10,0.9
in August/September,2020,Louisiana-Lafayette,3,0,3,1.0
in October,2020,Louisiana-Lafayette,2,1,3,0.6666666666666666
in November,2020,Louisiana-Lafayette,3,0,3,1.0
in December/January,2020,Louisiana-Lafayette,2,0,2,1.0
All Games,2021,Louisiana-Lafayette,13,1,14,0.9285714285714286
at Home,2021,Louisiana-Lafayette,7,0,7,1.0
on Road/Neutral Site,2021,Louisiana-Lafayette,6,1,7,0.8571428571428571
vs. Conference,2021,Louisiana-Lafayette,9,0,9,1.0
vs. Non-Conference,2021,Louisiana-Lafayette,4,1,5,0.8
vs. Ranked (AP),2021,Louisiana-Lafayette,0,0,0,
vs. Unranked (AP),2021,Louisiana-Lafayette,13,1,14,0.9285714285714286
vs. FBS (I-A),2021,Louisiana-Lafayette,12,1,13,0.9230769230769231
vs. FCS (I-AA),2021,Louisiana-Lafayette,1,0,1,1.0
vs. FBS Winning,2021,Louisiana-Lafayette,5,0,5,1.0
vs. FBS Non-Winning,2021,Louisiana-Lafayette,7,1,8,0.875
vs. BCS AQ,2021,Louisiana-Lafayette,0,1,1,0.0
vs. BCS non-AQ,2021,Louisiana-Lafayette,12,0,12,1.0
vs. FBS Power 5,2021,Louisiana-Lafayette,0,1,1,0.0
vs. FBS non-Power 5,2021,Louisiana-Lafayette,12,0,12,1.0
in August/September,2021,Louisiana-Lafayette,3,1,4,0.75
in October,2021,Louisiana-Lafayette,4,0,4,1.0
in November,2021,Louisiana-Lafayette,4,0,4,1.0
in December/January,2021,Louisiana-Lafayette,2,0,2,1.0
All Games,2022,Louisiana-Lafayette,6,7,13,0.46153846153846156
at Home,2022,Louisiana-Lafayette,4,2,6,0.6666666666666666
on Road/Neutral Site,2022,Louisiana-Lafayette,2,5,7,0.2857142857142857
vs. Conference,2022,Louisiana-Lafayette,4,4,8,0.5
vs. Non-Conference,2022,Louisiana-Lafayette,2,3,5,0.4
vs. Ranked (AP),2022,Louisiana-Lafayette,0,2,2,0.0
vs. Unranked (AP),2022,Louisiana-Lafayette,6,5,11,0.5454545454545454
vs. FBS (I-A),2022,Louisiana-Lafayette,5,7,12,0.4166666666666667
vs. FCS (I-AA),2022,Louisiana-Lafayette,1,0,1,1.0
vs. FBS Winning,2022,Louisiana-Lafayette,2,5,7,0.2857142857142857
vs. FBS Non-Winning,2022,Louisiana-Lafayette,3,2,5,0.6
vs. BCS AQ,2022,Louisiana-Lafayette,0,2,2,0.0
vs. BCS non-AQ,2022,Louisiana-Lafayette,5,5,10,0.5
vs. FBS Power 5,2022,Louisiana-Lafayette,0,1,1,0.0
vs. FBS non-Power 5,2022,Louisiana-Lafayette,5,6,11,0.45454545454545453
in August/September,2022,Louisiana-Lafayette,2,2,4,0.5
in October,2022,Louisiana-Lafayette,2,2,4,0.5
in November,2022,Louisiana-Lafayette,2,2,4,0.5
in December/January,2022,Louisiana-Lafayette,0,1,1,0.0
All Games,2009,Louisiana-Monroe,6,6,12,0.5
at Home,2009,Louisiana-Monroe,4,1,5,0.8
on Road/Neutral Site,2009,Louisiana-Monroe,2,5,7,0.2857142857142857
vs. Conference,2009,Louisiana-Monroe,5,3,8,0.625
vs. Non-Conference,2009,Louisiana-Monroe,1,3,4,0.25
vs. Ranked (AP),2009,Louisiana-Monroe,0,1,1,0.0
vs. Unranked (AP),2009,Louisiana-Monroe,6,5,11,0.5454545454545454
vs. FBS (I-A),2009,Louisiana-Monroe,5,6,11,0.45454545454545453
vs. FCS (I-AA),2009,Louisiana-Monroe,1,0,1,1.0
vs. FBS Winning,2009,Louisiana-Monroe,0,4,4,0.0
vs. FBS Non-Winning,2009,Louisiana-Monroe,5,2,7,0.7142857142857143
vs. BCS AQ,2009,Louisiana-Monroe,0,3,3,0.0
vs. BCS non-AQ,2009,Louisiana-Monroe,5,3,8,0.625
vs. FBS Power 5,2009,Louisiana-Monroe,0,3,3,0.0
vs. FBS non-Power 5,2009,Louisiana-Monroe,5,3,8,0.625
in August/September,2009,Louisiana-Monroe,2,2,4,0.5
in October,2009,Louisiana-Monroe,2,2,4,0.5
in November,2009,Louisiana-Monroe,2,2,4,0.5
in December/January,2009,Louisiana-Monroe,0,0,0,
All Games,2010,Louisiana-Monroe,5,7,12,0.4166666666666667
at Home,2010,Louisiana-Monroe,4,1,5,0.8
on Road/Neutral Site,2010,Louisiana-Monroe,1,6,7,0.14285714285714285
vs. Conference,2010,Louisiana-Monroe,4,4,8,0.5
vs. Non-Conference,2010,Louisiana-Monroe,1,3,4,0.25
vs. Ranked (AP),2010,Louisiana-Monroe,0,3,3,0.0
vs. Unranked (AP),2010,Louisiana-Monroe,5,4,9,0.5555555555555556
vs. FBS (I-A),2010,Louisiana-Monroe,4,7,11,0.36363636363636365
vs. FCS (I-AA),2010,Louisiana-Monroe,1,0,1,1.0
vs. FBS Winning,2010,Louisiana-Monroe,1,4,5,0.2
vs. FBS Non-Winning,2010,Louisiana-Monroe,3,3,6,0.5
vs. BCS AQ,2010,Louisiana-Monroe,0,3,3,0.0
vs. BCS non-AQ,2010,Louisiana-Monroe,4,4,8,0.5
vs. FBS Power 5,2010,Louisiana-Monroe,0,3,3,0.0
vs. FBS non-Power 5,2010,Louisiana-Monroe,4,4,8,0.5
in August/September,2010,Louisiana-Monroe,1,2,3,0.3333333333333333
in October,2010,Louisiana-Monroe,3,2,5,0.6
in November,2010,Louisiana-Monroe,1,3,4,0.25
in December/January,2010,Louisiana-Monroe,0,0,0,
All Games,2011,Louisiana-Monroe,4,8,12,0.3333333333333333
at Home,2011,Louisiana-Monroe,2,3,5,0.4
on Road/Neutral Site,2011,Louisiana-Monroe,2,5,7,0.2857142857142857
vs. Conference,2011,Louisiana-Monroe,3,5,8,0.375
vs. Non-Conference,2011,Louisiana-Monroe,1,3,4,0.25
vs. Ranked (AP),2011,Louisiana-Monroe,0,2,2,0.0
vs. Unranked (AP),2011,Louisiana-Monroe,4,6,10,0.4
vs. FBS (I-A),2011,Louisiana-Monroe,3,8,11,0.2727272727272727
vs. FCS (I-AA),2011,Louisiana-Monroe,1,0,1,1.0
vs. FBS Winning,2011,Louisiana-Monroe,0,7,7,0.0
vs. FBS Non-Winning,2011,Louisiana-Monroe,3,1,4,0.75
vs. BCS AQ,2011,Louisiana-Monroe,0,2,2,0.0
vs. BCS non-AQ,2011,Louisiana-Monroe,3,6,9,0.3333333333333333
vs. FBS Power 5,2011,Louisiana-Monroe,0,2,2,0.0
vs. FBS non-Power 5,2011,Louisiana-Monroe,3,6,9,0.3333333333333333
in August/September,2011,Louisiana-Monroe,1,3,4,0.25
in October,2011,Louisiana-Monroe,1,3,4,0.25
in November,2011,Louisiana-Monroe,1,2,3,0.3333333333333333
in December/January,2011,Louisiana-Monroe,1,0,1,1.0
All Games,2012,Louisiana-Monroe,8,5,13,0.6153846153846154
at Home,2012,Louisiana-Monroe,3,2,5,0.6
on Road/Neutral Site,2012,Louisiana-Monroe,5,3,8,0.625
vs. Conference,2012,Louisiana-Monroe,6,2,8,0.75
vs. Non-Conference,2012,Louisiana-Monroe,2,3,5,0.4
vs. Ranked (AP),2012,Louisiana-Monroe,0,0,0,
vs. Unranked (AP),2012,Louisiana-Monroe,8,5,13,0.6153846153846154
vs. FBS (I-A),2012,Louisiana-Monroe,8,5,13,0.6153846153846154
vs. FCS (I-AA),2012,Louisiana-Monroe,0,0,0,
vs. FBS Winning,2012,Louisiana-Monroe,2,4,6,0.3333333333333333
vs. FBS Non-Winning,2012,Louisiana-Monroe,6,1,7,0.8571428571428571
vs. BCS AQ,2012,Louisiana-Monroe,1,2,3,0.3333333333333333
vs. BCS non-AQ,2012,Louisiana-Monroe,7,3,10,0.7
vs. FBS Power 5,2012,Louisiana-Monroe,1,2,3,0.3333333333333333
vs. FBS non-Power 5,2012,Louisiana-Monroe,7,3,10,0.7
in August/September,2012,Louisiana-Monroe,2,2,4,0.5
in October,2012,Louisiana-Monroe,4,0,4,1.0
in November,2012,Louisiana-Monroe,2,2,4,0.5
in December/January,2012,Louisiana-Monroe,0,1,1,0.0
All Games,2013,Louisiana-Monroe,6,6,12,0.5
at Home,2013,Louisiana-Monroe,2,3,5,0.4
on Road/Neutral Site,2013,Louisiana-Monroe,4,3,7,0.5714285714285714
vs. Conference,2013,Louisiana-Monroe,4,3,7,0.5714285714285714
vs. Non-Conference,2013,Louisiana-Monroe,2,3,5,0.4
vs. Ranked (AP),2013,Louisiana-Monroe,0,2,2,0.0
vs. Unranked (AP),2013,Louisiana-Monroe,6,4,10,0.6
vs. FBS (I-A),2013,Louisiana-Monroe,5,6,11,0.45454545454545453
vs. FCS (I-AA),2013,Louisiana-Monroe,1,0,1,1.0
vs. FBS Winning,2013,Louisiana-Monroe,1,5,6,0.16666666666666666
vs. FBS Non-Winning,2013,Louisiana-Monroe,4,1,5,0.8
vs. BCS AQ,2013,Louisiana-Monroe,1,2,3,0.3333333333333333
vs. BCS non-AQ,2013,Louisiana-Monroe,4,4,8,0.5
vs. FBS Power 5,2013,Louisiana-Monroe,1,2,3,0.3333333333333333
vs. FBS non-Power 5,2013,Louisiana-Monroe,4,4,8,0.5
in August/September,2013,Louisiana-Monroe,2,3,5,0.4
in October,2013,Louisiana-Monroe,3,1,4,0.75
in November,2013,Louisiana-Monroe,1,2,3,0.3333333333333333
in December/January,2013,Louisiana-Monroe,0,0,0,
All Games,2014,Louisiana-Monroe,4,8,12,0.3333333333333333
at Home,2014,Louisiana-Monroe,3,2,5,0.6
on Road/Neutral Site,2014,Louisiana-Monroe,1,6,7,0.14285714285714285
vs. Conference,2014,Louisiana-Monroe,3,5,8,0.375
vs. Non-Conference,2014,Louisiana-Monroe,1,3,4,0.25
vs. Ranked (AP),2014,Louisiana-Monroe,0,0,0,
vs. Unranked (AP),2014,Louisiana-Monroe,4,8,12,0.3333333333333333
vs. FBS (I-A),2014,Louisiana-Monroe,4,8,12,0.3333333333333333
vs. FCS (I-AA),2014,Louisiana-Monroe,0,0,0,
vs. FBS Winning,2014,Louisiana-Monroe,0,7,7,0.0
vs. FBS Non-Winning,2014,Louisiana-Monroe,4,1,5,0.8
vs. BCS AQ,2014,Louisiana-Monroe,1,3,4,0.25
vs. BCS non-AQ,2014,Louisiana-Monroe,3,5,8,0.375
vs. FBS Power 5,2014,Louisiana-Monroe,1,3,4,0.25
vs. FBS non-Power 5,2014,Louisiana-Monroe,3,5,8,0.375
in August/September,2014,Louisiana-Monroe,3,1,4,0.75
in October,2014,Louisiana-Monroe,0,3,3,0.0
in November,2014,Louisiana-Monroe,1,4,5,0.2
in December/January,2014,Louisiana-Monroe,0,0,0,
All Games,2015,Louisiana-Monroe,2,11,13,0.15384615384615385
at Home,2015,Louisiana-Monroe,2,3,5,0.4
on Road/Neutral Site,2015,Louisiana-Monroe,0,8,8,0.0
vs. Conference,2015,Louisiana-Monroe,1,7,8,0.125
vs. Non-Conference,2015,Louisiana-Monroe,1,4,5,0.2
vs. Ranked (AP),2015,Louisiana-Monroe,0,1,1,0.0
vs. Unranked (AP),2015,Louisiana-Monroe,2,10,12,0.16666666666666666
vs. FBS (I-A),2015,Louisiana-Monroe,1,11,12,0.08333333333333333
vs. FCS (I-AA),2015,Louisiana-Monroe,1,0,1,1.0
vs. FBS Winning,2015,Louisiana-Monroe,0,5,5,0.0
vs. FBS Non-Winning,2015,Louisiana-Monroe,1,6,7,0.14285714285714285
vs. BCS AQ,2015,Louisiana-Monroe,0,3,3,0.0
vs. BCS non-AQ,2015,Louisiana-Monroe,1,8,9,0.1111111111111111
vs. FBS Power 5,2015,Louisiana-Monroe,0,2,2,0.0
vs. FBS non-Power 5,2015,Louisiana-Monroe,1,9,10,0.1
in August/September,2015,Louisiana-Monroe,1,2,3,0.3333333333333333
in October,2015,Louisiana-Monroe,0,5,5,0.0
in November,2015,Louisiana-Monroe,0,4,4,0.0
in December/January,2015,Louisiana-Monroe,1,0,1,1.0
All Games,2016,Louisiana-Monroe,4,8,12,0.3333333333333333
at Home,2016,Louisiana-Monroe,3,2,5,0.6
on Road/Neutral Site,2016,Louisiana-Monroe,1,6,7,0.14285714285714285
vs. Conference,2016,Louisiana-Monroe,3,5,8,0.375
vs. Non-Conference,2016,Louisiana-Monroe,1,3,4,0.25
vs. Ranked (AP),2016,Louisiana-Monroe,0,2,2,0.0
vs. Unranked (AP),2016,Louisiana-Monroe,4,6,10,0.4
vs. FBS (I-A),2016,Louisiana-Monroe,3,8,11,0.2727272727272727
vs. FCS (I-AA),2016,Louisiana-Monroe,1,0,1,1.0
vs. FBS Winning,2016,Louisiana-Monroe,0,6,6,0.0
vs. FBS Non-Winning,2016,Louisiana-Monroe,3,2,5,0.6
vs. BCS AQ,2016,Louisiana-Monroe,0,2,2,0.0
vs. BCS non-AQ,2016,Louisiana-Monroe,3,6,9,0.3333333333333333
vs. FBS Power 5,2016,Louisiana-Monroe,0,2,2,0.0
vs. FBS non-Power 5,2016,Louisiana-Monroe,3,6,9,0.3333333333333333
in August/September,2016,Louisiana-Monroe,1,2,3,0.3333333333333333
in October,2016,Louisiana-Monroe,1,4,5,0.2
in November,2016,Louisiana-Monroe,2,1,3,0.6666666666666666
in December/January,2016,Louisiana-Monroe,0,1,1,0.0
All Games,2017,Louisiana-Monroe,4,8,12,0.3333333333333333
at Home,2017,Louisiana-Monroe,2,3,5,0.4
on Road/Neutral Site,2017,Louisiana-Monroe,2,5,7,0.2857142857142857
vs. Conference,2017,Louisiana-Monroe,4,4,8,0.5
vs. Non-Conference,2017,Louisiana-Monroe,0,4,4,0.0
vs. Ranked (AP),2017,Louisiana-Monroe,0,2,2,0.0
vs. Unranked (AP),2017,Louisiana-Monroe,4,6,10,0.4
vs. FBS (I-A),2017,Louisiana-Monroe,4,8,12,0.3333333333333333
vs. FCS (I-AA),2017,Louisiana-Monroe,0,0,0,
vs. FBS Winning,2017,Louisiana-Monroe,1,6,7,0.14285714285714285
vs. FBS Non-Winning,2017,Louisiana-Monroe,3,2,5,0.6
vs. BCS AQ,2017,Louisiana-Monroe,0,3,3,0.0
vs. BCS non-AQ,2017,Louisiana-Monroe,4,5,9,0.4444444444444444
vs. FBS Power 5,2017,Louisiana-Monroe,0,2,2,0.0
vs. FBS non-Power 5,2017,Louisiana-Monroe,4,6,10,0.4
in August/September,2017,Louisiana-Monroe,2,2,4,0.5
in October,2017,Louisiana-Monroe,1,3,4,0.25
in November,2017,Louisiana-Monroe,1,2,3,0.3333333333333333
in December/January,2017,Louisiana-Monroe,0,1,1,0.0
All Games,2018,Louisiana-Monroe,6,6,12,0.5
at Home,2018,Louisiana-Monroe,3,2,5,0.6
on Road/Neutral Site,2018,Louisiana-Monroe,3,4,7,0.42857142857142855
vs. Conference,2018,Louisiana-Monroe,4,4,8,0.5
vs. Non-Conference,2018,Louisiana-Monroe,2,2,4,0.5
vs. Ranked (AP),2018,Louisiana-Monroe,0,1,1,0.0
vs. Unranked (AP),2018,Louisiana-Monroe,6,5,11,0.5454545454545454
vs. FBS (I-A),2018,Louisiana-Monroe,5,6,11,0.45454545454545453
vs. FCS (I-AA),2018,Louisiana-Monroe,1,0,1,1.0
vs. FBS Winning,2018,Louisiana-Monroe,2,3,5,0.4
vs. FBS Non-Winning,2018,Louisiana-Monroe,3,3,6,0.5
vs. BCS AQ,2018,Louisiana-Monroe,0,2,2,0.0
vs. BCS non-AQ,2018,Louisiana-Monroe,5,4,9,0.5555555555555556
vs. FBS Power 5,2018,Louisiana-Monroe,0,2,2,0.0
vs. FBS non-Power 5,2018,Louisiana-Monroe,5,4,9,0.5555555555555556
in August/September,2018,Louisiana-Monroe,2,3,5,0.4
in October,2018,Louisiana-Monroe,2,1,3,0.6666666666666666
in November,2018,Louisiana-Monroe,2,2,4,0.5
in December/January,2018,Louisiana-Monroe,0,0,0,
All Games,2019,Louisiana-Monroe,5,7,12,0.4166666666666667
at Home,2019,Louisiana-Monroe,4,2,6,0.6666666666666666
on Road/Neutral Site,2019,Louisiana-Monroe,1,5,6,0.16666666666666666
vs. Conference,2019,Louisiana-Monroe,4,4,8,0.5
vs. Non-Conference,2019,Louisiana-Monroe,1,3,4,0.25
vs. Ranked (AP),2019,Louisiana-Monroe,0,2,2,0.0
vs. Unranked (AP),2019,Louisiana-Monroe,5,5,10,0.5
vs. FBS (I-A),2019,Louisiana-Monroe,4,7,11,0.36363636363636365
vs. FCS (I-AA),2019,Louisiana-Monroe,1,0,1,1.0
vs. FBS Winning,2019,Louisiana-Monroe,1,6,7,0.14285714285714285
vs. FBS Non-Winning,2019,Louisiana-Monroe,3,1,4,0.75
vs. BCS AQ,2019,Louisiana-Monroe,0,3,3,0.0
vs. BCS non-AQ,2019,Louisiana-Monroe,4,4,8,0.5
vs. FBS Power 5,2019,Louisiana-Monroe,0,2,2,0.0
vs. FBS non-Power 5,2019,Louisiana-Monroe,4,5,9,0.4444444444444444
in August/September,2019,Louisiana-Monroe,2,2,4,0.5
in October,2019,Louisiana-Monroe,1,2,3,0.3333333333333333
in November,2019,Louisiana-Monroe,2,3,5,0.4
in December/January,2019,Louisiana-Monroe,0,0,0,
All Games,2020,Louisiana-Monroe,0,10,10,0.0
at Home,2020,Louisiana-Monroe,0,5,5,0.0
on Road/Neutral Site,2020,Louisiana-Monroe,0,5,5,0.0
vs. Conference,2020,Louisiana-Monroe,0,7,7,0.0
vs. Non-Conference,2020,Louisiana-Monroe,0,3,3,0.0
vs. Ranked (AP),2020,Louisiana-Monroe,0,2,2,0.0
vs. Unranked (AP),2020,Louisiana-Monroe,0,8,8,0.0
vs. FBS (I-A),2020,Louisiana-Monroe,0,10,10,0.0
vs. FCS (I-AA),2020,Louisiana-Monroe,0,0,0,
vs. FBS Winning,2020,Louisiana-Monroe,0,6,6,0.0
vs. FBS Non-Winning,2020,Louisiana-Monroe,0,4,4,0.0
vs. BCS AQ,2020,Louisiana-Monroe,0,0,0,
vs. BCS non-AQ,2020,Louisiana-Monroe,0,10,10,0.0
vs. FBS Power 5,2020,Louisiana-Monroe,0,0,0,
vs. FBS non-Power 5,2020,Louisiana-Monroe,0,10,10,0.0
in August/September,2020,Louisiana-Monroe,0,3,3,0.0
in October,2020,Louisiana-Monroe,0,4,4,0.0
in November,2020,Louisiana-Monroe,0,2,2,0.0
in December/January,2020,Louisiana-Monroe,0,1,1,0.0
All Games,2021,Louisiana-Monroe,4,8,12,0.3333333333333333
at Home,2021,Louisiana-Monroe,4,2,6,0.6666666666666666
on Road/Neutral Site,2021,Louisiana-Monroe,0,6,6,0.0
vs. Conference,2021,Louisiana-Monroe,2,6,8,0.25
vs. Non-Conference,2021,Louisiana-Monroe,2,2,4,0.5
vs. Ranked (AP),2021,Louisiana-Monroe,0,2,2,0.0
vs. Unranked (AP),2021,Louisiana-Monroe,4,6,10,0.4
vs. FBS (I-A),2021,Louisiana-Monroe,3,8,11,0.2727272727272727
vs. FCS (I-AA),2021,Louisiana-Monroe,1,0,1,1.0
vs. FBS Winning,2021,Louisiana-Monroe,1,5,6,0.16666666666666666
vs. FBS Non-Winning,2021,Louisiana-Monroe,2,3,5,0.4
vs. BCS AQ,2021,Louisiana-Monroe,0,2,2,0.0
vs. BCS non-AQ,2021,Louisiana-Monroe,3,6,9,0.3333333333333333
vs. FBS Power 5,2021,Louisiana-Monroe,0,2,2,0.0
vs. FBS non-Power 5,2021,Louisiana-Monroe,3,6,9,0.3333333333333333
in August/September,2021,Louisiana-Monroe,2,1,3,0.6666666666666666
in October,2021,Louisiana-Monroe,2,3,5,0.4
in November,2021,Louisiana-Monroe,0,4,4,0.0
in December/January,2021,Louisiana-Monroe,0,0,0,
All Games,2022,Louisiana-Monroe,4,8,12,0.3333333333333333
at Home,2022,Louisiana-Monroe,3,2,5,0.6
on Road/Neutral Site,2022,Louisiana-Monroe,1,6,7,0.14285714285714285
vs. Conference,2022,Louisiana-Monroe,3,5,8,0.375
vs. Non-Conference,2022,Louisiana-Monroe,1,3,4,0.25
vs. Ranked (AP),2022,Louisiana-Monroe,0,3,3,0.0
vs. Unranked (AP),2022,Louisiana-Monroe,4,5,9,0.4444444444444444
vs. FBS (I-A),2022,Louisiana-Monroe,3,8,11,0.2727272727272727
vs. FCS (I-AA),2022,Louisiana-Monroe,1,0,1,1.0
vs. FBS Winning,2022,Louisiana-Monroe,0,6,6,0.0
vs. FBS Non-Winning,2022,Louisiana-Monroe,3,2,5,0.6
vs. BCS AQ,2022,Louisiana-Monroe,0,2,2,0.0
vs. BCS non-AQ,2022,Louisiana-Monroe,3,6,9,0.3333333333333333
vs. FBS Power 5,2022,Louisiana-Monroe,0,2,2,0.0
vs. FBS non-Power 5,2022,Louisiana-Monroe,3,6,9,0.3333333333333333
in August/September,2022,Louisiana-Monroe,2,2,4,0.5
in October,2022,Louisiana-Monroe,0,4,4,0.0
in November,2022,Louisiana-Monroe,2,2,4,0.5
in December/January,2022,Louisiana-Monroe,0,0,0,
All Games,2009,Louisville,4,8,12,0.3333333333333333
at Home,2009,Louisville,4,2,6,0.6666666666666666
on Road/Neutral Site,2009,Louisville,0,6,6,0.0
vs. Conference,2009,Louisville,1,6,7,0.14285714285714285
vs. Non-Conference,2009,Louisville,3,2,5,0.6
vs. Ranked (AP),2009,Louisville,0,4,4,0.0
vs. Unranked (AP),2009,Louisville,4,4,8,0.5
vs. FBS (I-A),2009,Louisville,3,8,11,0.2727272727272727
vs. FCS (I-AA),2009,Louisville,1,0,1,1.0
vs. FBS Winning,2009,Louisville,1,8,9,0.1111111111111111
vs. FBS Non-Winning,2009,Louisville,2,0,2,1.0
vs. BCS AQ,2009,Louisville,1,7,8,0.125
vs. BCS non-AQ,2009,Louisville,2,1,3,0.6666666666666666
vs. FBS Power 5,2009,Louisville,0,1,1,0.0
vs. FBS non-Power 5,2009,Louisville,3,7,10,0.3
in August/September,2009,Louisville,1,2,3,0.3333333333333333
in October,2009,Louisville,2,3,5,0.4
in November,2009,Louisville,1,3,4,0.25
in December/January,2009,Louisville,0,0,0,
All Games,2010,Louisville,7,6,13,0.5384615384615384
at Home,2010,Louisville,3,4,7,0.42857142857142855
on Road/Neutral Site,2010,Louisville,4,2,6,0.6666666666666666
vs. Conference,2010,Louisville,3,4,7,0.42857142857142855
vs. Non-Conference,2010,Louisville,4,2,6,0.6666666666666666
vs. Ranked (AP),2010,Louisville,0,0,0,
vs. Unranked (AP),2010,Louisville,7,6,13,0.5384615384615384
vs. FBS (I-A),2010,Louisville,6,6,12,0.5
vs. FCS (I-AA),2010,Louisville,1,0,1,1.0
vs. FBS Winning,2010,Louisville,3,3,6,0.5
vs. FBS Non-Winning,2010,Louisville,3,3,6,0.5
vs. BCS AQ,2010,Louisville,3,6,9,0.3333333333333333
vs. BCS non-AQ,2010,Louisville,3,0,3,1.0
vs. FBS Power 5,2010,Louisville,0,2,2,0.0
vs. FBS non-Power 5,2010,Louisville,6,4,10,0.6
in August/September,2010,Louisville,1,2,3,0.3333333333333333
in October,2010,Louisville,3,2,5,0.6
in November,2010,Louisville,2,2,4,0.5
in December/January,2010,Louisville,1,0,1,1.0
All Games,2011,Louisville,7,6,13,0.5384615384615384
at Home,2011,Louisville,3,3,6,0.5
on Road/Neutral Site,2011,Louisville,4,3,7,0.5714285714285714
vs. Conference,2011,Louisville,5,2,7,0.7142857142857143
vs. Non-Conference,2011,Louisville,2,4,6,0.3333333333333333
vs. Ranked (AP),2011,Louisville,1,1,2,0.5
vs. Unranked (AP),2011,Louisville,6,5,11,0.5454545454545454
vs. FBS (I-A),2011,Louisville,6,6,12,0.5
vs. FCS (I-AA),2011,Louisville,1,0,1,1.0
vs. FBS Winning,2011,Louisville,2,5,7,0.2857142857142857
vs. FBS Non-Winning,2011,Louisville,4,1,5,0.8
vs. BCS AQ,2011,Louisville,6,4,10,0.6
vs. BCS non-AQ,2011,Louisville,0,2,2,0.0
vs. FBS Power 5,2011,Louisville,1,2,3,0.3333333333333333
vs. FBS non-Power 5,2011,Louisville,5,4,9,0.5555555555555556
in August/September,2011,Louisville,2,1,3,0.6666666666666666
in October,2011,Louisville,2,3,5,0.4
in November,2011,Louisville,3,1,4,0.75
in December/January,2011,Louisville,0,1,1,0.0
All Games,2012,Louisville,11,2,13,0.8461538461538461
at Home,2012,Louisville,6,1,7,0.8571428571428571
on Road/Neutral Site,2012,Louisville,5,1,6,0.8333333333333334
vs. Conference,2012,Louisville,5,2,7,0.7142857142857143
vs. Non-Conference,2012,Louisville,6,0,6,1.0
vs. Ranked (AP),2012,Louisville,1,0,1,1.0
vs. Unranked (AP),2012,Louisville,10,2,12,0.8333333333333334
vs. FBS (I-A),2012,Louisville,10,2,12,0.8333333333333334
vs. FCS (I-AA),2012,Louisville,1,0,1,1.0
vs. FBS Winning,2012,Louisville,4,1,5,0.8
vs. FBS Non-Winning,2012,Louisville,6,1,7,0.8571428571428571
vs. BCS AQ,2012,Louisville,8,2,10,0.8
vs. BCS non-AQ,2012,Louisville,2,0,2,1.0
vs. FBS Power 5,2012,Louisville,3,0,3,1.0
vs. FBS non-Power 5,2012,Louisville,7,2,9,0.7777777777777778
in August/September,2012,Louisville,5,0,5,1.0
in October,2012,Louisville,3,0,3,1.0
in November,2012,Louisville,2,2,4,0.5
in December/January,2012,Louisville,1,0,1,1.0
All Games,2013,Louisville,12,1,13,0.9230769230769231
at Home,2013,Louisville,6,1,7,0.8571428571428571
on Road/Neutral Site,2013,Louisville,6,0,6,1.0
vs. Conference,2013,Louisville,7,1,8,0.875
vs. Non-Conference,2013,Louisville,5,0,5,1.0
vs. Ranked (AP),2013,Louisville,0,1,1,0.0
vs. Unranked (AP),2013,Louisville,12,0,12,1.0
vs. FBS (I-A),2013,Louisville,11,1,12,0.9166666666666666
vs. FCS (I-AA),2013,Louisville,1,0,1,1.0
vs. FBS Winning,2013,Louisville,4,1,5,0.8
vs. FBS Non-Winning,2013,Louisville,7,0,7,1.0
vs. BCS AQ,2013,Louisville,9,1,10,0.9
vs. BCS non-AQ,2013,Louisville,2,0,2,1.0
vs. FBS Power 5,2013,Louisville,2,0,2,1.0
vs. FBS non-Power 5,2013,Louisville,9,1,10,0.9
in August/September,2013,Louisville,4,0,4,1.0
in October,2013,Louisville,3,1,4,0.75
in November,2013,Louisville,3,0,3,1.0
in December/January,2013,Louisville,2,0,2,1.0
All Games,2014,Louisville,9,4,13,0.6923076923076923
at Home,2014,Louisville,5,1,6,0.8333333333333334
on Road/Neutral Site,2014,Louisville,4,3,7,0.5714285714285714
vs. Conference,2014,Louisville,5,3,8,0.625
vs. Non-Conference,2014,Louisville,4,1,5,0.8
vs. Ranked (AP),2014,Louisville,0,3,3,0.0
vs. Unranked (AP),2014,Louisville,9,1,10,0.9
vs. FBS (I-A),2014,Louisville,8,4,12,0.6666666666666666
vs. FCS (I-AA),2014,Louisville,1,0,1,1.0
vs. FBS Winning,2014,Louisville,3,3,6,0.5
vs. FBS Non-Winning,2014,Louisville,5,1,6,0.8333333333333334
vs. BCS AQ,2014,Louisville,7,4,11,0.6363636363636364
vs. BCS non-AQ,2014,Louisville,1,0,1,1.0
vs. FBS Power 5,2014,Louisville,6,4,10,0.6
vs. FBS non-Power 5,2014,Louisville,2,0,2,1.0
in August/September,2014,Louisville,4,1,5,0.8
in October,2014,Louisville,2,2,4,0.5
in November,2014,Louisville,3,0,3,1.0
in December/January,2014,Louisville,0,1,1,0.0
All Games,2015,Louisville,8,5,13,0.6153846153846154
at Home,2015,Louisville,4,2,6,0.6666666666666666
on Road/Neutral Site,2015,Louisville,4,3,7,0.5714285714285714
vs. Conference,2015,Louisville,5,3,8,0.625
vs. Non-Conference,2015,Louisville,3,2,5,0.6
vs. Ranked (AP),2015,Louisville,0,3,3,0.0
vs. Unranked (AP),2015,Louisville,8,2,10,0.8
vs. FBS (I-A),2015,Louisville,7,5,12,0.5833333333333334
vs. FCS (I-AA),2015,Louisville,1,0,1,1.0
vs. FBS Winning,2015,Louisville,2,5,7,0.2857142857142857
vs. FBS Non-Winning,2015,Louisville,5,0,5,1.0
vs. BCS AQ,2015,Louisville,7,5,12,0.5833333333333334
vs. BCS non-AQ,2015,Louisville,0,0,0,
vs. FBS Power 5,2015,Louisville,7,4,11,0.6363636363636364
vs. FBS non-Power 5,2015,Louisville,0,1,1,0.0
in August/September,2015,Louisville,1,3,4,0.25
in October,2015,Louisville,3,1,4,0.75
in November,2015,Louisville,3,1,4,0.75
in December/January,2015,Louisville,1,0,1,1.0
All Games,2016,Louisville,9,4,13,0.6923076923076923
at Home,2016,Louisville,5,1,6,0.8333333333333334
on Road/Neutral Site,2016,Louisville,4,3,7,0.5714285714285714
vs. Conference,2016,Louisville,7,1,8,0.875
vs. Non-Conference,2016,Louisville,2,3,5,0.4
vs. Ranked (AP),2016,Louisville,1,2,3,0.3333333333333333
vs. Unranked (AP),2016,Louisville,8,2,10,0.8
vs. FBS (I-A),2016,Louisville,9,4,13,0.6923076923076923
vs. FCS (I-AA),2016,Louisville,0,0,0,
vs. FBS Winning,2016,Louisville,4,4,8,0.5
vs. FBS Non-Winning,2016,Louisville,5,0,5,1.0
vs. BCS AQ,2016,Louisville,7,4,11,0.6363636363636364
vs. BCS non-AQ,2016,Louisville,2,0,2,1.0
vs. FBS Power 5,2016,Louisville,7,3,10,0.7
vs. FBS non-Power 5,2016,Louisville,2,1,3,0.6666666666666666
in August/September,2016,Louisville,4,0,4,1.0
in October,2016,Louisville,3,1,4,0.75
in November,2016,Louisville,2,2,4,0.5
in December/January,2016,Louisville,0,1,1,0.0
All Games,2017,Louisville,8,5,13,0.6153846153846154
at Home,2017,Louisville,4,2,6,0.6666666666666666
on Road/Neutral Site,2017,Louisville,4,3,7,0.5714285714285714
vs. Conference,2017,Louisville,4,4,8,0.5
vs. Non-Conference,2017,Louisville,4,1,5,0.8
vs. Ranked (AP),2017,Louisville,0,3,3,0.0
vs. Unranked (AP),2017,Louisville,8,2,10,0.8
vs. FBS (I-A),2017,Louisville,7,5,12,0.5833333333333334
vs. FCS (I-AA),2017,Louisville,1,0,1,1.0
vs. FBS Winning,2017,Louisville,3,5,8,0.375
vs. FBS Non-Winning,2017,Louisville,4,0,4,1.0
vs. BCS AQ,2017,Louisville,6,5,11,0.5454545454545454
vs. BCS non-AQ,2017,Louisville,1,0,1,1.0
vs. FBS Power 5,2017,Louisville,6,5,11,0.5454545454545454
vs. FBS non-Power 5,2017,Louisville,1,0,1,1.0
in August/September,2017,Louisville,4,1,5,0.8
in October,2017,Louisville,1,3,4,0.25
in November,2017,Louisville,3,0,3,1.0
in December/January,2017,Louisville,0,1,1,0.0
All Games,2018,Louisville,2,10,12,0.16666666666666666
at Home,2018,Louisville,2,5,7,0.2857142857142857
on Road/Neutral Site,2018,Louisville,0,5,5,0.0
vs. Conference,2018,Louisville,0,8,8,0.0
vs. Non-Conference,2018,Louisville,2,2,4,0.5
vs. Ranked (AP),2018,Louisville,0,4,4,0.0
vs. Unranked (AP),2018,Louisville,2,6,8,0.25
vs. FBS (I-A),2018,Louisville,1,10,11,0.09090909090909091
vs. FCS (I-AA),2018,Louisville,1,0,1,1.0
vs. FBS Winning,2018,Louisville,0,9,9,0.0
vs. FBS Non-Winning,2018,Louisville,1,1,2,0.5
vs. BCS AQ,2018,Louisville,0,10,10,0.0
vs. BCS non-AQ,2018,Louisville,1,0,1,1.0
vs. FBS Power 5,2018,Louisville,0,10,10,0.0
vs. FBS non-Power 5,2018,Louisville,1,0,1,1.0
in August/September,2018,Louisville,2,3,5,0.4
in October,2018,Louisville,0,3,3,0.0
in November,2018,Louisville,0,4,4,0.0
in December/January,2018,Louisville,0,0,0,
All Games,2019,Louisville,8,5,13,0.6153846153846154
at Home,2019,Louisville,4,2,6,0.6666666666666666
on Road/Neutral Site,2019,Louisville,4,3,7,0.5714285714285714
vs. Conference,2019,Louisville,5,3,8,0.625
vs. Non-Conference,2019,Louisville,3,2,5,0.6
vs. Ranked (AP),2019,Louisville,0,2,2,0.0
vs. Unranked (AP),2019,Louisville,8,3,11,0.7272727272727273
vs. FBS (I-A),2019,Louisville,7,5,12,0.5833333333333334
vs. FCS (I-AA),2019,Louisville,1,0,1,1.0
vs. FBS Winning,2019,Louisville,3,3,6,0.5
vs. FBS Non-Winning,2019,Louisville,4,2,6,0.6666666666666666
vs. BCS AQ,2019,Louisville,6,5,11,0.5454545454545454
vs. BCS non-AQ,2019,Louisville,1,0,1,1.0
vs. FBS Power 5,2019,Louisville,6,4,10,0.6
vs. FBS non-Power 5,2019,Louisville,1,1,2,0.5
in August/September,2019,Louisville,2,2,4,0.5
in October,2019,Louisville,3,1,4,0.75
in November,2019,Louisville,2,2,4,0.5
in December/January,2019,Louisville,1,0,1,1.0
All Games,2020,Louisville,4,7,11,0.36363636363636365
at Home,2020,Louisville,4,2,6,0.6666666666666666
on Road/Neutral Site,2020,Louisville,0,5,5,0.0
vs. Conference,2020,Louisville,3,7,10,0.3
vs. Non-Conference,2020,Louisville,1,0,1,1.0
vs. Ranked (AP),2020,Louisville,0,2,2,0.0
vs. Unranked (AP),2020,Louisville,4,5,9,0.4444444444444444
vs. FBS (I-A),2020,Louisville,4,7,11,0.36363636363636365
vs. FCS (I-AA),2020,Louisville,0,0,0,
vs. FBS Winning,2020,Louisville,0,4,4,0.0
vs. FBS Non-Winning,2020,Louisville,4,3,7,0.5714285714285714
vs. BCS AQ,2020,Louisville,3,7,10,0.3
vs. BCS non-AQ,2020,Louisville,1,0,1,1.0
vs. FBS Power 5,2020,Louisville,3,7,10,0.3
vs. FBS non-Power 5,2020,Louisville,1,0,1,1.0
in August/September,2020,Louisville,1,2,3,0.3333333333333333
in October,2020,Louisville,1,3,4,0.25
in November,2020,Louisville,1,2,3,0.3333333333333333
in December/January,2020,Louisville,1,0,1,1.0
All Games,2021,Louisville,6,7,13,0.46153846153846156
at Home,2021,Louisville,4,3,7,0.5714285714285714
on Road/Neutral Site,2021,Louisville,2,4,6,0.3333333333333333
vs. Conference,2021,Louisville,4,4,8,0.5
vs. Non-Conference,2021,Louisville,2,3,5,0.4
vs. Ranked (AP),2021,Louisville,0,5,5,0.0
vs. Unranked (AP),2021,Louisville,6,2,8,0.75
vs. FBS (I-A),2021,Louisville,5,7,12,0.4166666666666667
vs. FCS (I-AA),2021,Louisville,1,0,1,1.0
vs. FBS Winning,2021,Louisville,1,6,7,0.14285714285714285
vs. FBS Non-Winning,2021,Louisville,4,1,5,0.8
vs. BCS AQ,2021,Louisville,5,6,11,0.45454545454545453
vs. BCS non-AQ,2021,Louisville,0,1,1,0.0
vs. FBS Power 5,2021,Louisville,4,6,10,0.4
vs. FBS non-Power 5,2021,Louisville,1,1,2,0.5
in August/September,2021,Louisville,3,1,4,0.75
in October,2021,Louisville,1,3,4,0.25
in November,2021,Louisville,2,2,4,0.5
in December/January,2021,Louisville,0,1,1,0.0
All Games,2022,Louisville,8,5,13,0.6153846153846154
at Home,2022,Louisville,5,1,6,0.8333333333333334
on Road/Neutral Site,2022,Louisville,3,4,7,0.42857142857142855
vs. Conference,2022,Louisville,4,4,8,0.5
vs. Non-Conference,2022,Louisville,4,1,5,0.8
vs. Ranked (AP),2022,Louisville,1,2,3,0.3333333333333333
vs. Unranked (AP),2022,Louisville,7,3,10,0.7
vs. FBS (I-A),2022,Louisville,8,5,13,0.6153846153846154
vs. FCS (I-AA),2022,Louisville,0,0,0,
vs. FBS Winning,2022,Louisville,6,4,10,0.6
vs. FBS Non-Winning,2022,Louisville,2,1,3,0.6666666666666666
vs. BCS AQ,2022,Louisville,7,5,12,0.5833333333333334
vs. BCS non-AQ,2022,Louisville,1,0,1,1.0
vs. FBS Power 5,2022,Louisville,4,5,9,0.4444444444444444
vs. FBS non-Power 5,2022,Louisville,4,0,4,1.0
in August/September,2022,Louisville,2,2,4,0.5
in October,2022,Louisville,3,1,4,0.75
in November,2022,Louisville,2,2,4,0.5
in December/January,2022,Louisville,1,0,1,1.0
All Games,2009,Marshall,7,6,13,0.5384615384615384
at Home,2009,Marshall,4,2,6,0.6666666666666666
on Road/Neutral Site,2009,Marshall,3,4,7,0.42857142857142855
vs. Conference,2009,Marshall,4,4,8,0.5
vs. Non-Conference,2009,Marshall,3,2,5,0.6
vs. Ranked (AP),2009,Marshall,0,2,2,0.0
vs. Unranked (AP),2009,Marshall,7,4,11,0.6363636363636364
vs. FBS (I-A),2009,Marshall,6,6,12,0.5
vs. FCS (I-AA),2009,Marshall,1,0,1,1.0
vs. FBS Winning,2009,Marshall,3,5,8,0.375
vs. FBS Non-Winning,2009,Marshall,3,1,4,0.75
vs. BCS AQ,2009,Marshall,0,2,2,0.0
vs. BCS non-AQ,2009,Marshall,6,4,10,0.6
vs. FBS Power 5,2009,Marshall,0,1,1,0.0
vs. FBS non-Power 5,2009,Marshall,6,5,11,0.5454545454545454
in August/September,2009,Marshall,3,1,4,0.75
in October,2009,Marshall,2,2,4,0.5
in November,2009,Marshall,1,3,4,0.25
in December/January,2009,Marshall,1,0,1,1.0
All Games,2010,Marshall,5,7,12,0.4166666666666667
at Home,2010,Marshall,4,2,6,0.6666666666666666
on Road/Neutral Site,2010,Marshall,1,5,6,0.16666666666666666
vs. Conference,2010,Marshall,4,4,8,0.5
vs. Non-Conference,2010,Marshall,1,3,4,0.25
vs. Ranked (AP),2010,Marshall,0,2,2,0.0
vs. Unranked (AP),2010,Marshall,5,5,10,0.5
vs. FBS (I-A),2010,Marshall,5,7,12,0.4166666666666667
vs. FCS (I-AA),2010,Marshall,0,0,0,
vs. FBS Winning,2010,Marshall,1,4,5,0.2
vs. FBS Non-Winning,2010,Marshall,4,3,7,0.5714285714285714
vs. BCS AQ,2010,Marshall,0,2,2,0.0
vs. BCS non-AQ,2010,Marshall,5,5,10,0.5
vs. FBS Power 5,2010,Marshall,0,1,1,0.0
vs. FBS non-Power 5,2010,Marshall,5,6,11,0.45454545454545453
in August/September,2010,Marshall,1,3,4,0.25
in October,2010,Marshall,1,3,4,0.25
in November,2010,Marshall,3,1,4,0.75
in December/January,2010,Marshall,0,0,0,
All Games,2011,Marshall,7,6,13,0.5384615384615384
at Home,2011,Marshall,4,1,5,0.8
on Road/Neutral Site,2011,Marshall,3,5,8,0.375
vs. Conference,2011,Marshall,5,3,8,0.625
vs. Non-Conference,2011,Marshall,2,3,5,0.4
vs. Ranked (AP),2011,Marshall,1,3,4,0.25
vs. Unranked (AP),2011,Marshall,6,3,9,0.6666666666666666
vs. FBS (I-A),2011,Marshall,7,6,13,0.5384615384615384
vs. FCS (I-AA),2011,Marshall,0,0,0,
vs. FBS Winning,2011,Marshall,3,5,8,0.375
vs. FBS Non-Winning,2011,Marshall,4,1,5,0.8
vs. BCS AQ,2011,Marshall,1,2,3,0.3333333333333333
vs. BCS non-AQ,2011,Marshall,6,4,10,0.6
vs. FBS Power 5,2011,Marshall,0,1,1,0.0
vs. FBS non-Power 5,2011,Marshall,7,5,12,0.5833333333333334
in August/September,2011,Marshall,1,3,4,0.25
in October,2011,Marshall,3,2,5,0.6
in November,2011,Marshall,2,1,3,0.6666666666666666
in December/January,2011,Marshall,1,0,1,1.0
All Games,2012,Marshall,5,7,12,0.4166666666666667
at Home,2012,Marshall,3,3,6,0.5
on Road/Neutral Site,2012,Marshall,2,4,6,0.3333333333333333
vs. Conference,2012,Marshall,4,4,8,0.5
vs. Non-Conference,2012,Marshall,1,3,4,0.25
vs. Ranked (AP),2012,Marshall,0,0,0,
vs. Unranked (AP),2012,Marshall,5,7,12,0.4166666666666667
vs. FBS (I-A),2012,Marshall,4,7,11,0.36363636363636365
vs. FCS (I-AA),2012,Marshall,1,0,1,1.0
vs. FBS Winning,2012,Marshall,1,5,6,0.16666666666666666
vs. FBS Non-Winning,2012,Marshall,3,2,5,0.6
vs. BCS AQ,2012,Marshall,0,2,2,0.0
vs. BCS non-AQ,2012,Marshall,4,5,9,0.4444444444444444
vs. FBS Power 5,2012,Marshall,0,2,2,0.0
vs. FBS non-Power 5,2012,Marshall,4,5,9,0.4444444444444444
in August/September,2012,Marshall,2,3,5,0.4
in October,2012,Marshall,1,2,3,0.3333333333333333
in November,2012,Marshall,2,2,4,0.5
in December/January,2012,Marshall,0,0,0,
All Games,2013,Marshall,10,4,14,0.7142857142857143
at Home,2013,Marshall,6,0,6,1.0
on Road/Neutral Site,2013,Marshall,4,4,8,0.5
vs. Conference,2013,Marshall,7,2,9,0.7777777777777778
vs. Non-Conference,2013,Marshall,3,2,5,0.6
vs. Ranked (AP),2013,Marshall,0,0,0,
vs. Unranked (AP),2013,Marshall,10,4,14,0.7142857142857143
vs. FBS (I-A),2013,Marshall,9,4,13,0.6923076923076923
vs. FCS (I-AA),2013,Marshall,1,0,1,1.0
vs. FBS Winning,2013,Marshall,3,4,7,0.42857142857142855
vs. FBS Non-Winning,2013,Marshall,6,0,6,1.0
vs. BCS AQ,2013,Marshall,1,1,2,0.5
vs. BCS non-AQ,2013,Marshall,8,3,11,0.7272727272727273
vs. FBS Power 5,2013,Marshall,1,1,2,0.5
vs. FBS non-Power 5,2013,Marshall,8,3,11,0.7272727272727273
in August/September,2013,Marshall,2,2,4,0.5
in October,2013,Marshall,2,1,3,0.6666666666666666
in November,2013,Marshall,5,0,5,1.0
in December/January,2013,Marshall,1,1,2,0.5
All Games,2014,Marshall,13,1,14,0.9285714285714286
at Home,2014,Marshall,6,1,7,0.8571428571428571
on Road/Neutral Site,2014,Marshall,7,0,7,1.0
vs. Conference,2014,Marshall,8,1,9,0.8888888888888888
vs. Non-Conference,2014,Marshall,5,0,5,1.0
vs. Ranked (AP),2014,Marshall,0,0,0,
vs. Unranked (AP),2014,Marshall,13,1,14,0.9285714285714286
vs. FBS (I-A),2014,Marshall,12,1,13,0.9230769230769231
vs. FCS (I-AA),2014,Marshall,1,0,1,1.0
vs. FBS Winning,2014,Marshall,3,1,4,0.75
vs. FBS Non-Winning,2014,Marshall,9,0,9,1.0
vs. BCS AQ,2014,Marshall,0,0,0,
vs. BCS non-AQ,2014,Marshall,12,1,13,0.9230769230769231
vs. FBS Power 5,2014,Marshall,0,0,0,
vs. FBS non-Power 5,2014,Marshall,12,1,13,0.9230769230769231
in August/September,2014,Marshall,4,0,4,1.0
in October,2014,Marshall,4,0,4,1.0
in November,2014,Marshall,3,1,4,0.75
in December/January,2014,Marshall,2,0,2,1.0
All Games,2015,Marshall,10,3,13,0.7692307692307693
at Home,2015,Marshall,6,0,6,1.0
on Road/Neutral Site,2015,Marshall,4,3,7,0.5714285714285714
vs. Conference,2015,Marshall,6,2,8,0.75
vs. Non-Conference,2015,Marshall,4,1,5,0.8
vs. Ranked (AP),2015,Marshall,0,1,1,0.0
vs. Unranked (AP),2015,Marshall,10,2,12,0.8333333333333334
vs. FBS (I-A),2015,Marshall,9,3,12,0.75
vs. FCS (I-AA),2015,Marshall,1,0,1,1.0
vs. FBS Winning,2015,Marshall,1,3,4,0.25
vs. FBS Non-Winning,2015,Marshall,8,0,8,1.0
vs. BCS AQ,2015,Marshall,2,0,2,1.0
vs. BCS non-AQ,2015,Marshall,7,3,10,0.7
vs. FBS Power 5,2015,Marshall,1,0,1,1.0
vs. FBS non-Power 5,2015,Marshall,8,3,11,0.7272727272727273
in August/September,2015,Marshall,3,1,4,0.75
in October,2015,Marshall,5,0,5,1.0
in November,2015,Marshall,1,2,3,0.3333333333333333
in December/January,2015,Marshall,1,0,1,1.0
All Games,2016,Marshall,3,9,12,0.25
at Home,2016,Marshall,3,4,7,0.42857142857142855
on Road/Neutral Site,2016,Marshall,0,5,5,0.0
vs. Conference,2016,Marshall,2,6,8,0.25
vs. Non-Conference,2016,Marshall,1,3,4,0.25
vs. Ranked (AP),2016,Marshall,0,2,2,0.0
vs. Unranked (AP),2016,Marshall,3,7,10,0.3
vs. FBS (I-A),2016,Marshall,2,9,11,0.18181818181818182
vs. FCS (I-AA),2016,Marshall,1,0,1,1.0
vs. FBS Winning,2016,Marshall,1,5,6,0.16666666666666666
vs. FBS Non-Winning,2016,Marshall,1,4,5,0.2
vs. BCS AQ,2016,Marshall,0,2,2,0.0
vs. BCS non-AQ,2016,Marshall,2,7,9,0.2222222222222222
vs. FBS Power 5,2016,Marshall,0,2,2,0.0
vs. FBS non-Power 5,2016,Marshall,2,7,9,0.2222222222222222
in August/September,2016,Marshall,1,2,3,0.3333333333333333
in October,2016,Marshall,1,4,5,0.2
in November,2016,Marshall,1,3,4,0.25
in December/January,2016,Marshall,0,0,0,
All Games,2017,Marshall,8,5,13,0.6153846153846154
at Home,2017,Marshall,4,2,6,0.6666666666666666
on Road/Neutral Site,2017,Marshall,4,3,7,0.5714285714285714
vs. Conference,2017,Marshall,4,4,8,0.5
vs. Non-Conference,2017,Marshall,4,1,5,0.8
vs. Ranked (AP),2017,Marshall,0,1,1,0.0
vs. Unranked (AP),2017,Marshall,8,4,12,0.6666666666666666
vs. FBS (I-A),2017,Marshall,8,5,13,0.6153846153846154
vs. FCS (I-AA),2017,Marshall,0,0,0,
vs. FBS Winning,2017,Marshall,2,5,7,0.2857142857142857
vs. FBS Non-Winning,2017,Marshall,6,0,6,1.0
vs. BCS AQ,2017,Marshall,1,1,2,0.5
vs. BCS non-AQ,2017,Marshall,7,4,11,0.6363636363636364
vs. FBS Power 5,2017,Marshall,0,1,1,0.0
vs. FBS non-Power 5,2017,Marshall,8,4,12,0.6666666666666666
in August/September,2017,Marshall,3,1,4,0.75
in October,2017,Marshall,3,1,4,0.75
in November,2017,Marshall,1,3,4,0.25
in December/January,2017,Marshall,1,0,1,1.0
All Games,2018,Marshall,9,4,13,0.6923076923076923
at Home,2018,Marshall,4,2,6,0.6666666666666666
on Road/Neutral Site,2018,Marshall,5,2,7,0.7142857142857143
vs. Conference,2018,Marshall,6,2,8,0.75
vs. Non-Conference,2018,Marshall,3,2,5,0.6
vs. Ranked (AP),2018,Marshall,0,0,0,
vs. Unranked (AP),2018,Marshall,9,4,13,0.6923076923076923
vs. FBS (I-A),2018,Marshall,8,4,12,0.6666666666666666
vs. FCS (I-AA),2018,Marshall,1,0,1,1.0
vs. FBS Winning,2018,Marshall,2,3,5,0.4
vs. FBS Non-Winning,2018,Marshall,6,1,7,0.8571428571428571
vs. BCS AQ,2018,Marshall,1,2,3,0.3333333333333333
vs. BCS non-AQ,2018,Marshall,7,2,9,0.7777777777777778
vs. FBS Power 5,2018,Marshall,0,2,2,0.0
vs. FBS non-Power 5,2018,Marshall,8,2,10,0.8
in August/September,2018,Marshall,3,1,4,0.75
in October,2018,Marshall,2,1,3,0.6666666666666666
in November,2018,Marshall,3,1,4,0.75
in December/January,2018,Marshall,1,1,2,0.5
All Games,2019,Marshall,8,5,13,0.6153846153846154
at Home,2019,Marshall,6,1,7,0.8571428571428571
on Road/Neutral Site,2019,Marshall,2,4,6,0.3333333333333333
vs. Conference,2019,Marshall,6,2,8,0.75
vs. Non-Conference,2019,Marshall,2,3,5,0.4
vs. Ranked (AP),2019,Marshall,0,3,3,0.0
vs. Unranked (AP),2019,Marshall,8,2,10,0.8
vs. FBS (I-A),2019,Marshall,7,5,12,0.5833333333333334
vs. FCS (I-AA),2019,Marshall,1,0,1,1.0
vs. FBS Winning,2019,Marshall,4,4,8,0.5
vs. FBS Non-Winning,2019,Marshall,3,1,4,0.75
vs. BCS AQ,2019,Marshall,0,2,2,0.0
vs. BCS non-AQ,2019,Marshall,7,3,10,0.7
vs. FBS Power 5,2019,Marshall,0,0,0,
vs. FBS non-Power 5,2019,Marshall,7,5,12,0.5833333333333334
in August/September,2019,Marshall,2,2,4,0.5
in October,2019,Marshall,3,1,4,0.75
in November,2019,Marshall,3,1,4,0.75
in December/January,2019,Marshall,0,1,1,0.0
All Games,2020,Marshall,7,3,10,0.7
at Home,2020,Marshall,5,2,7,0.7142857142857143
on Road/Neutral Site,2020,Marshall,2,1,3,0.6666666666666666
vs. Conference,2020,Marshall,4,2,6,0.6666666666666666
vs. Non-Conference,2020,Marshall,3,1,4,0.75
vs. Ranked (AP),2020,Marshall,0,0,0,
vs. Unranked (AP),2020,Marshall,7,3,10,0.7
vs. FBS (I-A),2020,Marshall,6,3,9,0.6666666666666666
vs. FCS (I-AA),2020,Marshall,1,0,1,1.0
vs. FBS Winning,2020,Marshall,2,2,4,0.5
vs. FBS Non-Winning,2020,Marshall,4,1,5,0.8
vs. BCS AQ,2020,Marshall,0,0,0,
vs. BCS non-AQ,2020,Marshall,6,3,9,0.6666666666666666
vs. FBS Power 5,2020,Marshall,0,0,0,
vs. FBS non-Power 5,2020,Marshall,6,3,9,0.6666666666666666
in August/September,2020,Marshall,2,0,2,1.0
in October,2020,Marshall,3,0,3,1.0
in November,2020,Marshall,2,0,2,1.0
in December/January,2020,Marshall,0,3,3,0.0
All Games,2021,Marshall,7,6,13,0.5384615384615384
at Home,2021,Marshall,3,3,6,0.5
on Road/Neutral Site,2021,Marshall,4,3,7,0.5714285714285714
vs. Conference,2021,Marshall,5,3,8,0.625
vs. Non-Conference,2021,Marshall,2,3,5,0.4
vs. Ranked (AP),2021,Marshall,0,1,1,0.0
vs. Unranked (AP),2021,Marshall,7,5,12,0.5833333333333334
vs. FBS (I-A),2021,Marshall,6,6,12,0.5
vs. FCS (I-AA),2021,Marshall,1,0,1,1.0
vs. FBS Winning,2021,Marshall,0,6,6,0.0
vs. FBS Non-Winning,2021,Marshall,6,0,6,1.0
vs. BCS AQ,2021,Marshall,1,1,2,0.5
vs. BCS non-AQ,2021,Marshall,5,5,10,0.5
vs. FBS Power 5,2021,Marshall,0,0,0,
vs. FBS non-Power 5,2021,Marshall,6,6,12,0.5
in August/September,2021,Marshall,2,2,4,0.5
in October,2021,Marshall,3,1,4,0.75
in November,2021,Marshall,2,2,4,0.5
in December/January,2021,Marshall,0,1,1,0.0
All Games,2022,Marshall,9,4,13,0.6923076923076923
at Home,2022,Marshall,4,2,6,0.6666666666666666
on Road/Neutral Site,2022,Marshall,5,2,7,0.7142857142857143
vs. Conference,2022,Marshall,5,3,8,0.625
vs. Non-Conference,2022,Marshall,4,1,5,0.8
vs. Ranked (AP),2022,Marshall,1,1,2,0.5
vs. Unranked (AP),2022,Marshall,8,3,11,0.7272727272727273
vs. FBS (I-A),2022,Marshall,7,4,11,0.6363636363636364
vs. FCS (I-AA),2022,Marshall,2,0,2,1.0
vs. FBS Winning,2022,Marshall,2,2,4,0.5
vs. FBS Non-Winning,2022,Marshall,5,2,7,0.7142857142857143
vs. BCS AQ,2022,Marshall,1,0,1,1.0
vs. BCS non-AQ,2022,Marshall,6,4,10,0.6
vs. FBS Power 5,2022,Marshall,0,0,0,
vs. FBS non-Power 5,2022,Marshall,7,4,11,0.6363636363636364
in August/September,2022,Marshall,2,2,4,0.5
in October,2022,Marshall,2,2,4,0.5
in November,2022,Marshall,4,0,4,1.0
in December/January,2022,Marshall,1,0,1,1.0
All Games,2009,Maryland,2,10,12,0.16666666666666666
at Home,2009,Maryland,2,5,7,0.2857142857142857
on Road/Neutral Site,2009,Maryland,0,5,5,0.0
vs. Conference,2009,Maryland,1,7,8,0.125
vs. Non-Conference,2009,Maryland,1,3,4,0.25
vs. Ranked (AP),2009,Maryland,1,1,2,0.5
vs. Unranked (AP),2009,Maryland,1,9,10,0.1
vs. FBS (I-A),2009,Maryland,1,10,11,0.09090909090909091
vs. FCS (I-AA),2009,Maryland,1,0,1,1.0
vs. FBS Winning,2009,Maryland,1,6,7,0.14285714285714285
vs. FBS Non-Winning,2009,Maryland,0,4,4,0.0
vs. BCS AQ,2009,Maryland,1,9,10,0.1
vs. BCS non-AQ,2009,Maryland,0,1,1,0.0
vs. FBS Power 5,2009,Maryland,1,8,9,0.1111111111111111
vs. FBS non-Power 5,2009,Maryland,0,2,2,0.0
in August/September,2009,Maryland,1,3,4,0.25
in October,2009,Maryland,1,3,4,0.25
in November,2009,Maryland,0,4,4,0.0
in December/January,2009,Maryland,0,0,0,
All Games,2010,Maryland,9,4,13,0.6923076923076923
at Home,2010,Maryland,5,1,6,0.8333333333333334
on Road/Neutral Site,2010,Maryland,4,3,7,0.5714285714285714
vs. Conference,2010,Maryland,5,3,8,0.625
vs. Non-Conference,2010,Maryland,4,1,5,0.8
vs. Ranked (AP),2010,Maryland,1,1,2,0.5
vs. Unranked (AP),2010,Maryland,8,3,11,0.7272727272727273
vs. FBS (I-A),2010,Maryland,8,4,12,0.6666666666666666
vs. FCS (I-AA),2010,Maryland,1,0,1,1.0
vs. FBS Winning,2010,Maryland,4,3,7,0.5714285714285714
vs. FBS Non-Winning,2010,Maryland,4,1,5,0.8
vs. BCS AQ,2010,Maryland,5,4,9,0.5555555555555556
vs. BCS non-AQ,2010,Maryland,3,0,3,1.0
vs. FBS Power 5,2010,Maryland,5,3,8,0.625
vs. FBS non-Power 5,2010,Maryland,3,1,4,0.75
in August/September,2010,Maryland,3,1,4,0.75
in October,2010,Maryland,3,1,4,0.75
in November,2010,Maryland,2,2,4,0.5
in December/January,2010,Maryland,1,0,1,1.0
All Games,2011,Maryland,2,10,12,0.16666666666666666
at Home,2011,Maryland,2,5,7,0.2857142857142857
on Road/Neutral Site,2011,Maryland,0,5,5,0.0
vs. Conference,2011,Maryland,1,7,8,0.125
vs. Non-Conference,2011,Maryland,1,3,4,0.25
vs. Ranked (AP),2011,Maryland,0,3,3,0.0
vs. Unranked (AP),2011,Maryland,2,7,9,0.2222222222222222
vs. FBS (I-A),2011,Maryland,1,10,11,0.09090909090909091
vs. FCS (I-AA),2011,Maryland,1,0,1,1.0
vs. FBS Winning,2011,Maryland,0,8,8,0.0
vs. FBS Non-Winning,2011,Maryland,1,2,3,0.3333333333333333
vs. BCS AQ,2011,Maryland,1,9,10,0.1
vs. BCS non-AQ,2011,Maryland,0,1,1,0.0
vs. FBS Power 5,2011,Maryland,1,7,8,0.125
vs. FBS non-Power 5,2011,Maryland,0,3,3,0.0
in August/September,2011,Maryland,1,2,3,0.3333333333333333
in October,2011,Maryland,1,4,5,0.2
in November,2011,Maryland,0,4,4,0.0
in December/January,2011,Maryland,0,0,0,
All Games,2012,Maryland,4,8,12,0.3333333333333333
at Home,2012,Maryland,2,4,6,0.3333333333333333
on Road/Neutral Site,2012,Maryland,2,4,6,0.3333333333333333
vs. Conference,2012,Maryland,2,6,8,0.25
vs. Non-Conference,2012,Maryland,2,2,4,0.5
vs. Ranked (AP),2012,Maryland,0,2,2,0.0
vs. Unranked (AP),2012,Maryland,4,6,10,0.4
vs. FBS (I-A),2012,Maryland,3,8,11,0.2727272727272727
vs. FCS (I-AA),2012,Maryland,1,0,1,1.0
vs. FBS Winning,2012,Maryland,0,5,5,0.0
vs. FBS Non-Winning,2012,Maryland,3,3,6,0.5
vs. BCS AQ,2012,Maryland,3,8,11,0.2727272727272727
vs. BCS non-AQ,2012,Maryland,0,0,0,
vs. FBS Power 5,2012,Maryland,2,7,9,0.2222222222222222
vs. FBS non-Power 5,2012,Maryland,1,1,2,0.5
in August/September,2012,Maryland,2,2,4,0.5
in October,2012,Maryland,2,2,4,0.5
in November,2012,Maryland,0,4,4,0.0
in December/January,2012,Maryland,0,0,0,
All Games,2013,Maryland,7,6,13,0.5384615384615384
at Home,2013,Maryland,3,3,6,0.5
on Road/Neutral Site,2013,Maryland,4,3,7,0.5714285714285714
vs. Conference,2013,Maryland,3,5,8,0.375
vs. Non-Conference,2013,Maryland,4,1,5,0.8
vs. Ranked (AP),2013,Maryland,0,2,2,0.0
vs. Unranked (AP),2013,Maryland,7,4,11,0.6363636363636364
vs. FBS (I-A),2013,Maryland,6,6,12,0.5
vs. FCS (I-AA),2013,Maryland,1,0,1,1.0
vs. FBS Winning,2013,Maryland,1,5,6,0.16666666666666666
vs. FBS Non-Winning,2013,Maryland,5,1,6,0.8333333333333334
vs. BCS AQ,2013,Maryland,5,5,10,0.5
vs. BCS non-AQ,2013,Maryland,1,1,2,0.5
vs. FBS Power 5,2013,Maryland,4,5,9,0.4444444444444444
vs. FBS non-Power 5,2013,Maryland,2,1,3,0.6666666666666666
in August/September,2013,Maryland,4,0,4,1.0
in October,2013,Maryland,1,3,4,0.25
in November,2013,Maryland,2,2,4,0.5
in December/January,2013,Maryland,0,1,1,0.0
All Games,2014,Maryland,7,6,13,0.5384615384615384
at Home,2014,Maryland,2,4,6,0.3333333333333333
on Road/Neutral Site,2014,Maryland,5,2,7,0.7142857142857143
vs. Conference,2014,Maryland,4,4,8,0.5
vs. Non-Conference,2014,Maryland,3,2,5,0.6
vs. Ranked (AP),2014,Maryland,0,3,3,0.0
vs. Unranked (AP),2014,Maryland,7,3,10,0.7
vs. FBS (I-A),2014,Maryland,6,6,12,0.5
vs. FCS (I-AA),2014,Maryland,1,0,1,1.0
vs. FBS Winning,2014,Maryland,2,6,8,0.25
vs. FBS Non-Winning,2014,Maryland,4,0,4,1.0
vs. BCS AQ,2014,Maryland,6,6,12,0.5
vs. BCS non-AQ,2014,Maryland,0,0,0,
vs. FBS Power 5,2014,Maryland,5,6,11,0.45454545454545453
vs. FBS non-Power 5,2014,Maryland,1,0,1,1.0
in August/September,2014,Maryland,4,1,5,0.8
in October,2014,Maryland,1,2,3,0.3333333333333333
in November,2014,Maryland,2,2,4,0.5
in December/January,2014,Maryland,0,1,1,0.0
All Games,2015,Maryland,3,9,12,0.25
at Home,2015,Maryland,2,4,6,0.3333333333333333
on Road/Neutral Site,2015,Maryland,1,5,6,0.16666666666666666
vs. Conference,2015,Maryland,1,7,8,0.125
vs. Non-Conference,2015,Maryland,2,2,4,0.5
vs. Ranked (AP),2015,Maryland,0,5,5,0.0
vs. Unranked (AP),2015,Maryland,3,4,7,0.42857142857142855
vs. FBS (I-A),2015,Maryland,2,9,11,0.18181818181818182
vs. FCS (I-AA),2015,Maryland,1,0,1,1.0
vs. FBS Winning,2015,Maryland,1,8,9,0.1111111111111111
vs. FBS Non-Winning,2015,Maryland,1,1,2,0.5
vs. BCS AQ,2015,Maryland,2,8,10,0.2
vs. BCS non-AQ,2015,Maryland,0,1,1,0.0
vs. FBS Power 5,2015,Maryland,1,8,9,0.1111111111111111
vs. FBS non-Power 5,2015,Maryland,1,1,2,0.5
in August/September,2015,Maryland,2,2,4,0.5
in October,2015,Maryland,0,4,4,0.0
in November,2015,Maryland,1,3,4,0.25
in December/January,2015,Maryland,0,0,0,
All Games,2016,Maryland,6,7,13,0.46153846153846156
at Home,2016,Maryland,4,2,6,0.6666666666666666
on Road/Neutral Site,2016,Maryland,2,5,7,0.2857142857142857
vs. Conference,2016,Maryland,3,6,9,0.3333333333333333
vs. Non-Conference,2016,Maryland,3,1,4,0.75
vs. Ranked (AP),2016,Maryland,0,4,4,0.0
vs. Unranked (AP),2016,Maryland,6,3,9,0.6666666666666666
vs. FBS (I-A),2016,Maryland,5,7,12,0.4166666666666667
vs. FCS (I-AA),2016,Maryland,1,0,1,1.0
vs. FBS Winning,2016,Maryland,0,6,6,0.0
vs. FBS Non-Winning,2016,Maryland,5,1,6,0.8333333333333334
vs. BCS AQ,2016,Maryland,4,7,11,0.36363636363636365
vs. BCS non-AQ,2016,Maryland,1,0,1,1.0
vs. FBS Power 5,2016,Maryland,3,7,10,0.3
vs. FBS non-Power 5,2016,Maryland,2,0,2,1.0
in August/September,2016,Maryland,3,0,3,1.0
in October,2016,Maryland,2,3,5,0.4
in November,2016,Maryland,1,3,4,0.25
in December/January,2016,Maryland,0,1,1,0.0
All Games,2017,Maryland,4,8,12,0.3333333333333333
at Home,2017,Maryland,2,4,6,0.3333333333333333
on Road/Neutral Site,2017,Maryland,2,4,6,0.3333333333333333
vs. Conference,2017,Maryland,2,7,9,0.2222222222222222
vs. Non-Conference,2017,Maryland,2,1,3,0.6666666666666666
vs. Ranked (AP),2017,Maryland,0,6,6,0.0
vs. Unranked (AP),2017,Maryland,4,2,6,0.6666666666666666
vs. FBS (I-A),2017,Maryland,3,8,11,0.2727272727272727
vs. FCS (I-AA),2017,Maryland,1,0,1,1.0
vs. FBS Winning,2017,Maryland,1,7,8,0.125
vs. FBS Non-Winning,2017,Maryland,2,1,3,0.6666666666666666
vs. BCS AQ,2017,Maryland,3,8,11,0.2727272727272727
vs. BCS non-AQ,2017,Maryland,0,0,0,
vs. FBS Power 5,2017,Maryland,3,7,10,0.3
vs. FBS non-Power 5,2017,Maryland,0,1,1,0.0
in August/September,2017,Maryland,3,1,4,0.75
in October,2017,Maryland,1,3,4,0.25
in November,2017,Maryland,0,4,4,0.0
in December/January,2017,Maryland,0,0,0,
All Games,2018,Maryland,5,7,12,0.4166666666666667
at Home,2018,Maryland,3,3,6,0.5
on Road/Neutral Site,2018,Maryland,2,4,6,0.3333333333333333
vs. Conference,2018,Maryland,3,6,9,0.3333333333333333
vs. Non-Conference,2018,Maryland,2,1,3,0.6666666666666666
vs. Ranked (AP),2018,Maryland,1,4,5,0.2
vs. Unranked (AP),2018,Maryland,4,3,7,0.5714285714285714
vs. FBS (I-A),2018,Maryland,5,7,12,0.4166666666666667
vs. FCS (I-AA),2018,Maryland,0,0,0,
vs. FBS Winning,2018,Maryland,2,6,8,0.25
vs. FBS Non-Winning,2018,Maryland,3,1,4,0.75
vs. BCS AQ,2018,Maryland,4,7,11,0.36363636363636365
vs. BCS non-AQ,2018,Maryland,1,0,1,1.0
vs. FBS Power 5,2018,Maryland,4,6,10,0.4
vs. FBS non-Power 5,2018,Maryland,1,1,2,0.5
in August/September,2018,Maryland,3,1,4,0.75
in October,2018,Maryland,2,2,4,0.5
in November,2018,Maryland,0,4,4,0.0
in December/January,2018,Maryland,0,0,0,
All Games,2019,Maryland,3,9,12,0.25
at Home,2019,Maryland,2,4,6,0.3333333333333333
on Road/Neutral Site,2019,Maryland,1,5,6,0.16666666666666666
vs. Conference,2019,Maryland,1,8,9,0.1111111111111111
vs. Non-Conference,2019,Maryland,2,1,3,0.6666666666666666
vs. Ranked (AP),2019,Maryland,0,4,4,0.0
vs. Unranked (AP),2019,Maryland,3,5,8,0.375
vs. FBS (I-A),2019,Maryland,2,9,11,0.18181818181818182
vs. FCS (I-AA),2019,Maryland,1,0,1,1.0
vs. FBS Winning,2019,Maryland,0,7,7,0.0
vs. FBS Non-Winning,2019,Maryland,2,2,4,0.5
vs. BCS AQ,2019,Maryland,2,9,11,0.18181818181818182
vs. BCS non-AQ,2019,Maryland,0,0,0,
vs. FBS Power 5,2019,Maryland,2,8,10,0.2
vs. FBS non-Power 5,2019,Maryland,0,1,1,0.0
in August/September,2019,Maryland,2,2,4,0.5
in October,2019,Maryland,1,3,4,0.25
in November,2019,Maryland,0,4,4,0.0
in December/January,2019,Maryland,0,0,0,
All Games,2020,Maryland,2,3,5,0.4
at Home,2020,Maryland,1,1,2,0.5
on Road/Neutral Site,2020,Maryland,1,2,3,0.3333333333333333
vs. Conference,2020,Maryland,2,3,5,0.4
vs. Non-Conference,2020,Maryland,0,0,0,
vs. Ranked (AP),2020,Maryland,0,2,2,0.0
vs. Unranked (AP),2020,Maryland,2,1,3,0.6666666666666666
vs. FBS (I-A),2020,Maryland,2,3,5,0.4
vs. FCS (I-AA),2020,Maryland,0,0,0,
vs. FBS Winning,2020,Maryland,0,2,2,0.0
vs. FBS Non-Winning,2020,Maryland,2,1,3,0.6666666666666666
vs. BCS AQ,2020,Maryland,2,3,5,0.4
vs. BCS non-AQ,2020,Maryland,0,0,0,
vs. FBS Power 5,2020,Maryland,2,3,5,0.4
vs. FBS non-Power 5,2020,Maryland,0,0,0,
in August/September,2020,Maryland,0,0,0,
in October,2020,Maryland,1,1,2,0.5
in November,2020,Maryland,1,1,2,0.5
in December/January,2020,Maryland,0,1,1,0.0
All Games,2021,Maryland,7,6,13,0.5384615384615384
at Home,2021,Maryland,4,3,7,0.5714285714285714
on Road/Neutral Site,2021,Maryland,3,3,6,0.5
vs. Conference,2021,Maryland,3,6,9,0.3333333333333333
vs. Non-Conference,2021,Maryland,4,0,4,1.0
vs. Ranked (AP),2021,Maryland,0,4,4,0.0
vs. Unranked (AP),2021,Maryland,7,2,9,0.7777777777777778
vs. FBS (I-A),2021,Maryland,6,6,12,0.5
vs. FCS (I-AA),2021,Maryland,1,0,1,1.0
vs. FBS Winning,2021,Maryland,0,6,6,0.0
vs. FBS Non-Winning,2021,Maryland,6,0,6,1.0
vs. BCS AQ,2021,Maryland,5,6,11,0.45454545454545453
vs. BCS non-AQ,2021,Maryland,1,0,1,1.0
vs. FBS Power 5,2021,Maryland,5,6,11,0.45454545454545453
vs. FBS non-Power 5,2021,Maryland,1,0,1,1.0
in August/September,2021,Maryland,4,0,4,1.0
in October,2021,Maryland,1,3,4,0.25
in November,2021,Maryland,1,3,4,0.25
in December/January,2021,Maryland,1,0,1,1.0
All Games,2022,Maryland,8,5,13,0.6153846153846154
at Home,2022,Maryland,5,2,7,0.7142857142857143
on Road/Neutral Site,2022,Maryland,3,3,6,0.5
vs. Conference,2022,Maryland,4,5,9,0.4444444444444444
vs. Non-Conference,2022,Maryland,4,0,4,1.0
vs. Ranked (AP),2022,Maryland,0,3,3,0.0
vs. Unranked (AP),2022,Maryland,8,2,10,0.8
vs. FBS (I-A),2022,Maryland,8,5,13,0.6153846153846154
vs. FCS (I-AA),2022,Maryland,0,0,0,
vs. FBS Winning,2022,Maryland,3,5,8,0.375
vs. FBS Non-Winning,2022,Maryland,5,0,5,1.0
vs. BCS AQ,2022,Maryland,6,5,11,0.5454545454545454
vs. BCS non-AQ,2022,Maryland,2,0,2,1.0
vs. FBS Power 5,2022,Maryland,5,5,10,0.5
vs. FBS non-Power 5,2022,Maryland,3,0,3,1.0
in August/September,2022,Maryland,3,1,4,0.75
in October,2022,Maryland,3,1,4,0.75
in November,2022,Maryland,1,3,4,0.25
in December/January,2022,Maryland,1,0,1,1.0
All Games,2012,Massachusetts,1,11,12,0.08333333333333333
at Home,2012,Massachusetts,0,5,5,0.0
on Road/Neutral Site,2012,Massachusetts,1,6,7,0.14285714285714285
vs. Conference,2012,Massachusetts,1,7,8,0.125
vs. Non-Conference,2012,Massachusetts,0,4,4,0.0
vs. Ranked (AP),2012,Massachusetts,0,3,3,0.0
vs. Unranked (AP),2012,Massachusetts,1,8,9,0.1111111111111111
vs. FBS (I-A),2012,Massachusetts,1,11,12,0.08333333333333333
vs. FCS (I-AA),2012,Massachusetts,0,0,0,
vs. FBS Winning,2012,Massachusetts,0,6,6,0.0
vs. FBS Non-Winning,2012,Massachusetts,1,5,6,0.16666666666666666
vs. BCS AQ,2012,Massachusetts,0,4,4,0.0
vs. BCS non-AQ,2012,Massachusetts,1,7,8,0.125
vs. FBS Power 5,2012,Massachusetts,0,3,3,0.0
vs. FBS non-Power 5,2012,Massachusetts,1,8,9,0.1111111111111111
in August/September,2012,Massachusetts,0,5,5,0.0
in October,2012,Massachusetts,0,3,3,0.0
in November,2012,Massachusetts,1,3,4,0.25
in December/January,2012,Massachusetts,0,0,0,
All Games,2013,Massachusetts,1,11,12,0.08333333333333333
at Home,2013,Massachusetts,1,5,6,0.16666666666666666
on Road/Neutral Site,2013,Massachusetts,0,6,6,0.0
vs. Conference,2013,Massachusetts,1,7,8,0.125
vs. Non-Conference,2013,Massachusetts,0,4,4,0.0
vs. Ranked (AP),2013,Massachusetts,0,2,2,0.0
vs. Unranked (AP),2013,Massachusetts,1,9,10,0.1
vs. FBS (I-A),2013,Massachusetts,1,10,11,0.09090909090909091
vs. FCS (I-AA),2013,Massachusetts,0,1,1,0.0
vs. FBS Winning,2013,Massachusetts,0,7,7,0.0
vs. FBS Non-Winning,2013,Massachusetts,1,3,4,0.25
vs. BCS AQ,2013,Massachusetts,0,3,3,0.0
vs. BCS non-AQ,2013,Massachusetts,1,7,8,0.125
vs. FBS Power 5,2013,Massachusetts,0,3,3,0.0
vs. FBS non-Power 5,2013,Massachusetts,1,7,8,0.125
in August/September,2013,Massachusetts,0,4,4,0.0
in October,2013,Massachusetts,1,3,4,0.25
in November,2013,Massachusetts,0,4,4,0.0
in December/January,2013,Massachusetts,0,0,0,
All Games,2014,Massachusetts,3,9,12,0.25
at Home,2014,Massachusetts,2,4,6,0.3333333333333333
on Road/Neutral Site,2014,Massachusetts,1,5,6,0.16666666666666666
vs. Conference,2014,Massachusetts,3,5,8,0.375
vs. Non-Conference,2014,Massachusetts,0,4,4,0.0
vs. Ranked (AP),2014,Massachusetts,0,0,0,
vs. Unranked (AP),2014,Massachusetts,3,9,12,0.25
vs. FBS (I-A),2014,Massachusetts,3,9,12,0.25
vs. FCS (I-AA),2014,Massachusetts,0,0,0,
vs. FBS Winning,2014,Massachusetts,0,4,4,0.0
vs. FBS Non-Winning,2014,Massachusetts,3,5,8,0.375
vs. BCS AQ,2014,Massachusetts,0,4,4,0.0
vs. BCS non-AQ,2014,Massachusetts,3,5,8,0.375
vs. FBS Power 5,2014,Massachusetts,0,4,4,0.0
vs. FBS non-Power 5,2014,Massachusetts,3,5,8,0.375
in August/September,2014,Massachusetts,0,5,5,0.0
in October,2014,Massachusetts,2,2,4,0.5
in November,2014,Massachusetts,1,2,3,0.3333333333333333
in December/January,2014,Massachusetts,0,0,0,
All Games,2015,Massachusetts,3,9,12,0.25
at Home,2015,Massachusetts,1,5,6,0.16666666666666666
on Road/Neutral Site,2015,Massachusetts,2,4,6,0.3333333333333333
vs. Conference,2015,Massachusetts,2,6,8,0.25
vs. Non-Conference,2015,Massachusetts,1,3,4,0.25
vs. Ranked (AP),2015,Massachusetts,0,1,1,0.0
vs. Unranked (AP),2015,Massachusetts,3,8,11,0.2727272727272727
vs. FBS (I-A),2015,Massachusetts,3,9,12,0.25
vs. FCS (I-AA),2015,Massachusetts,0,0,0,
vs. FBS Winning,2015,Massachusetts,0,5,5,0.0
vs. FBS Non-Winning,2015,Massachusetts,3,4,7,0.42857142857142855
vs. BCS AQ,2015,Massachusetts,0,3,3,0.0
vs. BCS non-AQ,2015,Massachusetts,3,6,9,0.3333333333333333
vs. FBS Power 5,2015,Massachusetts,0,1,1,0.0
vs. FBS non-Power 5,2015,Massachusetts,3,8,11,0.2727272727272727
in August/September,2015,Massachusetts,0,3,3,0.0
in October,2015,Massachusetts,1,4,5,0.2
in November,2015,Massachusetts,2,2,4,0.5
in December/January,2015,Massachusetts,0,0,0,
All Games,2016,Massachusetts,2,10,12,0.16666666666666666
at Home,2016,Massachusetts,2,4,6,0.3333333333333333
on Road/Neutral Site,2016,Massachusetts,0,6,6,0.0
vs. Conference,2016,Massachusetts,0,1,1,0.0
vs. Non-Conference,2016,Massachusetts,2,9,11,0.18181818181818182
vs. Ranked (AP),2016,Massachusetts,0,1,1,0.0
vs. Unranked (AP),2016,Massachusetts,2,9,11,0.18181818181818182
vs. FBS (I-A),2016,Massachusetts,1,10,11,0.09090909090909091
vs. FCS (I-AA),2016,Massachusetts,1,0,1,1.0
vs. FBS Winning,2016,Massachusetts,0,6,6,0.0
vs. FBS Non-Winning,2016,Massachusetts,1,4,5,0.2
vs. BCS AQ,2016,Massachusetts,0,5,5,0.0
vs. BCS non-AQ,2016,Massachusetts,1,5,6,0.16666666666666666
vs. FBS Power 5,2016,Massachusetts,0,4,4,0.0
vs. FBS non-Power 5,2016,Massachusetts,1,6,7,0.14285714285714285
in August/September,2016,Massachusetts,1,3,4,0.25
in October,2016,Massachusetts,1,4,5,0.2
in November,2016,Massachusetts,0,3,3,0.0
in December/January,2016,Massachusetts,0,0,0,
All Games,2017,Massachusetts,4,8,12,0.3333333333333333
at Home,2017,Massachusetts,2,3,5,0.4
on Road/Neutral Site,2017,Massachusetts,2,5,7,0.2857142857142857
vs. Conference,2017,Massachusetts,1,0,1,1.0
vs. Non-Conference,2017,Massachusetts,3,8,11,0.2727272727272727
vs. Ranked (AP),2017,Massachusetts,0,1,1,0.0
vs. Unranked (AP),2017,Massachusetts,4,7,11,0.36363636363636365
vs. FBS (I-A),2017,Massachusetts,3,8,11,0.2727272727272727
vs. FCS (I-AA),2017,Massachusetts,1,0,1,1.0
vs. FBS Winning,2017,Massachusetts,1,4,5,0.2
vs. FBS Non-Winning,2017,Massachusetts,2,4,6,0.3333333333333333
vs. BCS AQ,2017,Massachusetts,0,3,3,0.0
vs. BCS non-AQ,2017,Massachusetts,3,5,8,0.375
vs. FBS Power 5,2017,Massachusetts,0,2,2,0.0
vs. FBS non-Power 5,2017,Massachusetts,3,6,9,0.3333333333333333
in August/September,2017,Massachusetts,0,6,6,0.0
in October,2017,Massachusetts,2,0,2,1.0
in November,2017,Massachusetts,2,1,3,0.6666666666666666
in December/January,2017,Massachusetts,0,1,1,0.0
All Games,2018,Massachusetts,4,8,12,0.3333333333333333
at Home,2018,Massachusetts,3,3,6,0.5
on Road/Neutral Site,2018,Massachusetts,1,5,6,0.16666666666666666
vs. Conference,2018,Massachusetts,1,1,2,0.5
vs. Non-Conference,2018,Massachusetts,3,7,10,0.3
vs. Ranked (AP),2018,Massachusetts,0,1,1,0.0
vs. Unranked (AP),2018,Massachusetts,4,7,11,0.36363636363636365
vs. FBS (I-A),2018,Massachusetts,3,8,11,0.2727272727272727
vs. FCS (I-AA),2018,Massachusetts,1,0,1,1.0
vs. FBS Winning,2018,Massachusetts,0,7,7,0.0
vs. FBS Non-Winning,2018,Massachusetts,3,1,4,0.75
vs. BCS AQ,2018,Massachusetts,1,3,4,0.25
vs. BCS non-AQ,2018,Massachusetts,2,5,7,0.2857142857142857
vs. FBS Power 5,2018,Massachusetts,0,2,2,0.0
vs. FBS non-Power 5,2018,Massachusetts,3,6,9,0.3333333333333333
in August/September,2018,Massachusetts,2,4,6,0.3333333333333333
in October,2018,Massachusetts,1,2,3,0.3333333333333333
in November,2018,Massachusetts,1,2,3,0.3333333333333333
in December/January,2018,Massachusetts,0,0,0,
All Games,2019,Massachusetts,1,11,12,0.08333333333333333
at Home,2019,Massachusetts,1,5,6,0.16666666666666666
on Road/Neutral Site,2019,Massachusetts,0,6,6,0.0
vs. Conference,2019,Massachusetts,0,3,3,0.0
vs. Non-Conference,2019,Massachusetts,1,8,9,0.1111111111111111
vs. Ranked (AP),2019,Massachusetts,0,0,0,
vs. Unranked (AP),2019,Massachusetts,1,11,12,0.08333333333333333
vs. FBS (I-A),2019,Massachusetts,1,10,11,0.09090909090909091
vs. FCS (I-AA),2019,Massachusetts,0,1,1,0.0
vs. FBS Winning,2019,Massachusetts,0,4,4,0.0
vs. FBS Non-Winning,2019,Massachusetts,1,6,7,0.14285714285714285
vs. BCS AQ,2019,Massachusetts,0,3,3,0.0
vs. BCS non-AQ,2019,Massachusetts,1,7,8,0.125
vs. FBS Power 5,2019,Massachusetts,0,2,2,0.0
vs. FBS non-Power 5,2019,Massachusetts,1,8,9,0.1111111111111111
in August/September,2019,Massachusetts,1,4,5,0.2
in October,2019,Massachusetts,0,3,3,0.0
in November,2019,Massachusetts,0,4,4,0.0
in December/January,2019,Massachusetts,0,0,0,
All Games,2020,Massachusetts,0,4,4,0.0
at Home,2020,Massachusetts,0,0,0,
on Road/Neutral Site,2020,Massachusetts,0,4,4,0.0
vs. Conference,2020,Massachusetts,0,1,1,0.0
vs. Non-Conference,2020,Massachusetts,0,3,3,0.0
vs. Ranked (AP),2020,Massachusetts,0,1,1,0.0
vs. Unranked (AP),2020,Massachusetts,0,3,3,0.0
vs. FBS (I-A),2020,Massachusetts,0,4,4,0.0
vs. FCS (I-AA),2020,Massachusetts,0,0,0,
vs. FBS Winning,2020,Massachusetts,0,4,4,0.0
vs. FBS Non-Winning,2020,Massachusetts,0,0,0,
vs. BCS AQ,2020,Massachusetts,0,0,0,
vs. BCS non-AQ,2020,Massachusetts,0,4,4,0.0
vs. FBS Power 5,2020,Massachusetts,0,0,0,
vs. FBS non-Power 5,2020,Massachusetts,0,4,4,0.0
in August/September,2020,Massachusetts,0,0,0,
in October,2020,Massachusetts,0,1,1,0.0
in November,2020,Massachusetts,0,3,3,0.0
in December/January,2020,Massachusetts,0,0,0,
All Games,2021,Massachusetts,1,11,12,0.08333333333333333
at Home,2021,Massachusetts,1,5,6,0.16666666666666666
on Road/Neutral Site,2021,Massachusetts,0,6,6,0.0
vs. Conference,2021,Massachusetts,1,3,4,0.25
vs. Non-Conference,2021,Massachusetts,0,8,8,0.0
vs. Ranked (AP),2021,Massachusetts,0,1,1,0.0
vs. Unranked (AP),2021,Massachusetts,1,10,11,0.09090909090909091
vs. FBS (I-A),2021,Massachusetts,1,9,10,0.1
vs. FCS (I-AA),2021,Massachusetts,0,2,2,0.0
vs. FBS Winning,2021,Massachusetts,0,6,6,0.0
vs. FBS Non-Winning,2021,Massachusetts,1,3,4,0.25
vs. BCS AQ,2021,Massachusetts,0,3,3,0.0
vs. BCS non-AQ,2021,Massachusetts,1,6,7,0.14285714285714285
vs. FBS Power 5,2021,Massachusetts,0,3,3,0.0
vs. FBS non-Power 5,2021,Massachusetts,1,6,7,0.14285714285714285
in August/September,2021,Massachusetts,0,4,4,0.0
in October,2021,Massachusetts,1,3,4,0.25
in November,2021,Massachusetts,0,4,4,0.0
in December/January,2021,Massachusetts,0,0,0,
All Games,2022,Massachusetts,1,11,12,0.08333333333333333
at Home,2022,Massachusetts,1,4,5,0.2
on Road/Neutral Site,2022,Massachusetts,0,7,7,0.0
vs. Conference,2022,Massachusetts,0,4,4,0.0
vs. Non-Conference,2022,Massachusetts,1,7,8,0.125
vs. Ranked (AP),2022,Massachusetts,0,1,1,0.0
vs. Unranked (AP),2022,Massachusetts,1,10,11,0.09090909090909091
vs. FBS (I-A),2022,Massachusetts,0,11,11,0.0
vs. FCS (I-AA),2022,Massachusetts,1,0,1,1.0
vs. FBS Winning,2022,Massachusetts,0,6,6,0.0
vs. FBS Non-Winning,2022,Massachusetts,0,5,5,0.0
vs. BCS AQ,2022,Massachusetts,0,3,3,0.0
vs. BCS non-AQ,2022,Massachusetts,0,8,8,0.0
vs. FBS Power 5,2022,Massachusetts,0,1,1,0.0
vs. FBS non-Power 5,2022,Massachusetts,0,10,10,0.0
in August/September,2022,Massachusetts,1,3,4,0.25
in October,2022,Massachusetts,0,4,4,0.0
in November,2022,Massachusetts,0,4,4,0.0
in December/January,2022,Massachusetts,0,0,0,
All Games,2009,Memphis,2,10,12,0.16666666666666666
at Home,2009,Memphis,2,4,6,0.3333333333333333
on Road/Neutral Site,2009,Memphis,0,6,6,0.0
vs. Conference,2009,Memphis,1,7,8,0.125
vs. Non-Conference,2009,Memphis,1,3,4,0.25
vs. Ranked (AP),2009,Memphis,0,1,1,0.0
vs. Unranked (AP),2009,Memphis,2,9,11,0.18181818181818182
vs. FBS (I-A),2009,Memphis,1,10,11,0.09090909090909091
vs. FCS (I-AA),2009,Memphis,1,0,1,1.0
vs. FBS Winning,2009,Memphis,0,8,8,0.0
vs. FBS Non-Winning,2009,Memphis,1,2,3,0.3333333333333333
vs. BCS AQ,2009,Memphis,0,2,2,0.0
vs. BCS non-AQ,2009,Memphis,1,8,9,0.1111111111111111
vs. FBS Power 5,2009,Memphis,0,2,2,0.0
vs. FBS non-Power 5,2009,Memphis,1,8,9,0.1111111111111111
in August/September,2009,Memphis,1,3,4,0.25
in October,2009,Memphis,1,3,4,0.25
in November,2009,Memphis,0,4,4,0.0
in December/January,2009,Memphis,0,0,0,
All Games,2010,Memphis,1,11,12,0.08333333333333333
at Home,2010,Memphis,1,5,6,0.16666666666666666
on Road/Neutral Site,2010,Memphis,0,6,6,0.0
vs. Conference,2010,Memphis,0,8,8,0.0
vs. Non-Conference,2010,Memphis,1,3,4,0.25
vs. Ranked (AP),2010,Memphis,0,3,3,0.0
vs. Unranked (AP),2010,Memphis,1,8,9,0.1111111111111111
vs. FBS (I-A),2010,Memphis,1,11,12,0.08333333333333333
vs. FCS (I-AA),2010,Memphis,0,0,0,
vs. FBS Winning,2010,Memphis,0,5,5,0.0
vs. FBS Non-Winning,2010,Memphis,1,6,7,0.14285714285714285
vs. BCS AQ,2010,Memphis,0,3,3,0.0
vs. BCS non-AQ,2010,Memphis,1,8,9,0.1111111111111111
vs. FBS Power 5,2010,Memphis,0,2,2,0.0
vs. FBS non-Power 5,2010,Memphis,1,9,10,0.1
in August/September,2010,Memphis,1,3,4,0.25
in October,2010,Memphis,0,4,4,0.0
in November,2010,Memphis,0,4,4,0.0
in December/January,2010,Memphis,0,0,0,
All Games,2011,Memphis,2,10,12,0.16666666666666666
at Home,2011,Memphis,1,5,6,0.16666666666666666
on Road/Neutral Site,2011,Memphis,1,5,6,0.16666666666666666
vs. Conference,2011,Memphis,1,7,8,0.125
vs. Non-Conference,2011,Memphis,1,3,4,0.25
vs. Ranked (AP),2011,Memphis,0,1,1,0.0
vs. Unranked (AP),2011,Memphis,2,9,11,0.18181818181818182
vs. FBS (I-A),2011,Memphis,1,10,11,0.09090909090909091
vs. FCS (I-AA),2011,Memphis,1,0,1,1.0
vs. FBS Winning,2011,Memphis,0,5,5,0.0
vs. FBS Non-Winning,2011,Memphis,1,5,6,0.16666666666666666
vs. BCS AQ,2011,Memphis,0,1,1,0.0
vs. BCS non-AQ,2011,Memphis,1,9,10,0.1
vs. FBS Power 5,2011,Memphis,0,1,1,0.0
vs. FBS non-Power 5,2011,Memphis,1,9,10,0.1
in August/September,2011,Memphis,1,3,4,0.25
in October,2011,Memphis,1,4,5,0.2
in November,2011,Memphis,0,3,3,0.0
in December/January,2011,Memphis,0,0,0,
All Games,2012,Memphis,4,8,12,0.3333333333333333
at Home,2012,Memphis,3,3,6,0.5
on Road/Neutral Site,2012,Memphis,1,5,6,0.16666666666666666
vs. Conference,2012,Memphis,4,4,8,0.5
vs. Non-Conference,2012,Memphis,0,4,4,0.0
vs. Ranked (AP),2012,Memphis,0,0,0,
vs. Unranked (AP),2012,Memphis,4,8,12,0.3333333333333333
vs. FBS (I-A),2012,Memphis,4,7,11,0.36363636363636365
vs. FCS (I-AA),2012,Memphis,0,1,1,0.0
vs. FBS Winning,2012,Memphis,1,5,6,0.16666666666666666
vs. FBS Non-Winning,2012,Memphis,3,2,5,0.6
vs. BCS AQ,2012,Memphis,0,1,1,0.0
vs. BCS non-AQ,2012,Memphis,4,6,10,0.4
vs. FBS Power 5,2012,Memphis,0,1,1,0.0
vs. FBS non-Power 5,2012,Memphis,4,6,10,0.4
in August/September,2012,Memphis,0,4,4,0.0
in October,2012,Memphis,1,3,4,0.25
in November,2012,Memphis,3,1,4,0.75
in December/January,2012,Memphis,0,0,0,
All Games,2013,Memphis,3,9,12,0.25
at Home,2013,Memphis,2,5,7,0.2857142857142857
on Road/Neutral Site,2013,Memphis,1,4,5,0.2
vs. Conference,2013,Memphis,1,7,8,0.125
vs. Non-Conference,2013,Memphis,2,2,4,0.5
vs. Ranked (AP),2013,Memphis,0,3,3,0.0
vs. Unranked (AP),2013,Memphis,3,6,9,0.3333333333333333
vs. FBS (I-A),2013,Memphis,2,9,11,0.18181818181818182
vs. FCS (I-AA),2013,Memphis,1,0,1,1.0
vs. FBS Winning,2013,Memphis,1,6,7,0.14285714285714285
vs. FBS Non-Winning,2013,Memphis,1,3,4,0.25
vs. BCS AQ,2013,Memphis,1,8,9,0.1111111111111111
vs. BCS non-AQ,2013,Memphis,1,1,2,0.5
vs. FBS Power 5,2013,Memphis,0,1,1,0.0
vs. FBS non-Power 5,2013,Memphis,2,8,10,0.2
in August/September,2013,Memphis,1,2,3,0.3333333333333333
in October,2013,Memphis,0,4,4,0.0
in November,2013,Memphis,2,2,4,0.5
in December/January,2013,Memphis,0,1,1,0.0
All Games,2014,Memphis,10,3,13,0.7692307692307693
at Home,2014,Memphis,5,1,6,0.8333333333333334
on Road/Neutral Site,2014,Memphis,5,2,7,0.7142857142857143
vs. Conference,2014,Memphis,7,1,8,0.875
vs. Non-Conference,2014,Memphis,3,2,5,0.6
vs. Ranked (AP),2014,Memphis,0,2,2,0.0
vs. Unranked (AP),2014,Memphis,10,1,11,0.9090909090909091
vs. FBS (I-A),2014,Memphis,9,3,12,0.75
vs. FCS (I-AA),2014,Memphis,1,0,1,1.0
vs. FBS Winning,2014,Memphis,2,3,5,0.4
vs. FBS Non-Winning,2014,Memphis,7,0,7,1.0
vs. BCS AQ,2014,Memphis,7,3,10,0.7
vs. BCS non-AQ,2014,Memphis,2,0,2,1.0
vs. FBS Power 5,2014,Memphis,0,2,2,0.0
vs. FBS non-Power 5,2014,Memphis,9,1,10,0.9
in August/September,2014,Memphis,2,2,4,0.5
in October,2014,Memphis,3,1,4,0.75
in November,2014,Memphis,4,0,4,1.0
in December/January,2014,Memphis,1,0,1,1.0
All Games,2015,Memphis,9,4,13,0.6923076923076923
at Home,2015,Memphis,5,1,6,0.8333333333333334
on Road/Neutral Site,2015,Memphis,4,3,7,0.5714285714285714
vs. Conference,2015,Memphis,5,3,8,0.625
vs. Non-Conference,2015,Memphis,4,1,5,0.8
vs. Ranked (AP),2015,Memphis,1,2,3,0.3333333333333333
vs. Unranked (AP),2015,Memphis,8,2,10,0.8
vs. FBS (I-A),2015,Memphis,8,4,12,0.6666666666666666
vs. FCS (I-AA),2015,Memphis,1,0,1,1.0
vs. FBS Winning,2015,Memphis,4,4,8,0.5
vs. FBS Non-Winning,2015,Memphis,4,0,4,1.0
vs. BCS AQ,2015,Memphis,7,4,11,0.6363636363636364
vs. BCS non-AQ,2015,Memphis,1,0,1,1.0
vs. FBS Power 5,2015,Memphis,2,1,3,0.6666666666666666
vs. FBS non-Power 5,2015,Memphis,6,3,9,0.6666666666666666
in August/September,2015,Memphis,4,0,4,1.0
in October,2015,Memphis,4,0,4,1.0
in November,2015,Memphis,1,3,4,0.25
in December/January,2015,Memphis,0,1,1,0.0
All Games,2016,Memphis,8,5,13,0.6153846153846154
at Home,2016,Memphis,5,2,7,0.7142857142857143
on Road/Neutral Site,2016,Memphis,3,3,6,0.5
vs. Conference,2016,Memphis,5,3,8,0.625
vs. Non-Conference,2016,Memphis,3,2,5,0.6
vs. Ranked (AP),2016,Memphis,1,1,2,0.5
vs. Unranked (AP),2016,Memphis,7,4,11,0.6363636363636364
vs. FBS (I-A),2016,Memphis,7,5,12,0.5833333333333334
vs. FCS (I-AA),2016,Memphis,1,0,1,1.0
vs. FBS Winning,2016,Memphis,2,4,6,0.3333333333333333
vs. FBS Non-Winning,2016,Memphis,5,1,6,0.8333333333333334
vs. BCS AQ,2016,Memphis,6,4,10,0.6
vs. BCS non-AQ,2016,Memphis,1,1,2,0.5
vs. FBS Power 5,2016,Memphis,1,1,2,0.5
vs. FBS non-Power 5,2016,Memphis,6,4,10,0.6
in August/September,2016,Memphis,3,0,3,1.0
in October,2016,Memphis,2,3,5,0.4
in November,2016,Memphis,3,1,4,0.75
in December/January,2016,Memphis,0,1,1,0.0
All Games,2017,Memphis,10,3,13,0.7692307692307693
at Home,2017,Memphis,7,1,8,0.875
on Road/Neutral Site,2017,Memphis,3,2,5,0.6
vs. Conference,2017,Memphis,7,2,9,0.7777777777777778
vs. Non-Conference,2017,Memphis,3,1,4,0.75
vs. Ranked (AP),2017,Memphis,0,2,2,0.0
vs. Unranked (AP),2017,Memphis,10,1,11,0.9090909090909091
vs. FBS (I-A),2017,Memphis,9,3,12,0.75
vs. FCS (I-AA),2017,Memphis,1,0,1,1.0
vs. FBS Winning,2017,Memphis,3,3,6,0.5
vs. FBS Non-Winning,2017,Memphis,6,0,6,1.0
vs. BCS AQ,2017,Memphis,8,3,11,0.7272727272727273
vs. BCS non-AQ,2017,Memphis,1,0,1,1.0
vs. FBS Power 5,2017,Memphis,1,1,2,0.5
vs. FBS non-Power 5,2017,Memphis,8,2,10,0.8
in August/September,2017,Memphis,3,1,4,0.75
in October,2017,Memphis,4,0,4,1.0
in November,2017,Memphis,3,0,3,1.0
in December/January,2017,Memphis,0,2,2,0.0
All Games,2018,Memphis,8,6,14,0.5714285714285714
at Home,2018,Memphis,6,1,7,0.8571428571428571
on Road/Neutral Site,2018,Memphis,2,5,7,0.2857142857142857
vs. Conference,2018,Memphis,5,4,9,0.5555555555555556
vs. Non-Conference,2018,Memphis,3,2,5,0.6
vs. Ranked (AP),2018,Memphis,0,2,2,0.0
vs. Unranked (AP),2018,Memphis,8,4,12,0.6666666666666666
vs. FBS (I-A),2018,Memphis,7,6,13,0.5384615384615384
vs. FCS (I-AA),2018,Memphis,1,0,1,1.0
vs. FBS Winning,2018,Memphis,1,5,6,0.16666666666666666
vs. FBS Non-Winning,2018,Memphis,6,1,7,0.8571428571428571
vs. BCS AQ,2018,Memphis,5,6,11,0.45454545454545453
vs. BCS non-AQ,2018,Memphis,2,0,2,1.0
vs. FBS Power 5,2018,Memphis,0,2,2,0.0
vs. FBS non-Power 5,2018,Memphis,7,4,11,0.6363636363636364
in August/September,2018,Memphis,3,2,5,0.6
in October,2018,Memphis,1,2,3,0.3333333333333333
in November,2018,Memphis,4,0,4,1.0
in December/January,2018,Memphis,0,2,2,0.0
All Games,2019,Memphis,12,2,14,0.8571428571428571
at Home,2019,Memphis,7,0,7,1.0
on Road/Neutral Site,2019,Memphis,5,2,7,0.7142857142857143
vs. Conference,2019,Memphis,8,1,9,0.8888888888888888
vs. Non-Conference,2019,Memphis,4,1,5,0.8
vs. Ranked (AP),2019,Memphis,3,1,4,0.75
vs. Unranked (AP),2019,Memphis,9,1,10,0.9
vs. FBS (I-A),2019,Memphis,11,2,13,0.8461538461538461
vs. FCS (I-AA),2019,Memphis,1,0,1,1.0
vs. FBS Winning,2019,Memphis,5,2,7,0.7142857142857143
vs. FBS Non-Winning,2019,Memphis,6,0,6,1.0
vs. BCS AQ,2019,Memphis,9,2,11,0.8181818181818182
vs. BCS non-AQ,2019,Memphis,2,0,2,1.0
vs. FBS Power 5,2019,Memphis,1,1,2,0.5
vs. FBS non-Power 5,2019,Memphis,10,1,11,0.9090909090909091
in August/September,2019,Memphis,4,0,4,1.0
in October,2019,Memphis,3,1,4,0.75
in November,2019,Memphis,4,0,4,1.0
in December/January,2019,Memphis,1,1,2,0.5
All Games,2020,Memphis,8,3,11,0.7272727272727273
at Home,2020,Memphis,6,0,6,1.0
on Road/Neutral Site,2020,Memphis,2,3,5,0.4
vs. Conference,2020,Memphis,5,3,8,0.625
vs. Non-Conference,2020,Memphis,3,0,3,1.0
vs. Ranked (AP),2020,Memphis,0,1,1,0.0
vs. Unranked (AP),2020,Memphis,8,2,10,0.8
vs. FBS (I-A),2020,Memphis,7,3,10,0.7
vs. FCS (I-AA),2020,Memphis,1,0,1,1.0
vs. FBS Winning,2020,Memphis,2,2,4,0.5
vs. FBS Non-Winning,2020,Memphis,5,1,6,0.8333333333333334
vs. BCS AQ,2020,Memphis,5,3,8,0.625
vs. BCS non-AQ,2020,Memphis,2,0,2,1.0
vs. FBS Power 5,2020,Memphis,0,0,0,
vs. FBS non-Power 5,2020,Memphis,7,3,10,0.7
in August/September,2020,Memphis,1,0,1,1.0
in October,2020,Memphis,2,2,4,0.5
in November,2020,Memphis,3,0,3,1.0
in December/January,2020,Memphis,2,1,3,0.6666666666666666
All Games,2021,Memphis,6,6,12,0.5
at Home,2021,Memphis,5,2,7,0.7142857142857143
on Road/Neutral Site,2021,Memphis,1,4,5,0.2
vs. Conference,2021,Memphis,3,5,8,0.375
vs. Non-Conference,2021,Memphis,3,1,4,0.75
vs. Ranked (AP),2021,Memphis,0,1,1,0.0
vs. Unranked (AP),2021,Memphis,6,5,11,0.5454545454545454
vs. FBS (I-A),2021,Memphis,5,6,11,0.45454545454545453
vs. FCS (I-AA),2021,Memphis,1,0,1,1.0
vs. FBS Winning,2021,Memphis,2,5,7,0.2857142857142857
vs. FBS Non-Winning,2021,Memphis,3,1,4,0.75
vs. BCS AQ,2021,Memphis,4,5,9,0.4444444444444444
vs. BCS non-AQ,2021,Memphis,1,1,2,0.5
vs. FBS Power 5,2021,Memphis,1,0,1,1.0
vs. FBS non-Power 5,2021,Memphis,4,6,10,0.4
in August/September,2021,Memphis,3,1,4,0.75
in October,2021,Memphis,1,3,4,0.25
in November,2021,Memphis,2,2,4,0.5
in December/January,2021,Memphis,0,0,0,
All Games,2022,Memphis,7,6,13,0.5384615384615384
at Home,2022,Memphis,5,2,7,0.7142857142857143
on Road/Neutral Site,2022,Memphis,2,4,6,0.3333333333333333
vs. Conference,2022,Memphis,3,5,8,0.375
vs. Non-Conference,2022,Memphis,4,1,5,0.8
vs. Ranked (AP),2022,Memphis,0,2,2,0.0
vs. Unranked (AP),2022,Memphis,7,4,11,0.6363636363636364
vs. FBS (I-A),2022,Memphis,6,6,12,0.5
vs. FCS (I-AA),2022,Memphis,1,0,1,1.0
vs. FBS Winning,2022,Memphis,0,6,6,0.0
vs. FBS Non-Winning,2022,Memphis,6,0,6,1.0
vs. BCS AQ,2022,Memphis,3,6,9,0.3333333333333333
vs. BCS non-AQ,2022,Memphis,3,0,3,1.0
vs. FBS Power 5,2022,Memphis,0,1,1,0.0
vs. FBS non-Power 5,2022,Memphis,6,5,11,0.5454545454545454
in August/September,2022,Memphis,3,1,4,0.75
in October,2022,Memphis,1,3,4,0.25
in November,2022,Memphis,2,2,4,0.5
in December/January,2022,Memphis,1,0,1,1.0
All Games,2009,Miami (Florida),9,4,13,0.6923076923076923
at Home,2009,Miami (Florida),5,1,6,0.8333333333333334
on Road/Neutral Site,2009,Miami (Florida),4,3,7,0.5714285714285714
vs. Conference,2009,Miami (Florida),5,3,8,0.625
vs. Non-Conference,2009,Miami (Florida),4,1,5,0.8
vs. Ranked (AP),2009,Miami (Florida),1,3,4,0.25
vs. Unranked (AP),2009,Miami (Florida),8,1,9,0.8888888888888888
vs. FBS (I-A),2009,Miami (Florida),8,4,12,0.6666666666666666
vs. FCS (I-AA),2009,Miami (Florida),1,0,1,1.0
vs. FBS Winning,2009,Miami (Florida),5,4,9,0.5555555555555556
vs. FBS Non-Winning,2009,Miami (Florida),3,0,3,1.0
vs. BCS AQ,2009,Miami (Florida),7,4,11,0.6363636363636364
vs. BCS non-AQ,2009,Miami (Florida),1,0,1,1.0
vs. FBS Power 5,2009,Miami (Florida),6,4,10,0.6
vs. FBS non-Power 5,2009,Miami (Florida),2,0,2,1.0
in August/September,2009,Miami (Florida),2,1,3,0.6666666666666666
in October,2009,Miami (Florida),4,1,5,0.8
in November,2009,Miami (Florida),3,1,4,0.75
in December/January,2009,Miami (Florida),0,1,1,0.0
All Games,2010,Miami (Florida),7,6,13,0.5384615384615384
at Home,2010,Miami (Florida),3,3,6,0.5
on Road/Neutral Site,2010,Miami (Florida),4,3,7,0.5714285714285714
vs. Conference,2010,Miami (Florida),5,3,8,0.625
vs. Non-Conference,2010,Miami (Florida),2,3,5,0.4
vs. Ranked (AP),2010,Miami (Florida),1,3,4,0.25
vs. Unranked (AP),2010,Miami (Florida),6,3,9,0.6666666666666666
vs. FBS (I-A),2010,Miami (Florida),6,6,12,0.5
vs. FCS (I-AA),2010,Miami (Florida),1,0,1,1.0
vs. FBS Winning,2010,Miami (Florida),3,5,8,0.375
vs. FBS Non-Winning,2010,Miami (Florida),3,1,4,0.75
vs. BCS AQ,2010,Miami (Florida),6,6,12,0.5
vs. BCS non-AQ,2010,Miami (Florida),0,0,0,
vs. FBS Power 5,2010,Miami (Florida),5,4,9,0.5555555555555556
vs. FBS non-Power 5,2010,Miami (Florida),1,2,3,0.3333333333333333
in August/September,2010,Miami (Florida),2,1,3,0.6666666666666666
in October,2010,Miami (Florida),3,2,5,0.6
in November,2010,Miami (Florida),2,2,4,0.5
in December/January,2010,Miami (Florida),0,1,1,0.0
All Games,2011,Miami (Florida),6,6,12,0.5
at Home,2011,Miami (Florida),4,3,7,0.5714285714285714
on Road/Neutral Site,2011,Miami (Florida),2,3,5,0.4
vs. Conference,2011,Miami (Florida),3,5,8,0.375
vs. Non-Conference,2011,Miami (Florida),3,1,4,0.75
vs. Ranked (AP),2011,Miami (Florida),0,3,3,0.0
vs. Unranked (AP),2011,Miami (Florida),6,3,9,0.6666666666666666
vs. FBS (I-A),2011,Miami (Florida),5,6,11,0.45454545454545453
vs. FCS (I-AA),2011,Miami (Florida),1,0,1,1.0
vs. FBS Winning,2011,Miami (Florida),2,4,6,0.3333333333333333
vs. FBS Non-Winning,2011,Miami (Florida),3,2,5,0.6
vs. BCS AQ,2011,Miami (Florida),5,6,11,0.45454545454545453
vs. BCS non-AQ,2011,Miami (Florida),0,0,0,
vs. FBS Power 5,2011,Miami (Florida),4,6,10,0.4
vs. FBS non-Power 5,2011,Miami (Florida),1,0,1,1.0
in August/September,2011,Miami (Florida),1,2,3,0.3333333333333333
in October,2011,Miami (Florida),3,2,5,0.6
in November,2011,Miami (Florida),2,2,4,0.5
in December/January,2011,Miami (Florida),0,0,0,
All Games,2012,Miami (Florida),7,5,12,0.5833333333333334
at Home,2012,Miami (Florida),4,2,6,0.6666666666666666
on Road/Neutral Site,2012,Miami (Florida),3,3,6,0.5
vs. Conference,2012,Miami (Florida),5,3,8,0.625
vs. Non-Conference,2012,Miami (Florida),2,2,4,0.5
vs. Ranked (AP),2012,Miami (Florida),0,3,3,0.0
vs. Unranked (AP),2012,Miami (Florida),7,2,9,0.7777777777777778
vs. FBS (I-A),2012,Miami (Florida),6,5,11,0.5454545454545454
vs. FCS (I-AA),2012,Miami (Florida),1,0,1,1.0
vs. FBS Winning,2012,Miami (Florida),2,4,6,0.3333333333333333
vs. FBS Non-Winning,2012,Miami (Florida),4,1,5,0.8
vs. BCS AQ,2012,Miami (Florida),6,5,11,0.5454545454545454
vs. BCS non-AQ,2012,Miami (Florida),0,0,0,
vs. FBS Power 5,2012,Miami (Florida),5,4,9,0.5555555555555556
vs. FBS non-Power 5,2012,Miami (Florida),1,1,2,0.5
in August/September,2012,Miami (Florida),4,1,5,0.8
in October,2012,Miami (Florida),0,3,3,0.0
in November,2012,Miami (Florida),3,1,4,0.75
in December/January,2012,Miami (Florida),0,0,0,
All Games,2013,Miami (Florida),9,4,13,0.6923076923076923
at Home,2013,Miami (Florida),6,1,7,0.8571428571428571
on Road/Neutral Site,2013,Miami (Florida),3,3,6,0.5
vs. Conference,2013,Miami (Florida),5,3,8,0.625
vs. Non-Conference,2013,Miami (Florida),4,1,5,0.8
vs. Ranked (AP),2013,Miami (Florida),0,3,3,0.0
vs. Unranked (AP),2013,Miami (Florida),9,1,10,0.9
vs. FBS (I-A),2013,Miami (Florida),8,4,12,0.6666666666666666
vs. FCS (I-AA),2013,Miami (Florida),1,0,1,1.0
vs. FBS Winning,2013,Miami (Florida),3,4,7,0.42857142857142855
vs. FBS Non-Winning,2013,Miami (Florida),5,0,5,1.0
vs. BCS AQ,2013,Miami (Florida),7,4,11,0.6363636363636364
vs. BCS non-AQ,2013,Miami (Florida),1,0,1,1.0
vs. FBS Power 5,2013,Miami (Florida),6,3,9,0.6666666666666666
vs. FBS non-Power 5,2013,Miami (Florida),2,1,3,0.6666666666666666
in August/September,2013,Miami (Florida),4,0,4,1.0
in October,2013,Miami (Florida),3,0,3,1.0
in November,2013,Miami (Florida),2,3,5,0.4
in December/January,2013,Miami (Florida),0,1,1,0.0
All Games,2014,Miami (Florida),6,7,13,0.46153846153846156
at Home,2014,Miami (Florida),5,2,7,0.7142857142857143
on Road/Neutral Site,2014,Miami (Florida),1,5,6,0.16666666666666666
vs. Conference,2014,Miami (Florida),3,5,8,0.375
vs. Non-Conference,2014,Miami (Florida),3,2,5,0.6
vs. Ranked (AP),2014,Miami (Florida),0,3,3,0.0
vs. Unranked (AP),2014,Miami (Florida),6,4,10,0.6
vs. FBS (I-A),2014,Miami (Florida),5,7,12,0.4166666666666667
vs. FCS (I-AA),2014,Miami (Florida),1,0,1,1.0
vs. FBS Winning,2014,Miami (Florida),4,5,9,0.4444444444444444
vs. FBS Non-Winning,2014,Miami (Florida),1,2,3,0.3333333333333333
vs. BCS AQ,2014,Miami (Florida),4,7,11,0.36363636363636365
vs. BCS non-AQ,2014,Miami (Florida),1,0,1,1.0
vs. FBS Power 5,2014,Miami (Florida),3,7,10,0.3
vs. FBS non-Power 5,2014,Miami (Florida),2,0,2,1.0
in August/September,2014,Miami (Florida),3,2,5,0.6
in October,2014,Miami (Florida),2,1,3,0.6666666666666666
in November,2014,Miami (Florida),1,3,4,0.25
in December/January,2014,Miami (Florida),0,1,1,0.0
All Games,2015,Miami (Florida),8,5,13,0.6153846153846154
at Home,2015,Miami (Florida),5,1,6,0.8333333333333334
on Road/Neutral Site,2015,Miami (Florida),3,4,7,0.42857142857142855
vs. Conference,2015,Miami (Florida),5,3,8,0.625
vs. Non-Conference,2015,Miami (Florida),3,2,5,0.6
vs. Ranked (AP),2015,Miami (Florida),0,3,3,0.0
vs. Unranked (AP),2015,Miami (Florida),8,2,10,0.8
vs. FBS (I-A),2015,Miami (Florida),7,5,12,0.5833333333333334
vs. FCS (I-AA),2015,Miami (Florida),1,0,1,1.0
vs. FBS Winning,2015,Miami (Florida),3,5,8,0.375
vs. FBS Non-Winning,2015,Miami (Florida),4,0,4,1.0
vs. BCS AQ,2015,Miami (Florida),6,5,11,0.5454545454545454
vs. BCS non-AQ,2015,Miami (Florida),1,0,1,1.0
vs. FBS Power 5,2015,Miami (Florida),6,4,10,0.6
vs. FBS non-Power 5,2015,Miami (Florida),1,1,2,0.5
in August/September,2015,Miami (Florida),3,0,3,1.0
in October,2015,Miami (Florida),2,3,5,0.4
in November,2015,Miami (Florida),3,1,4,0.75
in December/January,2015,Miami (Florida),0,1,1,0.0
All Games,2016,Miami (Florida),9,4,13,0.6923076923076923
at Home,2016,Miami (Florida),4,2,6,0.6666666666666666
on Road/Neutral Site,2016,Miami (Florida),5,2,7,0.7142857142857143
vs. Conference,2016,Miami (Florida),5,3,8,0.625
vs. Non-Conference,2016,Miami (Florida),4,1,5,0.8
vs. Ranked (AP),2016,Miami (Florida),2,2,4,0.5
vs. Unranked (AP),2016,Miami (Florida),7,2,9,0.7777777777777778
vs. FBS (I-A),2016,Miami (Florida),8,4,12,0.6666666666666666
vs. FCS (I-AA),2016,Miami (Florida),1,0,1,1.0
vs. FBS Winning,2016,Miami (Florida),5,3,8,0.625
vs. FBS Non-Winning,2016,Miami (Florida),3,1,4,0.75
vs. BCS AQ,2016,Miami (Florida),6,4,10,0.6
vs. BCS non-AQ,2016,Miami (Florida),2,0,2,1.0
vs. FBS Power 5,2016,Miami (Florida),6,3,9,0.6666666666666666
vs. FBS non-Power 5,2016,Miami (Florida),2,1,3,0.6666666666666666
in August/September,2016,Miami (Florida),3,0,3,1.0
in October,2016,Miami (Florida),1,4,5,0.2
in November,2016,Miami (Florida),4,0,4,1.0
in December/January,2016,Miami (Florida),1,0,1,1.0
All Games,2017,Miami (Florida),10,3,13,0.7692307692307693
at Home,2017,Miami (Florida),7,1,8,0.875
on Road/Neutral Site,2017,Miami (Florida),3,2,5,0.6
vs. Conference,2017,Miami (Florida),7,2,9,0.7777777777777778
vs. Non-Conference,2017,Miami (Florida),3,1,4,0.75
vs. Ranked (AP),2017,Miami (Florida),2,2,4,0.5
vs. Unranked (AP),2017,Miami (Florida),8,1,9,0.8888888888888888
vs. FBS (I-A),2017,Miami (Florida),9,3,12,0.75
vs. FCS (I-AA),2017,Miami (Florida),1,0,1,1.0
vs. FBS Winning,2017,Miami (Florida),5,2,7,0.7142857142857143
vs. FBS Non-Winning,2017,Miami (Florida),4,1,5,0.8
vs. BCS AQ,2017,Miami (Florida),8,3,11,0.7272727272727273
vs. BCS non-AQ,2017,Miami (Florida),1,0,1,1.0
vs. FBS Power 5,2017,Miami (Florida),7,3,10,0.7
vs. FBS non-Power 5,2017,Miami (Florida),2,0,2,1.0
in August/September,2017,Miami (Florida),3,0,3,1.0
in October,2017,Miami (Florida),4,0,4,1.0
in November,2017,Miami (Florida),3,1,4,0.75
in December/January,2017,Miami (Florida),0,2,2,0.0
All Games,2018,Miami (Florida),7,6,13,0.5384615384615384
at Home,2018,Miami (Florida),5,1,6,0.8333333333333334
on Road/Neutral Site,2018,Miami (Florida),2,5,7,0.2857142857142857
vs. Conference,2018,Miami (Florida),4,4,8,0.5
vs. Non-Conference,2018,Miami (Florida),3,2,5,0.6
vs. Ranked (AP),2018,Miami (Florida),0,1,1,0.0
vs. Unranked (AP),2018,Miami (Florida),7,5,12,0.5833333333333334
vs. FBS (I-A),2018,Miami (Florida),6,6,12,0.5
vs. FCS (I-AA),2018,Miami (Florida),1,0,1,1.0
vs. FBS Winning,2018,Miami (Florida),2,6,8,0.25
vs. FBS Non-Winning,2018,Miami (Florida),4,0,4,1.0
vs. BCS AQ,2018,Miami (Florida),4,6,10,0.4
vs. BCS non-AQ,2018,Miami (Florida),2,0,2,1.0
vs. FBS Power 5,2018,Miami (Florida),4,6,10,0.4
vs. FBS non-Power 5,2018,Miami (Florida),2,0,2,1.0
in August/September,2018,Miami (Florida),4,1,5,0.8
in October,2018,Miami (Florida),1,2,3,0.3333333333333333
in November,2018,Miami (Florida),2,2,4,0.5
in December/January,2018,Miami (Florida),0,1,1,0.0
All Games,2019,Miami (Florida),6,7,13,0.46153846153846156
at Home,2019,Miami (Florida),4,2,6,0.6666666666666666
on Road/Neutral Site,2019,Miami (Florida),2,5,7,0.2857142857142857
vs. Conference,2019,Miami (Florida),4,4,8,0.5
vs. Non-Conference,2019,Miami (Florida),2,3,5,0.4
vs. Ranked (AP),2019,Miami (Florida),0,1,1,0.0
vs. Unranked (AP),2019,Miami (Florida),6,6,12,0.5
vs. FBS (I-A),2019,Miami (Florida),5,7,12,0.4166666666666667
vs. FCS (I-AA),2019,Miami (Florida),1,0,1,1.0
vs. FBS Winning,2019,Miami (Florida),4,4,8,0.5
vs. FBS Non-Winning,2019,Miami (Florida),1,3,4,0.25
vs. BCS AQ,2019,Miami (Florida),4,5,9,0.4444444444444444
vs. BCS non-AQ,2019,Miami (Florida),1,2,3,0.3333333333333333
vs. FBS Power 5,2019,Miami (Florida),4,5,9,0.4444444444444444
vs. FBS non-Power 5,2019,Miami (Florida),1,2,3,0.3333333333333333
in August/September,2019,Miami (Florida),2,2,4,0.5
in October,2019,Miami (Florida),2,2,4,0.5
in November,2019,Miami (Florida),2,2,4,0.5
in December/January,2019,Miami (Florida),0,1,1,0.0
All Games,2020,Miami (Florida),8,3,11,0.7272727272727273
at Home,2020,Miami (Florida),4,1,5,0.8
on Road/Neutral Site,2020,Miami (Florida),4,2,6,0.6666666666666666
vs. Conference,2020,Miami (Florida),7,2,9,0.7777777777777778
vs. Non-Conference,2020,Miami (Florida),1,1,2,0.5
vs. Ranked (AP),2020,Miami (Florida),1,2,3,0.3333333333333333
vs. Unranked (AP),2020,Miami (Florida),7,1,8,0.875
vs. FBS (I-A),2020,Miami (Florida),8,3,11,0.7272727272727273
vs. FCS (I-AA),2020,Miami (Florida),0,0,0,
vs. FBS Winning,2020,Miami (Florida),3,3,6,0.5
vs. FBS Non-Winning,2020,Miami (Florida),5,0,5,1.0
vs. BCS AQ,2020,Miami (Florida),7,3,10,0.7
vs. BCS non-AQ,2020,Miami (Florida),1,0,1,1.0
vs. FBS Power 5,2020,Miami (Florida),7,3,10,0.7
vs. FBS non-Power 5,2020,Miami (Florida),1,0,1,1.0
in August/September,2020,Miami (Florida),3,0,3,1.0
in October,2020,Miami (Florida),2,1,3,0.6666666666666666
in November,2020,Miami (Florida),2,0,2,1.0
in December/January,2020,Miami (Florida),1,2,3,0.3333333333333333
All Games,2021,Miami (Florida),7,5,12,0.5833333333333334
at Home,2021,Miami (Florida),5,2,7,0.7142857142857143
on Road/Neutral Site,2021,Miami (Florida),2,3,5,0.4
vs. Conference,2021,Miami (Florida),5,3,8,0.625
vs. Non-Conference,2021,Miami (Florida),2,2,4,0.5
vs. Ranked (AP),2021,Miami (Florida),2,2,4,0.5
vs. Unranked (AP),2021,Miami (Florida),5,3,8,0.625
vs. FBS (I-A),2021,Miami (Florida),6,5,11,0.5454545454545454
vs. FCS (I-AA),2021,Miami (Florida),1,0,1,1.0
vs. FBS Winning,2021,Miami (Florida),3,2,5,0.6
vs. FBS Non-Winning,2021,Miami (Florida),3,3,6,0.5
vs. BCS AQ,2021,Miami (Florida),5,5,10,0.5
vs. BCS non-AQ,2021,Miami (Florida),1,0,1,1.0
vs. FBS Power 5,2021,Miami (Florida),5,5,10,0.5
vs. FBS non-Power 5,2021,Miami (Florida),1,0,1,1.0
in August/September,2021,Miami (Florida),2,3,5,0.4
in October,2021,Miami (Florida),2,1,3,0.6666666666666666
in November,2021,Miami (Florida),3,1,4,0.75
in December/January,2021,Miami (Florida),0,0,0,
All Games,2022,Miami (Florida),5,7,12,0.4166666666666667
at Home,2022,Miami (Florida),2,5,7,0.2857142857142857
on Road/Neutral Site,2022,Miami (Florida),3,2,5,0.6
vs. Conference,2022,Miami (Florida),3,5,8,0.375
vs. Non-Conference,2022,Miami (Florida),2,2,4,0.5
vs. Ranked (AP),2022,Miami (Florida),0,3,3,0.0
vs. Unranked (AP),2022,Miami (Florida),5,4,9,0.5555555555555556
vs. FBS (I-A),2022,Miami (Florida),4,7,11,0.36363636363636365
vs. FCS (I-AA),2022,Miami (Florida),1,0,1,1.0
vs. FBS Winning,2022,Miami (Florida),1,6,7,0.14285714285714285
vs. FBS Non-Winning,2022,Miami (Florida),3,1,4,0.75
vs. BCS AQ,2022,Miami (Florida),3,6,9,0.3333333333333333
vs. BCS non-AQ,2022,Miami (Florida),1,1,2,0.5
vs. FBS Power 5,2022,Miami (Florida),3,6,9,0.3333333333333333
vs. FBS non-Power 5,2022,Miami (Florida),1,1,2,0.5
in August/September,2022,Miami (Florida),2,2,4,0.5
in October,2022,Miami (Florida),2,2,4,0.5
in November,2022,Miami (Florida),1,3,4,0.25
in December/January,2022,Miami (Florida),0,0,0,
All Games,2009,Miami (Ohio),1,11,12,0.08333333333333333
at Home,2009,Miami (Ohio),1,4,5,0.2
on Road/Neutral Site,2009,Miami (Ohio),0,7,7,0.0
vs. Conference,2009,Miami (Ohio),1,7,8,0.125
vs. Non-Conference,2009,Miami (Ohio),0,4,4,0.0
vs. Ranked (AP),2009,Miami (Ohio),0,2,2,0.0
vs. Unranked (AP),2009,Miami (Ohio),1,9,10,0.1
vs. FBS (I-A),2009,Miami (Ohio),1,11,12,0.08333333333333333
vs. FCS (I-AA),2009,Miami (Ohio),0,0,0,
vs. FBS Winning,2009,Miami (Ohio),0,8,8,0.0
vs. FBS Non-Winning,2009,Miami (Ohio),1,3,4,0.25
vs. BCS AQ,2009,Miami (Ohio),0,3,3,0.0
vs. BCS non-AQ,2009,Miami (Ohio),1,8,9,0.1111111111111111
vs. FBS Power 5,2009,Miami (Ohio),0,2,2,0.0
vs. FBS non-Power 5,2009,Miami (Ohio),1,9,10,0.1
in August/September,2009,Miami (Ohio),0,4,4,0.0
in October,2009,Miami (Ohio),1,4,5,0.2
in November,2009,Miami (Ohio),0,3,3,0.0
in December/January,2009,Miami (Ohio),0,0,0,
All Games,2010,Miami (Ohio),10,4,14,0.7142857142857143
at Home,2010,Miami (Ohio),4,1,5,0.8
on Road/Neutral Site,2010,Miami (Ohio),6,3,9,0.6666666666666666
vs. Conference,2010,Miami (Ohio),8,1,9,0.8888888888888888
vs. Non-Conference,2010,Miami (Ohio),2,3,5,0.4
vs. Ranked (AP),2010,Miami (Ohio),0,1,1,0.0
vs. Unranked (AP),2010,Miami (Ohio),10,3,13,0.7692307692307693
vs. FBS (I-A),2010,Miami (Ohio),10,4,14,0.7142857142857143
vs. FCS (I-AA),2010,Miami (Ohio),0,0,0,
vs. FBS Winning,2010,Miami (Ohio),2,3,5,0.4
vs. FBS Non-Winning,2010,Miami (Ohio),8,1,9,0.8888888888888888
vs. BCS AQ,2010,Miami (Ohio),0,3,3,0.0
vs. BCS non-AQ,2010,Miami (Ohio),10,1,11,0.9090909090909091
vs. FBS Power 5,2010,Miami (Ohio),0,2,2,0.0
vs. FBS non-Power 5,2010,Miami (Ohio),10,2,12,0.8333333333333334
in August/September,2010,Miami (Ohio),2,2,4,0.5
in October,2010,Miami (Ohio),3,2,5,0.6
in November,2010,Miami (Ohio),3,0,3,1.0
in December/January,2010,Miami (Ohio),2,0,2,1.0
All Games,2011,Miami (Ohio),4,8,12,0.3333333333333333
at Home,2011,Miami (Ohio),3,3,6,0.5
on Road/Neutral Site,2011,Miami (Ohio),1,5,6,0.16666666666666666
vs. Conference,2011,Miami (Ohio),3,5,8,0.375
vs. Non-Conference,2011,Miami (Ohio),1,3,4,0.25
vs. Ranked (AP),2011,Miami (Ohio),0,1,1,0.0
vs. Unranked (AP),2011,Miami (Ohio),4,7,11,0.36363636363636365
vs. FBS (I-A),2011,Miami (Ohio),4,8,12,0.3333333333333333
vs. FCS (I-AA),2011,Miami (Ohio),0,0,0,
vs. FBS Winning,2011,Miami (Ohio),0,6,6,0.0
vs. FBS Non-Winning,2011,Miami (Ohio),4,2,6,0.6666666666666666
vs. BCS AQ,2011,Miami (Ohio),0,3,3,0.0
vs. BCS non-AQ,2011,Miami (Ohio),4,5,9,0.4444444444444444
vs. FBS Power 5,2011,Miami (Ohio),0,2,2,0.0
vs. FBS non-Power 5,2011,Miami (Ohio),4,6,10,0.4
in August/September,2011,Miami (Ohio),0,3,3,0.0
in October,2011,Miami (Ohio),3,2,5,0.6
in November,2011,Miami (Ohio),1,3,4,0.25
in December/January,2011,Miami (Ohio),0,0,0,
All Games,2012,Miami (Ohio),4,8,12,0.3333333333333333
at Home,2012,Miami (Ohio),3,2,5,0.6
on Road/Neutral Site,2012,Miami (Ohio),1,6,7,0.14285714285714285
vs. Conference,2012,Miami (Ohio),3,5,8,0.375
vs. Non-Conference,2012,Miami (Ohio),1,3,4,0.25
vs. Ranked (AP),2012,Miami (Ohio),0,2,2,0.0
vs. Unranked (AP),2012,Miami (Ohio),4,6,10,0.4
vs. FBS (I-A),2012,Miami (Ohio),3,8,11,0.2727272727272727
vs. FCS (I-AA),2012,Miami (Ohio),1,0,1,1.0
vs. FBS Winning,2012,Miami (Ohio),1,7,8,0.125
vs. FBS Non-Winning,2012,Miami (Ohio),2,1,3,0.6666666666666666
vs. BCS AQ,2012,Miami (Ohio),0,2,2,0.0
vs. BCS non-AQ,2012,Miami (Ohio),3,6,9,0.3333333333333333
vs. FBS Power 5,2012,Miami (Ohio),0,1,1,0.0
vs. FBS non-Power 5,2012,Miami (Ohio),3,7,10,0.3
in August/September,2012,Miami (Ohio),3,2,5,0.6
in October,2012,Miami (Ohio),1,2,3,0.3333333333333333
in November,2012,Miami (Ohio),0,4,4,0.0
in December/January,2012,Miami (Ohio),0,0,0,
All Games,2013,Miami (Ohio),0,12,12,0.0
at Home,2013,Miami (Ohio),0,5,5,0.0
on Road/Neutral Site,2013,Miami (Ohio),0,7,7,0.0
vs. Conference,2013,Miami (Ohio),0,8,8,0.0
vs. Non-Conference,2013,Miami (Ohio),0,4,4,0.0
vs. Ranked (AP),2013,Miami (Ohio),0,0,0,
vs. Unranked (AP),2013,Miami (Ohio),0,12,12,0.0
vs. FBS (I-A),2013,Miami (Ohio),0,12,12,0.0
vs. FCS (I-AA),2013,Miami (Ohio),0,0,0,
vs. FBS Winning,2013,Miami (Ohio),0,6,6,0.0
vs. FBS Non-Winning,2013,Miami (Ohio),0,6,6,0.0
vs. BCS AQ,2013,Miami (Ohio),0,3,3,0.0
vs. BCS non-AQ,2013,Miami (Ohio),0,9,9,0.0
vs. FBS Power 5,2013,Miami (Ohio),0,2,2,0.0
vs. FBS non-Power 5,2013,Miami (Ohio),0,10,10,0.0
in August/September,2013,Miami (Ohio),0,4,4,0.0
in October,2013,Miami (Ohio),0,4,4,0.0
in November,2013,Miami (Ohio),0,4,4,0.0
in December/January,2013,Miami (Ohio),0,0,0,
All Games,2014,Miami (Ohio),2,10,12,0.16666666666666666
at Home,2014,Miami (Ohio),2,4,6,0.3333333333333333
on Road/Neutral Site,2014,Miami (Ohio),0,6,6,0.0
vs. Conference,2014,Miami (Ohio),2,6,8,0.25
vs. Non-Conference,2014,Miami (Ohio),0,4,4,0.0
vs. Ranked (AP),2014,Miami (Ohio),0,1,1,0.0
vs. Unranked (AP),2014,Miami (Ohio),2,9,11,0.18181818181818182
vs. FBS (I-A),2014,Miami (Ohio),2,9,11,0.18181818181818182
vs. FCS (I-AA),2014,Miami (Ohio),0,1,1,0.0
vs. FBS Winning,2014,Miami (Ohio),0,5,5,0.0
vs. FBS Non-Winning,2014,Miami (Ohio),2,4,6,0.3333333333333333
vs. BCS AQ,2014,Miami (Ohio),0,2,2,0.0
vs. BCS non-AQ,2014,Miami (Ohio),2,7,9,0.2222222222222222
vs. FBS Power 5,2014,Miami (Ohio),0,1,1,0.0
vs. FBS non-Power 5,2014,Miami (Ohio),2,8,10,0.2
in August/September,2014,Miami (Ohio),0,5,5,0.0
in October,2014,Miami (Ohio),2,2,4,0.5
in November,2014,Miami (Ohio),0,3,3,0.0
in December/January,2014,Miami (Ohio),0,0,0,
All Games,2015,Miami (Ohio),3,9,12,0.25
at Home,2015,Miami (Ohio),2,4,6,0.3333333333333333
on Road/Neutral Site,2015,Miami (Ohio),1,5,6,0.16666666666666666
vs. Conference,2015,Miami (Ohio),2,6,8,0.25
vs. Non-Conference,2015,Miami (Ohio),1,3,4,0.25
vs. Ranked (AP),2015,Miami (Ohio),0,2,2,0.0
vs. Unranked (AP),2015,Miami (Ohio),3,7,10,0.3
vs. FBS (I-A),2015,Miami (Ohio),2,9,11,0.18181818181818182
vs. FCS (I-AA),2015,Miami (Ohio),1,0,1,1.0
vs. FBS Winning,2015,Miami (Ohio),0,7,7,0.0
vs. FBS Non-Winning,2015,Miami (Ohio),2,2,4,0.5
vs. BCS AQ,2015,Miami (Ohio),0,2,2,0.0
vs. BCS non-AQ,2015,Miami (Ohio),2,7,9,0.2222222222222222
vs. FBS Power 5,2015,Miami (Ohio),0,1,1,0.0
vs. FBS non-Power 5,2015,Miami (Ohio),2,8,10,0.2
in August/September,2015,Miami (Ohio),1,3,4,0.25
in October,2015,Miami (Ohio),0,5,5,0.0
in November,2015,Miami (Ohio),2,1,3,0.6666666666666666
in December/January,2015,Miami (Ohio),0,0,0,
All Games,2016,Miami (Ohio),6,7,13,0.46153846153846156
at Home,2016,Miami (Ohio),3,3,6,0.5
on Road/Neutral Site,2016,Miami (Ohio),3,4,7,0.42857142857142855
vs. Conference,2016,Miami (Ohio),6,2,8,0.75
vs. Non-Conference,2016,Miami (Ohio),0,5,5,0.0
vs. Ranked (AP),2016,Miami (Ohio),0,1,1,0.0
vs. Unranked (AP),2016,Miami (Ohio),6,6,12,0.5
vs. FBS (I-A),2016,Miami (Ohio),6,6,12,0.5
vs. FCS (I-AA),2016,Miami (Ohio),0,1,1,0.0
vs. FBS Winning,2016,Miami (Ohio),1,3,4,0.25
vs. FBS Non-Winning,2016,Miami (Ohio),5,3,8,0.625
vs. BCS AQ,2016,Miami (Ohio),0,3,3,0.0
vs. BCS non-AQ,2016,Miami (Ohio),6,3,9,0.6666666666666666
vs. FBS Power 5,2016,Miami (Ohio),0,2,2,0.0
vs. FBS non-Power 5,2016,Miami (Ohio),6,4,10,0.6
in August/September,2016,Miami (Ohio),0,4,4,0.0
in October,2016,Miami (Ohio),3,2,5,0.6
in November,2016,Miami (Ohio),3,0,3,1.0
in December/January,2016,Miami (Ohio),0,1,1,0.0
All Games,2017,Miami (Ohio),5,7,12,0.4166666666666667
at Home,2017,Miami (Ohio),3,3,6,0.5
on Road/Neutral Site,2017,Miami (Ohio),2,4,6,0.3333333333333333
vs. Conference,2017,Miami (Ohio),4,4,8,0.5
vs. Non-Conference,2017,Miami (Ohio),1,3,4,0.25
vs. Ranked (AP),2017,Miami (Ohio),0,1,1,0.0
vs. Unranked (AP),2017,Miami (Ohio),5,6,11,0.45454545454545453
vs. FBS (I-A),2017,Miami (Ohio),4,7,11,0.36363636363636365
vs. FCS (I-AA),2017,Miami (Ohio),1,0,1,1.0
vs. FBS Winning,2017,Miami (Ohio),1,3,4,0.25
vs. FBS Non-Winning,2017,Miami (Ohio),3,4,7,0.42857142857142855
vs. BCS AQ,2017,Miami (Ohio),0,2,2,0.0
vs. BCS non-AQ,2017,Miami (Ohio),4,5,9,0.4444444444444444
vs. FBS Power 5,2017,Miami (Ohio),0,0,0,
vs. FBS non-Power 5,2017,Miami (Ohio),4,7,11,0.36363636363636365
in August/September,2017,Miami (Ohio),2,3,5,0.4
in October,2017,Miami (Ohio),1,3,4,0.25
in November,2017,Miami (Ohio),2,1,3,0.6666666666666666
in December/January,2017,Miami (Ohio),0,0,0,
All Games,2018,Miami (Ohio),6,6,12,0.5
at Home,2018,Miami (Ohio),3,3,6,0.5
on Road/Neutral Site,2018,Miami (Ohio),3,3,6,0.5
vs. Conference,2018,Miami (Ohio),6,2,8,0.75
vs. Non-Conference,2018,Miami (Ohio),0,4,4,0.0
vs. Ranked (AP),2018,Miami (Ohio),0,2,2,0.0
vs. Unranked (AP),2018,Miami (Ohio),6,4,10,0.6
vs. FBS (I-A),2018,Miami (Ohio),6,6,12,0.5
vs. FCS (I-AA),2018,Miami (Ohio),0,0,0,
vs. FBS Winning,2018,Miami (Ohio),2,6,8,0.25
vs. FBS Non-Winning,2018,Miami (Ohio),4,0,4,1.0
vs. BCS AQ,2018,Miami (Ohio),0,2,2,0.0
vs. BCS non-AQ,2018,Miami (Ohio),6,4,10,0.6
vs. FBS Power 5,2018,Miami (Ohio),0,1,1,0.0
vs. FBS non-Power 5,2018,Miami (Ohio),6,5,11,0.5454545454545454
in August/September,2018,Miami (Ohio),1,4,5,0.2
in October,2018,Miami (Ohio),2,2,4,0.5
in November,2018,Miami (Ohio),3,0,3,1.0
in December/January,2018,Miami (Ohio),0,0,0,
All Games,2019,Miami (Ohio),8,6,14,0.5714285714285714
at Home,2019,Miami (Ohio),5,0,5,1.0
on Road/Neutral Site,2019,Miami (Ohio),3,6,9,0.3333333333333333
vs. Conference,2019,Miami (Ohio),7,2,9,0.7777777777777778
vs. Non-Conference,2019,Miami (Ohio),1,4,5,0.2
vs. Ranked (AP),2019,Miami (Ohio),0,3,3,0.0
vs. Unranked (AP),2019,Miami (Ohio),8,3,11,0.7272727272727273
vs. FBS (I-A),2019,Miami (Ohio),7,6,13,0.5384615384615384
vs. FCS (I-AA),2019,Miami (Ohio),1,0,1,1.0
vs. FBS Winning,2019,Miami (Ohio),4,5,9,0.4444444444444444
vs. FBS Non-Winning,2019,Miami (Ohio),3,1,4,0.75
vs. BCS AQ,2019,Miami (Ohio),0,3,3,0.0
vs. BCS non-AQ,2019,Miami (Ohio),7,3,10,0.7
vs. FBS Power 5,2019,Miami (Ohio),0,2,2,0.0
vs. FBS non-Power 5,2019,Miami (Ohio),7,4,11,0.6363636363636364
in August/September,2019,Miami (Ohio),2,3,5,0.4
in October,2019,Miami (Ohio),2,1,3,0.6666666666666666
in November,2019,Miami (Ohio),3,1,4,0.75
in December/January,2019,Miami (Ohio),1,1,2,0.5
All Games,2020,Miami (Ohio),2,1,3,0.6666666666666666
at Home,2020,Miami (Ohio),1,0,1,1.0
on Road/Neutral Site,2020,Miami (Ohio),1,1,2,0.5
vs. Conference,2020,Miami (Ohio),2,1,3,0.6666666666666666
vs. Non-Conference,2020,Miami (Ohio),0,0,0,
vs. Ranked (AP),2020,Miami (Ohio),0,0,0,
vs. Unranked (AP),2020,Miami (Ohio),2,1,3,0.6666666666666666
vs. FBS (I-A),2020,Miami (Ohio),2,1,3,0.6666666666666666
vs. FCS (I-AA),2020,Miami (Ohio),0,0,0,
vs. FBS Winning,2020,Miami (Ohio),1,1,2,0.5
vs. FBS Non-Winning,2020,Miami (Ohio),1,0,1,1.0
vs. BCS AQ,2020,Miami (Ohio),0,0,0,
vs. BCS non-AQ,2020,Miami (Ohio),2,1,3,0.6666666666666666
vs. FBS Power 5,2020,Miami (Ohio),0,0,0,
vs. FBS non-Power 5,2020,Miami (Ohio),2,1,3,0.6666666666666666
in August/September,2020,Miami (Ohio),0,0,0,
in October,2020,Miami (Ohio),0,0,0,
in November,2020,Miami (Ohio),2,1,3,0.6666666666666666
in December/January,2020,Miami (Ohio),0,0,0,
All Games,2021,Miami (Ohio),7,6,13,0.5384615384615384
at Home,2021,Miami (Ohio),5,0,5,1.0
on Road/Neutral Site,2021,Miami (Ohio),2,6,8,0.25
vs. Conference,2021,Miami (Ohio),5,3,8,0.625
vs. Non-Conference,2021,Miami (Ohio),2,3,5,0.4
vs. Ranked (AP),2021,Miami (Ohio),0,1,1,0.0
vs. Unranked (AP),2021,Miami (Ohio),7,5,12,0.5833333333333334
vs. FBS (I-A),2021,Miami (Ohio),6,6,12,0.5
vs. FCS (I-AA),2021,Miami (Ohio),1,0,1,1.0
vs. FBS Winning,2021,Miami (Ohio),1,4,5,0.2
vs. FBS Non-Winning,2021,Miami (Ohio),5,2,7,0.7142857142857143
vs. BCS AQ,2021,Miami (Ohio),0,2,2,0.0
vs. BCS non-AQ,2021,Miami (Ohio),6,4,10,0.6
vs. FBS Power 5,2021,Miami (Ohio),0,1,1,0.0
vs. FBS non-Power 5,2021,Miami (Ohio),6,5,11,0.5454545454545454
in August/September,2021,Miami (Ohio),1,3,4,0.25
in October,2021,Miami (Ohio),3,1,4,0.75
in November,2021,Miami (Ohio),2,2,4,0.5
in December/January,2021,Miami (Ohio),1,0,1,1.0
All Games,2022,Miami (Ohio),6,7,13,0.46153846153846156
at Home,2022,Miami (Ohio),3,2,5,0.6
on Road/Neutral Site,2022,Miami (Ohio),3,5,8,0.375
vs. Conference,2022,Miami (Ohio),4,4,8,0.5
vs. Non-Conference,2022,Miami (Ohio),2,3,5,0.4
vs. Ranked (AP),2022,Miami (Ohio),0,0,0,
vs. Unranked (AP),2022,Miami (Ohio),6,7,13,0.46153846153846156
vs. FBS (I-A),2022,Miami (Ohio),5,7,12,0.4166666666666667
vs. FCS (I-AA),2022,Miami (Ohio),1,0,1,1.0
vs. FBS Winning,2022,Miami (Ohio),0,5,5,0.0
vs. FBS Non-Winning,2022,Miami (Ohio),5,2,7,0.7142857142857143
vs. BCS AQ,2022,Miami (Ohio),1,2,3,0.3333333333333333
vs. BCS non-AQ,2022,Miami (Ohio),4,5,9,0.4444444444444444
vs. FBS Power 5,2022,Miami (Ohio),1,1,2,0.5
vs. FBS non-Power 5,2022,Miami (Ohio),4,6,10,0.4
in August/September,2022,Miami (Ohio),2,2,4,0.5
in October,2022,Miami (Ohio),2,3,5,0.4
in November,2022,Miami (Ohio),2,1,3,0.6666666666666666
in December/January,2022,Miami (Ohio),0,1,1,0.0
All Games,2009,Michigan,5,7,12,0.4166666666666667
at Home,2009,Michigan,5,3,8,0.625
on Road/Neutral Site,2009,Michigan,0,4,4,0.0
vs. Conference,2009,Michigan,1,7,8,0.125
vs. Non-Conference,2009,Michigan,4,0,4,1.0
vs. Ranked (AP),2009,Michigan,0,4,4,0.0
vs. Unranked (AP),2009,Michigan,5,3,8,0.625
vs. FBS (I-A),2009,Michigan,4,7,11,0.36363636363636365
vs. FCS (I-AA),2009,Michigan,1,0,1,1.0
vs. FBS Winning,2009,Michigan,0,4,4,0.0
vs. FBS Non-Winning,2009,Michigan,4,3,7,0.5714285714285714
vs. BCS AQ,2009,Michigan,2,7,9,0.2222222222222222
vs. BCS non-AQ,2009,Michigan,2,0,2,1.0
vs. FBS Power 5,2009,Michigan,1,7,8,0.125
vs. FBS non-Power 5,2009,Michigan,3,0,3,1.0
in August/September,2009,Michigan,4,0,4,1.0
in October,2009,Michigan,1,4,5,0.2
in November,2009,Michigan,0,3,3,0.0
in December/January,2009,Michigan,0,0,0,
All Games,2010,Michigan,7,6,13,0.5384615384615384
at Home,2010,Michigan,4,3,7,0.5714285714285714
on Road/Neutral Site,2010,Michigan,3,3,6,0.5
vs. Conference,2010,Michigan,3,5,8,0.375
vs. Non-Conference,2010,Michigan,4,1,5,0.8
vs. Ranked (AP),2010,Michigan,0,4,4,0.0
vs. Unranked (AP),2010,Michigan,7,2,9,0.7777777777777778
vs. FBS (I-A),2010,Michigan,6,6,12,0.5
vs. FCS (I-AA),2010,Michigan,1,0,1,1.0
vs. FBS Winning,2010,Michigan,3,6,9,0.3333333333333333
vs. FBS Non-Winning,2010,Michigan,3,0,3,1.0
vs. BCS AQ,2010,Michigan,5,6,11,0.45454545454545453
vs. BCS non-AQ,2010,Michigan,1,0,1,1.0
vs. FBS Power 5,2010,Michigan,3,6,9,0.3333333333333333
vs. FBS non-Power 5,2010,Michigan,3,0,3,1.0
in August/September,2010,Michigan,4,0,4,1.0
in October,2010,Michigan,1,3,4,0.25
in November,2010,Michigan,2,2,4,0.5
in December/January,2010,Michigan,0,1,1,0.0
All Games,2011,Michigan,11,2,13,0.8461538461538461
at Home,2011,Michigan,8,0,8,1.0
on Road/Neutral Site,2011,Michigan,3,2,5,0.6
vs. Conference,2011,Michigan,6,2,8,0.75
vs. Non-Conference,2011,Michigan,5,0,5,1.0
vs. Ranked (AP),2011,Michigan,2,1,3,0.6666666666666666
vs. Unranked (AP),2011,Michigan,9,1,10,0.9
vs. FBS (I-A),2011,Michigan,11,2,13,0.8461538461538461
vs. FCS (I-AA),2011,Michigan,0,0,0,
vs. FBS Winning,2011,Michigan,7,2,9,0.7777777777777778
vs. FBS Non-Winning,2011,Michigan,4,0,4,1.0
vs. BCS AQ,2011,Michigan,8,2,10,0.8
vs. BCS non-AQ,2011,Michigan,3,0,3,1.0
vs. FBS Power 5,2011,Michigan,7,2,9,0.7777777777777778
vs. FBS non-Power 5,2011,Michigan,4,0,4,1.0
in August/September,2011,Michigan,4,0,4,1.0
in October,2011,Michigan,3,1,4,0.75
in November,2011,Michigan,3,1,4,0.75
in December/January,2011,Michigan,1,0,1,1.0
All Games,2012,Michigan,8,5,13,0.6153846153846154
at Home,2012,Michigan,6,0,6,1.0
on Road/Neutral Site,2012,Michigan,2,5,7,0.2857142857142857
vs. Conference,2012,Michigan,6,2,8,0.75
vs. Non-Conference,2012,Michigan,2,3,5,0.4
vs. Ranked (AP),2012,Michigan,1,5,6,0.16666666666666666
vs. Unranked (AP),2012,Michigan,7,0,7,1.0
vs. FBS (I-A),2012,Michigan,8,5,13,0.6153846153846154
vs. FCS (I-AA),2012,Michigan,0,0,0,
vs. FBS Winning,2012,Michigan,2,5,7,0.2857142857142857
vs. FBS Non-Winning,2012,Michigan,6,0,6,1.0
vs. BCS AQ,2012,Michigan,6,5,11,0.5454545454545454
vs. BCS non-AQ,2012,Michigan,2,0,2,1.0
vs. FBS Power 5,2012,Michigan,6,4,10,0.6
vs. FBS non-Power 5,2012,Michigan,2,1,3,0.6666666666666666
in August/September,2012,Michigan,2,2,4,0.5
in October,2012,Michigan,3,1,4,0.75
in November,2012,Michigan,3,1,4,0.75
in December/January,2012,Michigan,0,1,1,0.0
All Games,2013,Michigan,7,6,13,0.5384615384615384
at Home,2013,Michigan,5,2,7,0.7142857142857143
on Road/Neutral Site,2013,Michigan,2,4,6,0.3333333333333333
vs. Conference,2013,Michigan,3,5,8,0.375
vs. Non-Conference,2013,Michigan,4,1,5,0.8
vs. Ranked (AP),2013,Michigan,1,2,3,0.3333333333333333
vs. Unranked (AP),2013,Michigan,6,4,10,0.6
vs. FBS (I-A),2013,Michigan,7,6,13,0.5384615384615384
vs. FCS (I-AA),2013,Michigan,0,0,0,
vs. FBS Winning,2013,Michigan,2,6,8,0.25
vs. FBS Non-Winning,2013,Michigan,5,0,5,1.0
vs. BCS AQ,2013,Michigan,5,6,11,0.45454545454545453
vs. BCS non-AQ,2013,Michigan,2,0,2,1.0
vs. FBS Power 5,2013,Michigan,3,6,9,0.3333333333333333
vs. FBS non-Power 5,2013,Michigan,4,0,4,1.0
in August/September,2013,Michigan,4,0,4,1.0
in October,2013,Michigan,2,1,3,0.6666666666666666
in November,2013,Michigan,1,4,5,0.2
in December/January,2013,Michigan,0,1,1,0.0
All Games,2014,Michigan,5,7,12,0.4166666666666667
at Home,2014,Michigan,4,3,7,0.5714285714285714
on Road/Neutral Site,2014,Michigan,1,4,5,0.2
vs. Conference,2014,Michigan,3,5,8,0.375
vs. Non-Conference,2014,Michigan,2,2,4,0.5
vs. Ranked (AP),2014,Michigan,0,3,3,0.0
vs. Unranked (AP),2014,Michigan,5,4,9,0.5555555555555556
vs. FBS (I-A),2014,Michigan,5,7,12,0.4166666666666667
vs. FCS (I-AA),2014,Michigan,0,0,0,
vs. FBS Winning,2014,Michigan,2,7,9,0.2222222222222222
vs. FBS Non-Winning,2014,Michigan,3,0,3,1.0
vs. BCS AQ,2014,Michigan,3,7,10,0.3
vs. BCS non-AQ,2014,Michigan,2,0,2,1.0
vs. FBS Power 5,2014,Michigan,3,6,9,0.3333333333333333
vs. FBS non-Power 5,2014,Michigan,2,1,3,0.6666666666666666
in August/September,2014,Michigan,2,3,5,0.4
in October,2014,Michigan,1,2,3,0.3333333333333333
in November,2014,Michigan,2,2,4,0.5
in December/January,2014,Michigan,0,0,0,
All Games,2015,Michigan,10,3,13,0.7692307692307693
at Home,2015,Michigan,5,2,7,0.7142857142857143
on Road/Neutral Site,2015,Michigan,5,1,6,0.8333333333333334
vs. Conference,2015,Michigan,6,2,8,0.75
vs. Non-Conference,2015,Michigan,4,1,5,0.8
vs. Ranked (AP),2015,Michigan,2,3,5,0.4
vs. Unranked (AP),2015,Michigan,8,0,8,1.0
vs. FBS (I-A),2015,Michigan,10,3,13,0.7692307692307693
vs. FCS (I-AA),2015,Michigan,0,0,0,
vs. FBS Winning,2015,Michigan,4,3,7,0.5714285714285714
vs. FBS Non-Winning,2015,Michigan,6,0,6,1.0
vs. BCS AQ,2015,Michigan,8,3,11,0.7272727272727273
vs. BCS non-AQ,2015,Michigan,2,0,2,1.0
vs. FBS Power 5,2015,Michigan,8,3,11,0.7272727272727273
vs. FBS non-Power 5,2015,Michigan,2,0,2,1.0
in August/September,2015,Michigan,3,1,4,0.75
in October,2015,Michigan,3,1,4,0.75
in November,2015,Michigan,3,1,4,0.75
in December/January,2015,Michigan,1,0,1,1.0
All Games,2016,Michigan,10,3,13,0.7692307692307693
at Home,2016,Michigan,8,0,8,1.0
on Road/Neutral Site,2016,Michigan,2,3,5,0.4
vs. Conference,2016,Michigan,7,2,9,0.7777777777777778
vs. Non-Conference,2016,Michigan,3,1,4,0.75
vs. Ranked (AP),2016,Michigan,3,3,6,0.5
vs. Unranked (AP),2016,Michigan,7,0,7,1.0
vs. FBS (I-A),2016,Michigan,10,3,13,0.7692307692307693
vs. FCS (I-AA),2016,Michigan,0,0,0,
vs. FBS Winning,2016,Michigan,3,3,6,0.5
vs. FBS Non-Winning,2016,Michigan,7,0,7,1.0
vs. BCS AQ,2016,Michigan,9,3,12,0.75
vs. BCS non-AQ,2016,Michigan,1,0,1,1.0
vs. FBS Power 5,2016,Michigan,8,3,11,0.7272727272727273
vs. FBS non-Power 5,2016,Michigan,2,0,2,1.0
in August/September,2016,Michigan,4,0,4,1.0
in October,2016,Michigan,4,0,4,1.0
in November,2016,Michigan,2,2,4,0.5
in December/January,2016,Michigan,0,1,1,0.0
All Games,2017,Michigan,8,5,13,0.6153846153846154
at Home,2017,Michigan,4,2,6,0.6666666666666666
on Road/Neutral Site,2017,Michigan,4,3,7,0.5714285714285714
vs. Conference,2017,Michigan,5,4,9,0.5555555555555556
vs. Non-Conference,2017,Michigan,3,1,4,0.75
vs. Ranked (AP),2017,Michigan,0,4,4,0.0
vs. Unranked (AP),2017,Michigan,8,1,9,0.8888888888888888
vs. FBS (I-A),2017,Michigan,8,5,13,0.6153846153846154
vs. FCS (I-AA),2017,Michigan,0,0,0,
vs. FBS Winning,2017,Michigan,1,5,6,0.16666666666666666
vs. FBS Non-Winning,2017,Michigan,7,0,7,1.0
vs. BCS AQ,2017,Michigan,7,5,12,0.5833333333333334
vs. BCS non-AQ,2017,Michigan,1,0,1,1.0
vs. FBS Power 5,2017,Michigan,6,5,11,0.5454545454545454
vs. FBS non-Power 5,2017,Michigan,2,0,2,1.0
in August/September,2017,Michigan,4,0,4,1.0
in October,2017,Michigan,2,2,4,0.5
in November,2017,Michigan,2,2,4,0.5
in December/January,2017,Michigan,0,1,1,0.0
All Games,2018,Michigan,10,3,13,0.7692307692307693
at Home,2018,Michigan,7,0,7,1.0
on Road/Neutral Site,2018,Michigan,3,3,6,0.5
vs. Conference,2018,Michigan,8,1,9,0.8888888888888888
vs. Non-Conference,2018,Michigan,2,2,4,0.5
vs. Ranked (AP),2018,Michigan,2,3,5,0.4
vs. Unranked (AP),2018,Michigan,8,0,8,1.0
vs. FBS (I-A),2018,Michigan,10,3,13,0.7692307692307693
vs. FCS (I-AA),2018,Michigan,0,0,0,
vs. FBS Winning,2018,Michigan,5,3,8,0.625
vs. FBS Non-Winning,2018,Michigan,5,0,5,1.0
vs. BCS AQ,2018,Michigan,9,3,12,0.75
vs. BCS non-AQ,2018,Michigan,1,0,1,1.0
vs. FBS Power 5,2018,Michigan,8,2,10,0.8
vs. FBS non-Power 5,2018,Michigan,2,1,3,0.6666666666666666
in August/September,2018,Michigan,4,1,5,0.8
in October,2018,Michigan,3,0,3,1.0
in November,2018,Michigan,3,1,4,0.75
in December/January,2018,Michigan,0,1,1,0.0
All Games,2019,Michigan,9,4,13,0.6923076923076923
at Home,2019,Michigan,6,1,7,0.8571428571428571
on Road/Neutral Site,2019,Michigan,3,3,6,0.5
vs. Conference,2019,Michigan,6,3,9,0.6666666666666666
vs. Non-Conference,2019,Michigan,3,1,4,0.75
vs. Ranked (AP),2019,Michigan,2,4,6,0.3333333333333333
vs. Unranked (AP),2019,Michigan,7,0,7,1.0
vs. FBS (I-A),2019,Michigan,9,4,13,0.6923076923076923
vs. FCS (I-AA),2019,Michigan,0,0,0,
vs. FBS Winning,2019,Michigan,4,4,8,0.5
vs. FBS Non-Winning,2019,Michigan,5,0,5,1.0
vs. BCS AQ,2019,Michigan,7,4,11,0.6363636363636364
vs. BCS non-AQ,2019,Michigan,2,0,2,1.0
vs. FBS Power 5,2019,Michigan,6,4,10,0.6
vs. FBS non-Power 5,2019,Michigan,3,0,3,1.0
in August/September,2019,Michigan,3,1,4,0.75
in October,2019,Michigan,3,1,4,0.75
in November,2019,Michigan,3,1,4,0.75
in December/January,2019,Michigan,0,1,1,0.0
All Games,2020,Michigan,2,4,6,0.3333333333333333
at Home,2020,Michigan,0,3,3,0.0
on Road/Neutral Site,2020,Michigan,2,1,3,0.6666666666666666
vs. Conference,2020,Michigan,2,4,6,0.3333333333333333
vs. Non-Conference,2020,Michigan,0,0,0,
vs. Ranked (AP),2020,Michigan,0,1,1,0.0
vs. Unranked (AP),2020,Michigan,2,3,5,0.4
vs. FBS (I-A),2020,Michigan,2,4,6,0.3333333333333333
vs. FCS (I-AA),2020,Michigan,0,0,0,
vs. FBS Winning,2020,Michigan,0,2,2,0.0
vs. FBS Non-Winning,2020,Michigan,2,2,4,0.5
vs. BCS AQ,2020,Michigan,2,4,6,0.3333333333333333
vs. BCS non-AQ,2020,Michigan,0,0,0,
vs. FBS Power 5,2020,Michigan,2,4,6,0.3333333333333333
vs. FBS non-Power 5,2020,Michigan,0,0,0,
in August/September,2020,Michigan,0,0,0,
in October,2020,Michigan,1,1,2,0.5
in November,2020,Michigan,1,3,4,0.25
in December/January,2020,Michigan,0,0,0,
All Games,2021,Michigan,12,2,14,0.8571428571428571
at Home,2021,Michigan,7,0,7,1.0
on Road/Neutral Site,2021,Michigan,5,2,7,0.7142857142857143
vs. Conference,2021,Michigan,9,1,10,0.9
vs. Non-Conference,2021,Michigan,3,1,4,0.75
vs. Ranked (AP),2021,Michigan,2,2,4,0.5
vs. Unranked (AP),2021,Michigan,10,0,10,1.0
vs. FBS (I-A),2021,Michigan,12,2,14,0.8571428571428571
vs. FCS (I-AA),2021,Michigan,0,0,0,
vs. FBS Winning,2021,Michigan,7,2,9,0.7777777777777778
vs. FBS Non-Winning,2021,Michigan,5,0,5,1.0
vs. BCS AQ,2021,Michigan,10,2,12,0.8333333333333334
vs. BCS non-AQ,2021,Michigan,2,0,2,1.0
vs. FBS Power 5,2021,Michigan,10,2,12,0.8333333333333334
vs. FBS non-Power 5,2021,Michigan,2,0,2,1.0
in August/September,2021,Michigan,4,0,4,1.0
in October,2021,Michigan,3,1,4,0.75
in November,2021,Michigan,4,0,4,1.0
in December/January,2021,Michigan,1,1,2,0.5
All Games,2022,Michigan,13,1,14,0.9285714285714286
at Home,2022,Michigan,8,0,8,1.0
on Road/Neutral Site,2022,Michigan,5,1,6,0.8333333333333334
vs. Conference,2022,Michigan,10,0,10,1.0
vs. Non-Conference,2022,Michigan,3,1,4,0.75
vs. Ranked (AP),2022,Michigan,2,1,3,0.6666666666666666
vs. Unranked (AP),2022,Michigan,11,0,11,1.0
vs. FBS (I-A),2022,Michigan,13,1,14,0.9285714285714286
vs. FCS (I-AA),2022,Michigan,0,0,0,
vs. FBS Winning,2022,Michigan,6,1,7,0.8571428571428571
vs. FBS Non-Winning,2022,Michigan,7,0,7,1.0
vs. BCS AQ,2022,Michigan,10,1,11,0.9090909090909091
vs. BCS non-AQ,2022,Michigan,3,0,3,1.0
vs. FBS Power 5,2022,Michigan,10,1,11,0.9090909090909091
vs. FBS non-Power 5,2022,Michigan,3,0,3,1.0
in August/September,2022,Michigan,4,0,4,1.0
in October,2022,Michigan,4,0,4,1.0
in November,2022,Michigan,4,0,4,1.0
in December/January,2022,Michigan,1,1,2,0.5
All Games,2009,Michigan State,6,7,13,0.46153846153846156
at Home,2009,Michigan State,4,3,7,0.5714285714285714
on Road/Neutral Site,2009,Michigan State,2,4,6,0.3333333333333333
vs. Conference,2009,Michigan State,4,4,8,0.5
vs. Non-Conference,2009,Michigan State,2,3,5,0.4
vs. Ranked (AP),2009,Michigan State,0,5,5,0.0
vs. Unranked (AP),2009,Michigan State,6,2,8,0.75
vs. FBS (I-A),2009,Michigan State,5,7,12,0.4166666666666667
vs. FCS (I-AA),2009,Michigan State,1,0,1,1.0
vs. FBS Winning,2009,Michigan State,1,5,6,0.16666666666666666
vs. FBS Non-Winning,2009,Michigan State,4,2,6,0.6666666666666666
vs. BCS AQ,2009,Michigan State,4,6,10,0.4
vs. BCS non-AQ,2009,Michigan State,1,1,2,0.5
vs. FBS Power 5,2009,Michigan State,4,5,9,0.4444444444444444
vs. FBS non-Power 5,2009,Michigan State,1,2,3,0.3333333333333333
in August/September,2009,Michigan State,1,3,4,0.25
in October,2009,Michigan State,3,2,5,0.6
in November,2009,Michigan State,2,1,3,0.6666666666666666
in December/January,2009,Michigan State,0,1,1,0.0
All Games,2010,Michigan State,11,2,13,0.8461538461538461
at Home,2010,Michigan State,7,0,7,1.0
on Road/Neutral Site,2010,Michigan State,4,2,6,0.6666666666666666
vs. Conference,2010,Michigan State,7,1,8,0.875
vs. Non-Conference,2010,Michigan State,4,1,5,0.8
vs. Ranked (AP),2010,Michigan State,1,1,2,0.5
vs. Unranked (AP),2010,Michigan State,10,1,11,0.9090909090909091
vs. FBS (I-A),2010,Michigan State,10,2,12,0.8333333333333334
vs. FCS (I-AA),2010,Michigan State,1,0,1,1.0
vs. FBS Winning,2010,Michigan State,6,2,8,0.75
vs. FBS Non-Winning,2010,Michigan State,4,0,4,1.0
vs. BCS AQ,2010,Michigan State,8,2,10,0.8
vs. BCS non-AQ,2010,Michigan State,2,0,2,1.0
vs. FBS Power 5,2010,Michigan State,7,2,9,0.7777777777777778
vs. FBS non-Power 5,2010,Michigan State,3,0,3,1.0
in August/September,2010,Michigan State,4,0,4,1.0
in October,2010,Michigan State,4,1,5,0.8
in November,2010,Michigan State,3,0,3,1.0
in December/January,2010,Michigan State,0,1,1,0.0
All Games,2011,Michigan State,11,3,14,0.7857142857142857
at Home,2011,Michigan State,7,0,7,1.0
on Road/Neutral Site,2011,Michigan State,4,3,7,0.5714285714285714
vs. Conference,2011,Michigan State,7,2,9,0.7777777777777778
vs. Non-Conference,2011,Michigan State,4,1,5,0.8
vs. Ranked (AP),2011,Michigan State,3,2,5,0.6
vs. Unranked (AP),2011,Michigan State,8,1,9,0.8888888888888888
vs. FBS (I-A),2011,Michigan State,10,3,13,0.7692307692307693
vs. FCS (I-AA),2011,Michigan State,1,0,1,1.0
vs. FBS Winning,2011,Michigan State,4,3,7,0.5714285714285714
vs. FBS Non-Winning,2011,Michigan State,6,0,6,1.0
vs. BCS AQ,2011,Michigan State,8,3,11,0.7272727272727273
vs. BCS non-AQ,2011,Michigan State,2,0,2,1.0
vs. FBS Power 5,2011,Michigan State,8,2,10,0.8
vs. FBS non-Power 5,2011,Michigan State,2,1,3,0.6666666666666666
in August/September,2011,Michigan State,3,1,4,0.75
in October,2011,Michigan State,3,1,4,0.75
in November,2011,Michigan State,4,0,4,1.0
in December/January,2011,Michigan State,1,1,2,0.5
All Games,2012,Michigan State,7,6,13,0.5384615384615384
at Home,2012,Michigan State,2,5,7,0.2857142857142857
on Road/Neutral Site,2012,Michigan State,5,1,6,0.8333333333333334
vs. Conference,2012,Michigan State,3,5,8,0.375
vs. Non-Conference,2012,Michigan State,4,1,5,0.8
vs. Ranked (AP),2012,Michigan State,1,5,6,0.16666666666666666
vs. Unranked (AP),2012,Michigan State,6,1,7,0.8571428571428571
vs. FBS (I-A),2012,Michigan State,7,6,13,0.5384615384615384
vs. FCS (I-AA),2012,Michigan State,0,0,0,
vs. FBS Winning,2012,Michigan State,4,5,9,0.4444444444444444
vs. FBS Non-Winning,2012,Michigan State,3,1,4,0.75
vs. BCS AQ,2012,Michigan State,4,6,10,0.4
vs. BCS non-AQ,2012,Michigan State,3,0,3,1.0
vs. FBS Power 5,2012,Michigan State,4,5,9,0.4444444444444444
vs. FBS non-Power 5,2012,Michigan State,3,1,4,0.75
in August/September,2012,Michigan State,3,2,5,0.6
in October,2012,Michigan State,2,2,4,0.5
in November,2012,Michigan State,1,2,3,0.3333333333333333
in December/January,2012,Michigan State,1,0,1,1.0
All Games,2013,Michigan State,13,1,14,0.9285714285714286
at Home,2013,Michigan State,7,0,7,1.0
on Road/Neutral Site,2013,Michigan State,6,1,7,0.8571428571428571
vs. Conference,2013,Michigan State,9,0,9,1.0
vs. Non-Conference,2013,Michigan State,4,1,5,0.8
vs. Ranked (AP),2013,Michigan State,2,1,3,0.6666666666666666
vs. Unranked (AP),2013,Michigan State,11,0,11,1.0
vs. FBS (I-A),2013,Michigan State,12,1,13,0.9230769230769231
vs. FCS (I-AA),2013,Michigan State,1,0,1,1.0
vs. FBS Winning,2013,Michigan State,6,1,7,0.8571428571428571
vs. FBS Non-Winning,2013,Michigan State,6,0,6,1.0
vs. BCS AQ,2013,Michigan State,11,1,12,0.9166666666666666
vs. BCS non-AQ,2013,Michigan State,1,0,1,1.0
vs. FBS Power 5,2013,Michigan State,10,0,10,1.0
vs. FBS non-Power 5,2013,Michigan State,2,1,3,0.6666666666666666
in August/September,2013,Michigan State,3,1,4,0.75
in October,2013,Michigan State,4,0,4,1.0
in November,2013,Michigan State,4,0,4,1.0
in December/January,2013,Michigan State,2,0,2,1.0
All Games,2014,Michigan State,11,2,13,0.8461538461538461
at Home,2014,Michigan State,6,1,7,0.8571428571428571
on Road/Neutral Site,2014,Michigan State,5,1,6,0.8333333333333334
vs. Conference,2014,Michigan State,7,1,8,0.875
vs. Non-Conference,2014,Michigan State,4,1,5,0.8
vs. Ranked (AP),2014,Michigan State,1,2,3,0.3333333333333333
vs. Unranked (AP),2014,Michigan State,10,0,10,1.0
vs. FBS (I-A),2014,Michigan State,10,2,12,0.8333333333333334
vs. FCS (I-AA),2014,Michigan State,1,0,1,1.0
vs. FBS Winning,2014,Michigan State,5,2,7,0.7142857142857143
vs. FBS Non-Winning,2014,Michigan State,5,0,5,1.0
vs. BCS AQ,2014,Michigan State,8,2,10,0.8
vs. BCS non-AQ,2014,Michigan State,2,0,2,1.0
vs. FBS Power 5,2014,Michigan State,8,2,10,0.8
vs. FBS non-Power 5,2014,Michigan State,2,0,2,1.0
in August/September,2014,Michigan State,3,1,4,0.75
in October,2014,Michigan State,4,0,4,1.0
in November,2014,Michigan State,3,1,4,0.75
in December/January,2014,Michigan State,1,0,1,1.0
All Games,2015,Michigan State,12,2,14,0.8571428571428571
at Home,2015,Michigan State,7,0,7,1.0
on Road/Neutral Site,2015,Michigan State,5,2,7,0.7142857142857143
vs. Conference,2015,Michigan State,8,1,9,0.8888888888888888
vs. Non-Conference,2015,Michigan State,4,1,5,0.8
vs. Ranked (AP),2015,Michigan State,4,1,5,0.8
vs. Unranked (AP),2015,Michigan State,8,1,9,0.8888888888888888
vs. FBS (I-A),2015,Michigan State,12,2,14,0.8571428571428571
vs. FCS (I-AA),2015,Michigan State,0,0,0,
vs. FBS Winning,2015,Michigan State,8,1,9,0.8888888888888888
vs. FBS Non-Winning,2015,Michigan State,4,1,5,0.8
vs. BCS AQ,2015,Michigan State,9,2,11,0.8181818181818182
vs. BCS non-AQ,2015,Michigan State,3,0,3,1.0
vs. FBS Power 5,2015,Michigan State,9,2,11,0.8181818181818182
vs. FBS non-Power 5,2015,Michigan State,3,0,3,1.0
in August/September,2015,Michigan State,4,0,4,1.0
in October,2015,Michigan State,4,0,4,1.0
in November,2015,Michigan State,3,1,4,0.75
in December/January,2015,Michigan State,1,1,2,0.5
All Games,2016,Michigan State,3,9,12,0.25
at Home,2016,Michigan State,2,5,7,0.2857142857142857
on Road/Neutral Site,2016,Michigan State,1,4,5,0.2
vs. Conference,2016,Michigan State,1,8,9,0.1111111111111111
vs. Non-Conference,2016,Michigan State,2,1,3,0.6666666666666666
vs. Ranked (AP),2016,Michigan State,0,4,4,0.0
vs. Unranked (AP),2016,Michigan State,3,5,8,0.375
vs. FBS (I-A),2016,Michigan State,2,9,11,0.18181818181818182
vs. FCS (I-AA),2016,Michigan State,1,0,1,1.0
vs. FBS Winning,2016,Michigan State,0,6,6,0.0
vs. FBS Non-Winning,2016,Michigan State,2,3,5,0.4
vs. BCS AQ,2016,Michigan State,2,8,10,0.2
vs. BCS non-AQ,2016,Michigan State,0,1,1,0.0
vs. FBS Power 5,2016,Michigan State,1,8,9,0.1111111111111111
vs. FBS non-Power 5,2016,Michigan State,1,1,2,0.5
in August/September,2016,Michigan State,2,1,3,0.6666666666666666
in October,2016,Michigan State,0,5,5,0.0
in November,2016,Michigan State,1,3,4,0.25
in December/January,2016,Michigan State,0,0,0,
All Games,2017,Michigan State,10,3,13,0.7692307692307693
at Home,2017,Michigan State,6,1,7,0.8571428571428571
on Road/Neutral Site,2017,Michigan State,4,2,6,0.6666666666666666
vs. Conference,2017,Michigan State,7,2,9,0.7777777777777778
vs. Non-Conference,2017,Michigan State,3,1,4,0.75
vs. Ranked (AP),2017,Michigan State,1,3,4,0.25
vs. Unranked (AP),2017,Michigan State,9,0,9,1.0
vs. FBS (I-A),2017,Michigan State,10,3,13,0.7692307692307693
vs. FCS (I-AA),2017,Michigan State,0,0,0,
vs. FBS Winning,2017,Michigan State,4,3,7,0.5714285714285714
vs. FBS Non-Winning,2017,Michigan State,6,0,6,1.0
vs. BCS AQ,2017,Michigan State,8,3,11,0.7272727272727273
vs. BCS non-AQ,2017,Michigan State,2,0,2,1.0
vs. FBS Power 5,2017,Michigan State,8,2,10,0.8
vs. FBS non-Power 5,2017,Michigan State,2,1,3,0.6666666666666666
in August/September,2017,Michigan State,3,1,4,0.75
in October,2017,Michigan State,3,1,4,0.75
in November,2017,Michigan State,3,1,4,0.75
in December/January,2017,Michigan State,1,0,1,1.0
All Games,2018,Michigan State,7,6,13,0.5384615384615384
at Home,2018,Michigan State,4,3,7,0.5714285714285714
on Road/Neutral Site,2018,Michigan State,3,3,6,0.5
vs. Conference,2018,Michigan State,5,4,9,0.5555555555555556
vs. Non-Conference,2018,Michigan State,2,2,4,0.5
vs. Ranked (AP),2018,Michigan State,2,3,5,0.4
vs. Unranked (AP),2018,Michigan State,5,3,8,0.625
vs. FBS (I-A),2018,Michigan State,7,6,13,0.5384615384615384
vs. FCS (I-AA),2018,Michigan State,0,0,0,
vs. FBS Winning,2018,Michigan State,2,5,7,0.2857142857142857
vs. FBS Non-Winning,2018,Michigan State,5,1,6,0.8333333333333334
vs. BCS AQ,2018,Michigan State,5,6,11,0.45454545454545453
vs. BCS non-AQ,2018,Michigan State,2,0,2,1.0
vs. FBS Power 5,2018,Michigan State,5,6,11,0.45454545454545453
vs. FBS non-Power 5,2018,Michigan State,2,0,2,1.0
in August/September,2018,Michigan State,3,1,4,0.75
in October,2018,Michigan State,2,2,4,0.5
in November,2018,Michigan State,2,2,4,0.5
in December/January,2018,Michigan State,0,1,1,0.0
All Games,2019,Michigan State,7,6,13,0.5384615384615384
at Home,2019,Michigan State,4,3,7,0.5714285714285714
on Road/Neutral Site,2019,Michigan State,3,3,6,0.5
vs. Conference,2019,Michigan State,4,5,9,0.4444444444444444
vs. Non-Conference,2019,Michigan State,3,1,4,0.75
vs. Ranked (AP),2019,Michigan State,0,4,4,0.0
vs. Unranked (AP),2019,Michigan State,7,2,9,0.7777777777777778
vs. FBS (I-A),2019,Michigan State,7,6,13,0.5384615384615384
vs. FCS (I-AA),2019,Michigan State,0,0,0,
vs. FBS Winning,2019,Michigan State,3,5,8,0.375
vs. FBS Non-Winning,2019,Michigan State,4,1,5,0.8
vs. BCS AQ,2019,Michigan State,6,6,12,0.5
vs. BCS non-AQ,2019,Michigan State,1,0,1,1.0
vs. FBS Power 5,2019,Michigan State,5,6,11,0.45454545454545453
vs. FBS non-Power 5,2019,Michigan State,2,0,2,1.0
in August/September,2019,Michigan State,4,1,5,0.8
in October,2019,Michigan State,0,3,3,0.0
in November,2019,Michigan State,2,2,4,0.5
in December/January,2019,Michigan State,1,0,1,1.0
All Games,2020,Michigan State,2,5,7,0.2857142857142857
at Home,2020,Michigan State,1,3,4,0.25
on Road/Neutral Site,2020,Michigan State,1,2,3,0.3333333333333333
vs. Conference,2020,Michigan State,2,5,7,0.2857142857142857
vs. Non-Conference,2020,Michigan State,0,0,0,
vs. Ranked (AP),2020,Michigan State,1,3,4,0.25
vs. Unranked (AP),2020,Michigan State,1,2,3,0.3333333333333333
vs. FBS (I-A),2020,Michigan State,2,5,7,0.2857142857142857
vs. FCS (I-AA),2020,Michigan State,0,0,0,
vs. FBS Winning,2020,Michigan State,1,3,4,0.25
vs. FBS Non-Winning,2020,Michigan State,1,2,3,0.3333333333333333
vs. BCS AQ,2020,Michigan State,2,5,7,0.2857142857142857
vs. BCS non-AQ,2020,Michigan State,0,0,0,
vs. FBS Power 5,2020,Michigan State,2,5,7,0.2857142857142857
vs. FBS non-Power 5,2020,Michigan State,0,0,0,
in August/September,2020,Michigan State,0,0,0,
in October,2020,Michigan State,1,1,2,0.5
in November,2020,Michigan State,1,2,3,0.3333333333333333
in December/January,2020,Michigan State,0,2,2,0.0
All Games,2021,Michigan State,11,2,13,0.8461538461538461
at Home,2021,Michigan State,6,0,6,1.0
on Road/Neutral Site,2021,Michigan State,5,2,7,0.7142857142857143
vs. Conference,2021,Michigan State,7,2,9,0.7777777777777778
vs. Non-Conference,2021,Michigan State,4,0,4,1.0
vs. Ranked (AP),2021,Michigan State,2,1,3,0.6666666666666666
vs. Unranked (AP),2021,Michigan State,9,1,10,0.9
vs. FBS (I-A),2021,Michigan State,10,2,12,0.8333333333333334
vs. FCS (I-AA),2021,Michigan State,1,0,1,1.0
vs. FBS Winning,2021,Michigan State,6,2,8,0.75
vs. FBS Non-Winning,2021,Michigan State,4,0,4,1.0
vs. BCS AQ,2021,Michigan State,9,2,11,0.8181818181818182
vs. BCS non-AQ,2021,Michigan State,1,0,1,1.0
vs. FBS Power 5,2021,Michigan State,9,2,11,0.8181818181818182
vs. FBS non-Power 5,2021,Michigan State,1,0,1,1.0
in August/September,2021,Michigan State,4,0,4,1.0
in October,2021,Michigan State,4,0,4,1.0
in November,2021,Michigan State,2,2,4,0.5
in December/January,2021,Michigan State,1,0,1,1.0
All Games,2022,Michigan State,5,7,12,0.4166666666666667
at Home,2022,Michigan State,4,3,7,0.5714285714285714
on Road/Neutral Site,2022,Michigan State,1,4,5,0.2
vs. Conference,2022,Michigan State,3,6,9,0.3333333333333333
vs. Non-Conference,2022,Michigan State,2,1,3,0.6666666666666666
vs. Ranked (AP),2022,Michigan State,0,4,4,0.0
vs. Unranked (AP),2022,Michigan State,5,3,8,0.625
vs. FBS (I-A),2022,Michigan State,5,7,12,0.4166666666666667
vs. FCS (I-AA),2022,Michigan State,0,0,0,
vs. FBS Winning,2022,Michigan State,2,6,8,0.25
vs. FBS Non-Winning,2022,Michigan State,3,1,4,0.75
vs. BCS AQ,2022,Michigan State,3,7,10,0.3
vs. BCS non-AQ,2022,Michigan State,2,0,2,1.0
vs. FBS Power 5,2022,Michigan State,3,7,10,0.3
vs. FBS non-Power 5,2022,Michigan State,2,0,2,1.0
in August/September,2022,Michigan State,2,2,4,0.5
in October,2022,Michigan State,1,3,4,0.25
in November,2022,Michigan State,2,2,4,0.5
in December/January,2022,Michigan State,0,0,0,
All Games,2009,Middle Tennessee,10,3,13,0.7692307692307693
at Home,2009,Middle Tennessee,5,1,6,0.8333333333333334
on Road/Neutral Site,2009,Middle Tennessee,5,2,7,0.7142857142857143
vs. Conference,2009,Middle Tennessee,7,1,8,0.875
vs. Non-Conference,2009,Middle Tennessee,3,2,5,0.6
vs. Ranked (AP),2009,Middle Tennessee,0,1,1,0.0
vs. Unranked (AP),2009,Middle Tennessee,10,2,12,0.8333333333333334
vs. FBS (I-A),2009,Middle Tennessee,10,3,13,0.7692307692307693
vs. FCS (I-AA),2009,Middle Tennessee,0,0,0,
vs. FBS Winning,2009,Middle Tennessee,1,2,3,0.3333333333333333
vs. FBS Non-Winning,2009,Middle Tennessee,9,1,10,0.9
vs. BCS AQ,2009,Middle Tennessee,1,2,3,0.3333333333333333
vs. BCS non-AQ,2009,Middle Tennessee,9,1,10,0.9
vs. FBS Power 5,2009,Middle Tennessee,1,2,3,0.3333333333333333
vs. FBS non-Power 5,2009,Middle Tennessee,9,1,10,0.9
in August/September,2009,Middle Tennessee,3,1,4,0.75
in October,2009,Middle Tennessee,2,2,4,0.5
in November,2009,Middle Tennessee,4,0,4,1.0
in December/January,2009,Middle Tennessee,1,0,1,1.0
All Games,2010,Middle Tennessee,6,7,13,0.46153846153846156
at Home,2010,Middle Tennessee,3,3,6,0.5
on Road/Neutral Site,2010,Middle Tennessee,3,4,7,0.42857142857142855
vs. Conference,2010,Middle Tennessee,5,3,8,0.625
vs. Non-Conference,2010,Middle Tennessee,1,4,5,0.2
vs. Ranked (AP),2010,Middle Tennessee,0,0,0,
vs. Unranked (AP),2010,Middle Tennessee,6,7,13,0.46153846153846156
vs. FBS (I-A),2010,Middle Tennessee,5,7,12,0.4166666666666667
vs. FCS (I-AA),2010,Middle Tennessee,1,0,1,1.0
vs. FBS Winning,2010,Middle Tennessee,1,2,3,0.3333333333333333
vs. FBS Non-Winning,2010,Middle Tennessee,4,5,9,0.4444444444444444
vs. BCS AQ,2010,Middle Tennessee,0,2,2,0.0
vs. BCS non-AQ,2010,Middle Tennessee,5,5,10,0.5
vs. FBS Power 5,2010,Middle Tennessee,0,2,2,0.0
vs. FBS non-Power 5,2010,Middle Tennessee,5,5,10,0.5
in August/September,2010,Middle Tennessee,2,2,4,0.5
in October,2010,Middle Tennessee,1,2,3,0.3333333333333333
in November,2010,Middle Tennessee,2,2,4,0.5
in December/January,2010,Middle Tennessee,1,1,2,0.5
All Games,2011,Middle Tennessee,2,10,12,0.16666666666666666
at Home,2011,Middle Tennessee,1,5,6,0.16666666666666666
on Road/Neutral Site,2011,Middle Tennessee,1,5,6,0.16666666666666666
vs. Conference,2011,Middle Tennessee,1,7,8,0.125
vs. Non-Conference,2011,Middle Tennessee,1,3,4,0.25
vs. Ranked (AP),2011,Middle Tennessee,0,0,0,
vs. Unranked (AP),2011,Middle Tennessee,2,10,12,0.16666666666666666
vs. FBS (I-A),2011,Middle Tennessee,2,10,12,0.16666666666666666
vs. FCS (I-AA),2011,Middle Tennessee,0,0,0,
vs. FBS Winning,2011,Middle Tennessee,0,6,6,0.0
vs. FBS Non-Winning,2011,Middle Tennessee,2,4,6,0.3333333333333333
vs. BCS AQ,2011,Middle Tennessee,0,3,3,0.0
vs. BCS non-AQ,2011,Middle Tennessee,2,7,9,0.2222222222222222
vs. FBS Power 5,2011,Middle Tennessee,0,3,3,0.0
vs. FBS non-Power 5,2011,Middle Tennessee,2,7,9,0.2222222222222222
in August/September,2011,Middle Tennessee,0,3,3,0.0
in October,2011,Middle Tennessee,2,2,4,0.5
in November,2011,Middle Tennessee,0,4,4,0.0
in December/January,2011,Middle Tennessee,0,1,1,0.0
All Games,2012,Middle Tennessee,8,4,12,0.6666666666666666
at Home,2012,Middle Tennessee,3,2,5,0.6
on Road/Neutral Site,2012,Middle Tennessee,5,2,7,0.7142857142857143
vs. Conference,2012,Middle Tennessee,6,2,8,0.75
vs. Non-Conference,2012,Middle Tennessee,2,2,4,0.5
vs. Ranked (AP),2012,Middle Tennessee,0,0,0,
vs. Unranked (AP),2012,Middle Tennessee,8,4,12,0.6666666666666666
vs. FBS (I-A),2012,Middle Tennessee,8,3,11,0.7272727272727273
vs. FCS (I-AA),2012,Middle Tennessee,0,1,1,0.0
vs. FBS Winning,2012,Middle Tennessee,1,3,4,0.25
vs. FBS Non-Winning,2012,Middle Tennessee,7,0,7,1.0
vs. BCS AQ,2012,Middle Tennessee,1,1,2,0.5
vs. BCS non-AQ,2012,Middle Tennessee,7,2,9,0.7777777777777778
vs. FBS Power 5,2012,Middle Tennessee,1,1,2,0.5
vs. FBS non-Power 5,2012,Middle Tennessee,7,2,9,0.7777777777777778
in August/September,2012,Middle Tennessee,3,1,4,0.75
in October,2012,Middle Tennessee,2,2,4,0.5
in November,2012,Middle Tennessee,3,0,3,1.0
in December/January,2012,Middle Tennessee,0,1,1,0.0
All Games,2013,Middle Tennessee,8,5,13,0.6153846153846154
at Home,2013,Middle Tennessee,5,1,6,0.8333333333333334
on Road/Neutral Site,2013,Middle Tennessee,3,4,7,0.42857142857142855
vs. Conference,2013,Middle Tennessee,6,2,8,0.75
vs. Non-Conference,2013,Middle Tennessee,2,3,5,0.4
vs. Ranked (AP),2013,Middle Tennessee,0,0,0,
vs. Unranked (AP),2013,Middle Tennessee,8,5,13,0.6153846153846154
vs. FBS (I-A),2013,Middle Tennessee,7,5,12,0.5833333333333334
vs. FCS (I-AA),2013,Middle Tennessee,1,0,1,1.0
vs. FBS Winning,2013,Middle Tennessee,1,5,6,0.16666666666666666
vs. FBS Non-Winning,2013,Middle Tennessee,6,0,6,1.0
vs. BCS AQ,2013,Middle Tennessee,1,1,2,0.5
vs. BCS non-AQ,2013,Middle Tennessee,6,4,10,0.6
vs. FBS Power 5,2013,Middle Tennessee,0,1,1,0.0
vs. FBS non-Power 5,2013,Middle Tennessee,7,4,11,0.6363636363636364
in August/September,2013,Middle Tennessee,3,2,5,0.6
in October,2013,Middle Tennessee,1,2,3,0.3333333333333333
in November,2013,Middle Tennessee,4,0,4,1.0
in December/January,2013,Middle Tennessee,0,1,1,0.0
All Games,2014,Middle Tennessee,6,6,12,0.5
at Home,2014,Middle Tennessee,5,1,6,0.8333333333333334
on Road/Neutral Site,2014,Middle Tennessee,1,5,6,0.16666666666666666
vs. Conference,2014,Middle Tennessee,5,3,8,0.625
vs. Non-Conference,2014,Middle Tennessee,1,3,4,0.25
vs. Ranked (AP),2014,Middle Tennessee,0,2,2,0.0
vs. Unranked (AP),2014,Middle Tennessee,6,4,10,0.6
vs. FBS (I-A),2014,Middle Tennessee,5,6,11,0.45454545454545453
vs. FCS (I-AA),2014,Middle Tennessee,1,0,1,1.0
vs. FBS Winning,2014,Middle Tennessee,1,5,6,0.16666666666666666
vs. FBS Non-Winning,2014,Middle Tennessee,4,1,5,0.8
vs. BCS AQ,2014,Middle Tennessee,0,2,2,0.0
vs. BCS non-AQ,2014,Middle Tennessee,5,4,9,0.5555555555555556
vs. FBS Power 5,2014,Middle Tennessee,0,1,1,0.0
vs. FBS non-Power 5,2014,Middle Tennessee,5,5,10,0.5
in August/September,2014,Middle Tennessee,3,2,5,0.6
in October,2014,Middle Tennessee,2,1,3,0.6666666666666666
in November,2014,Middle Tennessee,1,3,4,0.25
in December/January,2014,Middle Tennessee,0,0,0,
All Games,2015,Middle Tennessee,7,6,13,0.5384615384615384
at Home,2015,Middle Tennessee,5,1,6,0.8333333333333334
on Road/Neutral Site,2015,Middle Tennessee,2,5,7,0.2857142857142857
vs. Conference,2015,Middle Tennessee,6,2,8,0.75
vs. Non-Conference,2015,Middle Tennessee,1,4,5,0.2
vs. Ranked (AP),2015,Middle Tennessee,0,2,2,0.0
vs. Unranked (AP),2015,Middle Tennessee,7,4,11,0.6363636363636364
vs. FBS (I-A),2015,Middle Tennessee,6,6,12,0.5
vs. FCS (I-AA),2015,Middle Tennessee,1,0,1,1.0
vs. FBS Winning,2015,Middle Tennessee,1,4,5,0.2
vs. FBS Non-Winning,2015,Middle Tennessee,5,2,7,0.7142857142857143
vs. BCS AQ,2015,Middle Tennessee,0,3,3,0.0
vs. BCS non-AQ,2015,Middle Tennessee,6,3,9,0.6666666666666666
vs. FBS Power 5,2015,Middle Tennessee,0,3,3,0.0
vs. FBS non-Power 5,2015,Middle Tennessee,6,3,9,0.6666666666666666
in August/September,2015,Middle Tennessee,2,2,4,0.5
in October,2015,Middle Tennessee,1,3,4,0.25
in November,2015,Middle Tennessee,4,0,4,1.0
in December/January,2015,Middle Tennessee,0,1,1,0.0
All Games,2016,Middle Tennessee,8,5,13,0.6153846153846154
at Home,2016,Middle Tennessee,3,2,5,0.6
on Road/Neutral Site,2016,Middle Tennessee,5,3,8,0.625
vs. Conference,2016,Middle Tennessee,5,3,8,0.625
vs. Non-Conference,2016,Middle Tennessee,3,2,5,0.6
vs. Ranked (AP),2016,Middle Tennessee,0,0,0,
vs. Unranked (AP),2016,Middle Tennessee,8,5,13,0.6153846153846154
vs. FBS (I-A),2016,Middle Tennessee,7,5,12,0.5833333333333334
vs. FCS (I-AA),2016,Middle Tennessee,1,0,1,1.0
vs. FBS Winning,2016,Middle Tennessee,1,1,2,0.5
vs. FBS Non-Winning,2016,Middle Tennessee,6,4,10,0.6
vs. BCS AQ,2016,Middle Tennessee,1,1,2,0.5
vs. BCS non-AQ,2016,Middle Tennessee,6,4,10,0.6
vs. FBS Power 5,2016,Middle Tennessee,1,1,2,0.5
vs. FBS non-Power 5,2016,Middle Tennessee,6,4,10,0.6
in August/September,2016,Middle Tennessee,3,1,4,0.75
in October,2016,Middle Tennessee,3,1,4,0.75
in November,2016,Middle Tennessee,2,2,4,0.5
in December/January,2016,Middle Tennessee,0,1,1,0.0
All Games,2017,Middle Tennessee,7,6,13,0.5384615384615384
at Home,2017,Middle Tennessee,4,2,6,0.6666666666666666
on Road/Neutral Site,2017,Middle Tennessee,3,4,7,0.42857142857142855
vs. Conference,2017,Middle Tennessee,4,4,8,0.5
vs. Non-Conference,2017,Middle Tennessee,3,2,5,0.6
vs. Ranked (AP),2017,Middle Tennessee,0,0,0,
vs. Unranked (AP),2017,Middle Tennessee,7,6,13,0.5384615384615384
vs. FBS (I-A),2017,Middle Tennessee,7,6,13,0.5384615384615384
vs. FCS (I-AA),2017,Middle Tennessee,0,0,0,
vs. FBS Winning,2017,Middle Tennessee,2,3,5,0.4
vs. FBS Non-Winning,2017,Middle Tennessee,5,3,8,0.625
vs. BCS AQ,2017,Middle Tennessee,1,2,3,0.3333333333333333
vs. BCS non-AQ,2017,Middle Tennessee,6,4,10,0.6
vs. FBS Power 5,2017,Middle Tennessee,1,2,3,0.3333333333333333
vs. FBS non-Power 5,2017,Middle Tennessee,6,4,10,0.6
in August/September,2017,Middle Tennessee,2,3,5,0.4
in October,2017,Middle Tennessee,1,2,3,0.3333333333333333
in November,2017,Middle Tennessee,3,1,4,0.75
in December/January,2017,Middle Tennessee,1,0,1,1.0
All Games,2018,Middle Tennessee,8,6,14,0.5714285714285714
at Home,2018,Middle Tennessee,5,1,6,0.8333333333333334
on Road/Neutral Site,2018,Middle Tennessee,3,5,8,0.375
vs. Conference,2018,Middle Tennessee,7,2,9,0.7777777777777778
vs. Non-Conference,2018,Middle Tennessee,1,4,5,0.2
vs. Ranked (AP),2018,Middle Tennessee,0,2,2,0.0
vs. Unranked (AP),2018,Middle Tennessee,8,4,12,0.6666666666666666
vs. FBS (I-A),2018,Middle Tennessee,7,6,13,0.5384615384615384
vs. FCS (I-AA),2018,Middle Tennessee,1,0,1,1.0
vs. FBS Winning,2018,Middle Tennessee,2,5,7,0.2857142857142857
vs. FBS Non-Winning,2018,Middle Tennessee,5,1,6,0.8333333333333334
vs. BCS AQ,2018,Middle Tennessee,0,3,3,0.0
vs. BCS non-AQ,2018,Middle Tennessee,7,3,10,0.7
vs. FBS Power 5,2018,Middle Tennessee,0,3,3,0.0
vs. FBS non-Power 5,2018,Middle Tennessee,7,3,10,0.7
in August/September,2018,Middle Tennessee,2,2,4,0.5
in October,2018,Middle Tennessee,3,1,4,0.75
in November,2018,Middle Tennessee,3,1,4,0.75
in December/January,2018,Middle Tennessee,0,2,2,0.0
All Games,2019,Middle Tennessee,4,8,12,0.3333333333333333
at Home,2019,Middle Tennessee,4,2,6,0.6666666666666666
on Road/Neutral Site,2019,Middle Tennessee,0,6,6,0.0
vs. Conference,2019,Middle Tennessee,3,5,8,0.375
vs. Non-Conference,2019,Middle Tennessee,1,3,4,0.25
vs. Ranked (AP),2019,Middle Tennessee,0,2,2,0.0
vs. Unranked (AP),2019,Middle Tennessee,4,6,10,0.4
vs. FBS (I-A),2019,Middle Tennessee,3,8,11,0.2727272727272727
vs. FCS (I-AA),2019,Middle Tennessee,1,0,1,1.0
vs. FBS Winning,2019,Middle Tennessee,1,5,6,0.16666666666666666
vs. FBS Non-Winning,2019,Middle Tennessee,2,3,5,0.4
vs. BCS AQ,2019,Middle Tennessee,0,3,3,0.0
vs. BCS non-AQ,2019,Middle Tennessee,3,5,8,0.375
vs. FBS Power 5,2019,Middle Tennessee,0,3,3,0.0
vs. FBS non-Power 5,2019,Middle Tennessee,3,5,8,0.375
in August/September,2019,Middle Tennessee,1,3,4,0.25
in October,2019,Middle Tennessee,2,2,4,0.5
in November,2019,Middle Tennessee,1,3,4,0.25
in December/January,2019,Middle Tennessee,0,0,0,
All Games,2020,Middle Tennessee,3,6,9,0.3333333333333333
at Home,2020,Middle Tennessee,0,3,3,0.0
on Road/Neutral Site,2020,Middle Tennessee,3,3,6,0.5
vs. Conference,2020,Middle Tennessee,2,4,6,0.3333333333333333
vs. Non-Conference,2020,Middle Tennessee,1,2,3,0.3333333333333333
vs. Ranked (AP),2020,Middle Tennessee,0,0,0,
vs. Unranked (AP),2020,Middle Tennessee,3,6,9,0.3333333333333333
vs. FBS (I-A),2020,Middle Tennessee,3,6,9,0.3333333333333333
vs. FCS (I-AA),2020,Middle Tennessee,0,0,0,
vs. FBS Winning,2020,Middle Tennessee,0,3,3,0.0
vs. FBS Non-Winning,2020,Middle Tennessee,3,3,6,0.5
vs. BCS AQ,2020,Middle Tennessee,0,0,0,
vs. BCS non-AQ,2020,Middle Tennessee,3,6,9,0.3333333333333333
vs. FBS Power 5,2020,Middle Tennessee,0,0,0,
vs. FBS non-Power 5,2020,Middle Tennessee,3,6,9,0.3333333333333333
in August/September,2020,Middle Tennessee,0,3,3,0.0
in October,2020,Middle Tennessee,2,2,4,0.5
in November,2020,Middle Tennessee,1,1,2,0.5
in December/January,2020,Middle Tennessee,0,0,0,
All Games,2021,Middle Tennessee,7,6,13,0.5384615384615384
at Home,2021,Middle Tennessee,4,1,5,0.8
on Road/Neutral Site,2021,Middle Tennessee,3,5,8,0.375
vs. Conference,2021,Middle Tennessee,4,4,8,0.5
vs. Non-Conference,2021,Middle Tennessee,3,2,5,0.6
vs. Ranked (AP),2021,Middle Tennessee,0,0,0,
vs. Unranked (AP),2021,Middle Tennessee,7,6,13,0.5384615384615384
vs. FBS (I-A),2021,Middle Tennessee,6,6,12,0.5
vs. FCS (I-AA),2021,Middle Tennessee,1,0,1,1.0
vs. FBS Winning,2021,Middle Tennessee,2,3,5,0.4
vs. FBS Non-Winning,2021,Middle Tennessee,4,3,7,0.5714285714285714
vs. BCS AQ,2021,Middle Tennessee,0,1,1,0.0
vs. BCS non-AQ,2021,Middle Tennessee,6,5,11,0.5454545454545454
vs. FBS Power 5,2021,Middle Tennessee,0,1,1,0.0
vs. FBS non-Power 5,2021,Middle Tennessee,6,5,11,0.5454545454545454
in August/September,2021,Middle Tennessee,1,3,4,0.25
in October,2021,Middle Tennessee,3,1,4,0.75
in November,2021,Middle Tennessee,2,2,4,0.5
in December/January,2021,Middle Tennessee,1,0,1,1.0
All Games,2022,Middle Tennessee,8,5,13,0.6153846153846154
at Home,2022,Middle Tennessee,3,2,5,0.6
on Road/Neutral Site,2022,Middle Tennessee,5,3,8,0.625
vs. Conference,2022,Middle Tennessee,4,4,8,0.5
vs. Non-Conference,2022,Middle Tennessee,4,1,5,0.8
vs. Ranked (AP),2022,Middle Tennessee,0,0,0,
vs. Unranked (AP),2022,Middle Tennessee,8,5,13,0.6153846153846154
vs. FBS (I-A),2022,Middle Tennessee,7,5,12,0.5833333333333334
vs. FCS (I-AA),2022,Middle Tennessee,1,0,1,1.0
vs. FBS Winning,2022,Middle Tennessee,1,4,5,0.2
vs. FBS Non-Winning,2022,Middle Tennessee,6,1,7,0.8571428571428571
vs. BCS AQ,2022,Middle Tennessee,1,0,1,1.0
vs. BCS non-AQ,2022,Middle Tennessee,6,5,11,0.5454545454545454
vs. FBS Power 5,2022,Middle Tennessee,1,0,1,1.0
vs. FBS non-Power 5,2022,Middle Tennessee,6,5,11,0.5454545454545454
in August/September,2022,Middle Tennessee,3,2,5,0.6
in October,2022,Middle Tennessee,1,2,3,0.3333333333333333
in November,2022,Middle Tennessee,3,1,4,0.75
in December/January,2022,Middle Tennessee,1,0,1,1.0
All Games,2009,Minnesota,6,7,13,0.46153846153846156
at Home,2009,Minnesota,4,3,7,0.5714285714285714
on Road/Neutral Site,2009,Minnesota,2,4,6,0.3333333333333333
vs. Conference,2009,Minnesota,3,5,8,0.375
vs. Non-Conference,2009,Minnesota,3,2,5,0.6
vs. Ranked (AP),2009,Minnesota,0,4,4,0.0
vs. Unranked (AP),2009,Minnesota,6,3,9,0.6666666666666666
vs. FBS (I-A),2009,Minnesota,5,7,12,0.4166666666666667
vs. FCS (I-AA),2009,Minnesota,1,0,1,1.0
vs. FBS Winning,2009,Minnesota,2,6,8,0.25
vs. FBS Non-Winning,2009,Minnesota,3,1,4,0.75
vs. BCS AQ,2009,Minnesota,4,7,11,0.36363636363636365
vs. BCS non-AQ,2009,Minnesota,1,0,1,1.0
vs. FBS Power 5,2009,Minnesota,3,7,10,0.3
vs. FBS non-Power 5,2009,Minnesota,2,0,2,1.0
in August/September,2009,Minnesota,3,1,4,0.75
in October,2009,Minnesota,2,3,5,0.4
in November,2009,Minnesota,1,2,3,0.3333333333333333
in December/January,2009,Minnesota,0,1,1,0.0
All Games,2010,Minnesota,3,9,12,0.25
at Home,2010,Minnesota,1,6,7,0.14285714285714285
on Road/Neutral Site,2010,Minnesota,2,3,5,0.4
vs. Conference,2010,Minnesota,2,6,8,0.25
vs. Non-Conference,2010,Minnesota,1,3,4,0.25
vs. Ranked (AP),2010,Minnesota,0,3,3,0.0
vs. Unranked (AP),2010,Minnesota,3,6,9,0.3333333333333333
vs. FBS (I-A),2010,Minnesota,3,8,11,0.2727272727272727
vs. FCS (I-AA),2010,Minnesota,0,1,1,0.0
vs. FBS Winning,2010,Minnesota,2,7,9,0.2222222222222222
vs. FBS Non-Winning,2010,Minnesota,1,1,2,0.5
vs. BCS AQ,2010,Minnesota,2,7,9,0.2222222222222222
vs. BCS non-AQ,2010,Minnesota,1,1,2,0.5
vs. FBS Power 5,2010,Minnesota,2,7,9,0.2222222222222222
vs. FBS non-Power 5,2010,Minnesota,1,1,2,0.5
in August/September,2010,Minnesota,1,3,4,0.25
in October,2010,Minnesota,0,5,5,0.0
in November,2010,Minnesota,2,1,3,0.6666666666666666
in December/January,2010,Minnesota,0,0,0,
All Games,2011,Minnesota,3,9,12,0.25
at Home,2011,Minnesota,3,4,7,0.42857142857142855
on Road/Neutral Site,2011,Minnesota,0,5,5,0.0
vs. Conference,2011,Minnesota,2,6,8,0.25
vs. Non-Conference,2011,Minnesota,1,3,4,0.25
vs. Ranked (AP),2011,Minnesota,0,5,5,0.0
vs. Unranked (AP),2011,Minnesota,3,4,7,0.42857142857142855
vs. FBS (I-A),2011,Minnesota,3,8,11,0.2727272727272727
vs. FCS (I-AA),2011,Minnesota,0,1,1,0.0
vs. FBS Winning,2011,Minnesota,2,6,8,0.25
vs. FBS Non-Winning,2011,Minnesota,1,2,3,0.3333333333333333
vs. BCS AQ,2011,Minnesota,2,7,9,0.2222222222222222
vs. BCS non-AQ,2011,Minnesota,1,1,2,0.5
vs. FBS Power 5,2011,Minnesota,2,7,9,0.2222222222222222
vs. FBS non-Power 5,2011,Minnesota,1,1,2,0.5
in August/September,2011,Minnesota,1,3,4,0.25
in October,2011,Minnesota,1,3,4,0.25
in November,2011,Minnesota,1,3,4,0.25
in December/January,2011,Minnesota,0,0,0,
All Games,2012,Minnesota,6,7,13,0.46153846153846156
at Home,2012,Minnesota,4,3,7,0.5714285714285714
on Road/Neutral Site,2012,Minnesota,2,4,6,0.3333333333333333
vs. Conference,2012,Minnesota,2,6,8,0.25
vs. Non-Conference,2012,Minnesota,4,1,5,0.8
vs. Ranked (AP),2012,Minnesota,0,3,3,0.0
vs. Unranked (AP),2012,Minnesota,6,4,10,0.6
vs. FBS (I-A),2012,Minnesota,5,7,12,0.4166666666666667
vs. FCS (I-AA),2012,Minnesota,1,0,1,1.0
vs. FBS Winning,2012,Minnesota,1,6,7,0.14285714285714285
vs. FBS Non-Winning,2012,Minnesota,4,1,5,0.8
vs. BCS AQ,2012,Minnesota,3,7,10,0.3
vs. BCS non-AQ,2012,Minnesota,2,0,2,1.0
vs. FBS Power 5,2012,Minnesota,2,7,9,0.2222222222222222
vs. FBS non-Power 5,2012,Minnesota,3,0,3,1.0
in August/September,2012,Minnesota,4,1,5,0.8
in October,2012,Minnesota,1,2,3,0.3333333333333333
in November,2012,Minnesota,1,3,4,0.25
in December/January,2012,Minnesota,0,1,1,0.0
All Games,2013,Minnesota,8,5,13,0.6153846153846154
at Home,2013,Minnesota,5,2,7,0.7142857142857143
on Road/Neutral Site,2013,Minnesota,3,3,6,0.5
vs. Conference,2013,Minnesota,4,4,8,0.5
vs. Non-Conference,2013,Minnesota,4,1,5,0.8
vs. Ranked (AP),2013,Minnesota,0,2,2,0.0
vs. Unranked (AP),2013,Minnesota,8,3,11,0.7272727272727273
vs. FBS (I-A),2013,Minnesota,7,5,12,0.5833333333333334
vs. FCS (I-AA),2013,Minnesota,1,0,1,1.0
vs. FBS Winning,2013,Minnesota,3,5,8,0.375
vs. FBS Non-Winning,2013,Minnesota,4,0,4,1.0
vs. BCS AQ,2013,Minnesota,4,5,9,0.4444444444444444
vs. BCS non-AQ,2013,Minnesota,3,0,3,1.0
vs. FBS Power 5,2013,Minnesota,4,5,9,0.4444444444444444
vs. FBS non-Power 5,2013,Minnesota,3,0,3,1.0
in August/September,2013,Minnesota,4,1,5,0.8
in October,2013,Minnesota,2,1,3,0.6666666666666666
in November,2013,Minnesota,2,2,4,0.5
in December/January,2013,Minnesota,0,1,1,0.0
All Games,2014,Minnesota,8,5,13,0.6153846153846154
at Home,2014,Minnesota,6,1,7,0.8571428571428571
on Road/Neutral Site,2014,Minnesota,2,4,6,0.3333333333333333
vs. Conference,2014,Minnesota,5,3,8,0.625
vs. Non-Conference,2014,Minnesota,3,2,5,0.6
vs. Ranked (AP),2014,Minnesota,0,4,4,0.0
vs. Unranked (AP),2014,Minnesota,8,1,9,0.8888888888888888
vs. FBS (I-A),2014,Minnesota,7,5,12,0.5833333333333334
vs. FCS (I-AA),2014,Minnesota,1,0,1,1.0
vs. FBS Winning,2014,Minnesota,2,4,6,0.3333333333333333
vs. FBS Non-Winning,2014,Minnesota,5,1,6,0.8333333333333334
vs. BCS AQ,2014,Minnesota,5,5,10,0.5
vs. BCS non-AQ,2014,Minnesota,2,0,2,1.0
vs. FBS Power 5,2014,Minnesota,5,5,10,0.5
vs. FBS non-Power 5,2014,Minnesota,2,0,2,1.0
in August/September,2014,Minnesota,4,1,5,0.8
in October,2014,Minnesota,2,1,3,0.6666666666666666
in November,2014,Minnesota,2,2,4,0.5
in December/January,2014,Minnesota,0,1,1,0.0
All Games,2015,Minnesota,6,7,13,0.46153846153846156
at Home,2015,Minnesota,3,4,7,0.42857142857142855
on Road/Neutral Site,2015,Minnesota,3,3,6,0.5
vs. Conference,2015,Minnesota,2,6,8,0.25
vs. Non-Conference,2015,Minnesota,4,1,5,0.8
vs. Ranked (AP),2015,Minnesota,0,6,6,0.0
vs. Unranked (AP),2015,Minnesota,6,1,7,0.8571428571428571
vs. FBS (I-A),2015,Minnesota,6,7,13,0.46153846153846156
vs. FCS (I-AA),2015,Minnesota,0,0,0,
vs. FBS Winning,2015,Minnesota,3,6,9,0.3333333333333333
vs. FBS Non-Winning,2015,Minnesota,3,1,4,0.75
vs. BCS AQ,2015,Minnesota,2,7,9,0.2222222222222222
vs. BCS non-AQ,2015,Minnesota,4,0,4,1.0
vs. FBS Power 5,2015,Minnesota,2,7,9,0.2222222222222222
vs. FBS non-Power 5,2015,Minnesota,4,0,4,1.0
in August/September,2015,Minnesota,3,1,4,0.75
in October,2015,Minnesota,1,3,4,0.25
in November,2015,Minnesota,1,3,4,0.25
in December/January,2015,Minnesota,1,0,1,1.0
All Games,2016,Minnesota,9,4,13,0.6923076923076923
at Home,2016,Minnesota,6,1,7,0.8571428571428571
on Road/Neutral Site,2016,Minnesota,3,3,6,0.5
vs. Conference,2016,Minnesota,5,4,9,0.5555555555555556
vs. Non-Conference,2016,Minnesota,4,0,4,1.0
vs. Ranked (AP),2016,Minnesota,0,4,4,0.0
vs. Unranked (AP),2016,Minnesota,9,0,9,1.0
vs. FBS (I-A),2016,Minnesota,8,4,12,0.6666666666666666
vs. FCS (I-AA),2016,Minnesota,1,0,1,1.0
vs. FBS Winning,2016,Minnesota,3,4,7,0.42857142857142855
vs. FBS Non-Winning,2016,Minnesota,5,0,5,1.0
vs. BCS AQ,2016,Minnesota,7,4,11,0.6363636363636364
vs. BCS non-AQ,2016,Minnesota,1,0,1,1.0
vs. FBS Power 5,2016,Minnesota,7,4,11,0.6363636363636364
vs. FBS non-Power 5,2016,Minnesota,1,0,1,1.0
in August/September,2016,Minnesota,3,0,3,1.0
in October,2016,Minnesota,3,2,5,0.6
in November,2016,Minnesota,2,2,4,0.5
in December/January,2016,Minnesota,1,0,1,1.0
All Games,2017,Minnesota,5,7,12,0.4166666666666667
at Home,2017,Minnesota,4,3,7,0.5714285714285714
on Road/Neutral Site,2017,Minnesota,1,4,5,0.2
vs. Conference,2017,Minnesota,2,7,9,0.2222222222222222
vs. Non-Conference,2017,Minnesota,3,0,3,1.0
vs. Ranked (AP),2017,Minnesota,0,3,3,0.0
vs. Unranked (AP),2017,Minnesota,5,4,9,0.5555555555555556
vs. FBS (I-A),2017,Minnesota,5,7,12,0.4166666666666667
vs. FCS (I-AA),2017,Minnesota,0,0,0,
vs. FBS Winning,2017,Minnesota,1,6,7,0.14285714285714285
vs. FBS Non-Winning,2017,Minnesota,4,1,5,0.8
vs. BCS AQ,2017,Minnesota,3,7,10,0.3
vs. BCS non-AQ,2017,Minnesota,2,0,2,1.0
vs. FBS Power 5,2017,Minnesota,3,7,10,0.3
vs. FBS non-Power 5,2017,Minnesota,2,0,2,1.0
in August/September,2017,Minnesota,3,1,4,0.75
in October,2017,Minnesota,1,3,4,0.25
in November,2017,Minnesota,1,3,4,0.25
in December/January,2017,Minnesota,0,0,0,
All Games,2018,Minnesota,7,6,13,0.5384615384615384
at Home,2018,Minnesota,5,2,7,0.7142857142857143
on Road/Neutral Site,2018,Minnesota,2,4,6,0.3333333333333333
vs. Conference,2018,Minnesota,3,6,9,0.3333333333333333
vs. Non-Conference,2018,Minnesota,4,0,4,1.0
vs. Ranked (AP),2018,Minnesota,1,3,4,0.25
vs. Unranked (AP),2018,Minnesota,6,3,9,0.6666666666666666
vs. FBS (I-A),2018,Minnesota,7,6,13,0.5384615384615384
vs. FCS (I-AA),2018,Minnesota,0,0,0,
vs. FBS Winning,2018,Minnesota,3,3,6,0.5
vs. FBS Non-Winning,2018,Minnesota,4,3,7,0.5714285714285714
vs. BCS AQ,2018,Minnesota,4,6,10,0.4
vs. BCS non-AQ,2018,Minnesota,3,0,3,1.0
vs. FBS Power 5,2018,Minnesota,4,6,10,0.4
vs. FBS non-Power 5,2018,Minnesota,3,0,3,1.0
in August/September,2018,Minnesota,3,1,4,0.75
in October,2018,Minnesota,1,3,4,0.25
in November,2018,Minnesota,2,2,4,0.5
in December/January,2018,Minnesota,1,0,1,1.0
All Games,2019,Minnesota,11,2,13,0.8461538461538461
at Home,2019,Minnesota,6,1,7,0.8571428571428571
on Road/Neutral Site,2019,Minnesota,5,1,6,0.8333333333333334
vs. Conference,2019,Minnesota,7,2,9,0.7777777777777778
vs. Non-Conference,2019,Minnesota,4,0,4,1.0
vs. Ranked (AP),2019,Minnesota,2,2,4,0.5
vs. Unranked (AP),2019,Minnesota,9,0,9,1.0
vs. FBS (I-A),2019,Minnesota,10,2,12,0.8333333333333334
vs. FCS (I-AA),2019,Minnesota,1,0,1,1.0
vs. FBS Winning,2019,Minnesota,3,2,5,0.6
vs. FBS Non-Winning,2019,Minnesota,7,0,7,1.0
vs. BCS AQ,2019,Minnesota,8,2,10,0.8
vs. BCS non-AQ,2019,Minnesota,2,0,2,1.0
vs. FBS Power 5,2019,Minnesota,8,2,10,0.8
vs. FBS non-Power 5,2019,Minnesota,2,0,2,1.0
in August/September,2019,Minnesota,4,0,4,1.0
in October,2019,Minnesota,4,0,4,1.0
in November,2019,Minnesota,2,2,4,0.5
in December/January,2019,Minnesota,1,0,1,1.0
All Games,2020,Minnesota,3,4,7,0.42857142857142855
at Home,2020,Minnesota,1,2,3,0.3333333333333333
on Road/Neutral Site,2020,Minnesota,2,2,4,0.5
vs. Conference,2020,Minnesota,3,4,7,0.42857142857142855
vs. Non-Conference,2020,Minnesota,0,0,0,
vs. Ranked (AP),2020,Minnesota,0,1,1,0.0
vs. Unranked (AP),2020,Minnesota,3,3,6,0.5
vs. FBS (I-A),2020,Minnesota,3,4,7,0.42857142857142855
vs. FCS (I-AA),2020,Minnesota,0,0,0,
vs. FBS Winning,2020,Minnesota,0,2,2,0.0
vs. FBS Non-Winning,2020,Minnesota,3,2,5,0.6
vs. BCS AQ,2020,Minnesota,3,4,7,0.42857142857142855
vs. BCS non-AQ,2020,Minnesota,0,0,0,
vs. FBS Power 5,2020,Minnesota,3,4,7,0.42857142857142855
vs. FBS non-Power 5,2020,Minnesota,0,0,0,
in August/September,2020,Minnesota,0,0,0,
in October,2020,Minnesota,0,2,2,0.0
in November,2020,Minnesota,2,1,3,0.6666666666666666
in December/January,2020,Minnesota,1,1,2,0.5
All Games,2021,Minnesota,9,4,13,0.6923076923076923
at Home,2021,Minnesota,4,3,7,0.5714285714285714
on Road/Neutral Site,2021,Minnesota,5,1,6,0.8333333333333334
vs. Conference,2021,Minnesota,6,3,9,0.6666666666666666
vs. Non-Conference,2021,Minnesota,3,1,4,0.75
vs. Ranked (AP),2021,Minnesota,0,2,2,0.0
vs. Unranked (AP),2021,Minnesota,9,2,11,0.8181818181818182
vs. FBS (I-A),2021,Minnesota,9,4,13,0.6923076923076923
vs. FCS (I-AA),2021,Minnesota,0,0,0,
vs. FBS Winning,2021,Minnesota,4,2,6,0.6666666666666666
vs. FBS Non-Winning,2021,Minnesota,5,2,7,0.7142857142857143
vs. BCS AQ,2021,Minnesota,8,3,11,0.7272727272727273
vs. BCS non-AQ,2021,Minnesota,1,1,2,0.5
vs. FBS Power 5,2021,Minnesota,8,3,11,0.7272727272727273
vs. FBS non-Power 5,2021,Minnesota,1,1,2,0.5
in August/September,2021,Minnesota,2,2,4,0.5
in October,2021,Minnesota,4,0,4,1.0
in November,2021,Minnesota,2,2,4,0.5
in December/January,2021,Minnesota,1,0,1,1.0
All Games,2022,Minnesota,9,4,13,0.6923076923076923
at Home,2022,Minnesota,5,2,7,0.7142857142857143
on Road/Neutral Site,2022,Minnesota,4,2,6,0.6666666666666666
vs. Conference,2022,Minnesota,5,4,9,0.5555555555555556
vs. Non-Conference,2022,Minnesota,4,0,4,1.0
vs. Ranked (AP),2022,Minnesota,0,1,1,0.0
vs. Unranked (AP),2022,Minnesota,9,3,12,0.75
vs. FBS (I-A),2022,Minnesota,8,4,12,0.6666666666666666
vs. FCS (I-AA),2022,Minnesota,1,0,1,1.0
vs. FBS Winning,2022,Minnesota,3,4,7,0.42857142857142855
vs. FBS Non-Winning,2022,Minnesota,5,0,5,1.0
vs. BCS AQ,2022,Minnesota,7,4,11,0.6363636363636364
vs. BCS non-AQ,2022,Minnesota,1,0,1,1.0
vs. FBS Power 5,2022,Minnesota,7,4,11,0.6363636363636364
vs. FBS non-Power 5,2022,Minnesota,1,0,1,1.0
in August/September,2022,Minnesota,4,0,4,1.0
in October,2022,Minnesota,1,3,4,0.25
in November,2022,Minnesota,3,1,4,0.75
in December/January,2022,Minnesota,1,0,1,1.0
All Games,2009,Mississippi,9,4,13,0.6923076923076923
at Home,2009,Mississippi,6,1,7,0.8571428571428571
on Road/Neutral Site,2009,Mississippi,3,3,6,0.5
vs. Conference,2009,Mississippi,4,4,8,0.5
vs. Non-Conference,2009,Mississippi,5,0,5,1.0
vs. Ranked (AP),2009,Mississippi,1,1,2,0.5
vs. Unranked (AP),2009,Mississippi,8,3,11,0.7272727272727273
vs. FBS (I-A),2009,Mississippi,7,4,11,0.6363636363636364
vs. FCS (I-AA),2009,Mississippi,2,0,2,1.0
vs. FBS Winning,2009,Mississippi,4,3,7,0.5714285714285714
vs. FBS Non-Winning,2009,Mississippi,3,1,4,0.75
vs. BCS AQ,2009,Mississippi,5,4,9,0.5555555555555556
vs. BCS non-AQ,2009,Mississippi,2,0,2,1.0
vs. FBS Power 5,2009,Mississippi,5,4,9,0.5555555555555556
vs. FBS non-Power 5,2009,Mississippi,2,0,2,1.0
in August/September,2009,Mississippi,2,1,3,0.6666666666666666
in October,2009,Mississippi,3,2,5,0.6
in November,2009,Mississippi,3,1,4,0.75
in December/January,2009,Mississippi,1,0,1,1.0
All Games,2010,Mississippi,4,8,12,0.3333333333333333
at Home,2010,Mississippi,3,4,7,0.42857142857142855
on Road/Neutral Site,2010,Mississippi,1,4,5,0.2
vs. Conference,2010,Mississippi,1,7,8,0.125
vs. Non-Conference,2010,Mississippi,3,1,4,0.75
vs. Ranked (AP),2010,Mississippi,0,5,5,0.0
vs. Unranked (AP),2010,Mississippi,4,3,7,0.5714285714285714
vs. FBS (I-A),2010,Mississippi,4,7,11,0.36363636363636365
vs. FCS (I-AA),2010,Mississippi,0,1,1,0.0
vs. FBS Winning,2010,Mississippi,1,5,6,0.16666666666666666
vs. FBS Non-Winning,2010,Mississippi,3,2,5,0.6
vs. BCS AQ,2010,Mississippi,1,7,8,0.125
vs. BCS non-AQ,2010,Mississippi,3,0,3,1.0
vs. FBS Power 5,2010,Mississippi,1,7,8,0.125
vs. FBS non-Power 5,2010,Mississippi,3,0,3,1.0
in August/September,2010,Mississippi,2,2,4,0.5
in October,2010,Mississippi,1,3,4,0.25
in November,2010,Mississippi,1,3,4,0.25
in December/January,2010,Mississippi,0,0,0,
All Games,2011,Mississippi,2,10,12,0.16666666666666666
at Home,2011,Mississippi,1,6,7,0.14285714285714285
on Road/Neutral Site,2011,Mississippi,1,4,5,0.2
vs. Conference,2011,Mississippi,0,8,8,0.0
vs. Non-Conference,2011,Mississippi,2,2,4,0.5
vs. Ranked (AP),2011,Mississippi,0,4,4,0.0
vs. Unranked (AP),2011,Mississippi,2,6,8,0.25
vs. FBS (I-A),2011,Mississippi,1,10,11,0.09090909090909091
vs. FCS (I-AA),2011,Mississippi,1,0,1,1.0
vs. FBS Winning,2011,Mississippi,0,8,8,0.0
vs. FBS Non-Winning,2011,Mississippi,1,2,3,0.3333333333333333
vs. BCS AQ,2011,Mississippi,0,8,8,0.0
vs. BCS non-AQ,2011,Mississippi,1,2,3,0.3333333333333333
vs. FBS Power 5,2011,Mississippi,0,8,8,0.0
vs. FBS non-Power 5,2011,Mississippi,1,2,3,0.3333333333333333
in August/September,2011,Mississippi,1,3,4,0.25
in October,2011,Mississippi,1,3,4,0.25
in November,2011,Mississippi,0,4,4,0.0
in December/January,2011,Mississippi,0,0,0,
All Games,2012,Mississippi,7,6,13,0.5384615384615384
at Home,2012,Mississippi,4,3,7,0.5714285714285714
on Road/Neutral Site,2012,Mississippi,3,3,6,0.5
vs. Conference,2012,Mississippi,3,5,8,0.375
vs. Non-Conference,2012,Mississippi,4,1,5,0.8
vs. Ranked (AP),2012,Mississippi,0,6,6,0.0
vs. Unranked (AP),2012,Mississippi,7,0,7,1.0
vs. FBS (I-A),2012,Mississippi,6,6,12,0.5
vs. FCS (I-AA),2012,Mississippi,1,0,1,1.0
vs. FBS Winning,2012,Mississippi,1,6,7,0.14285714285714285
vs. FBS Non-Winning,2012,Mississippi,5,0,5,1.0
vs. BCS AQ,2012,Mississippi,4,6,10,0.4
vs. BCS non-AQ,2012,Mississippi,2,0,2,1.0
vs. FBS Power 5,2012,Mississippi,3,6,9,0.3333333333333333
vs. FBS non-Power 5,2012,Mississippi,3,0,3,1.0
in August/September,2012,Mississippi,3,2,5,0.6
in October,2012,Mississippi,2,1,3,0.6666666666666666
in November,2012,Mississippi,1,3,4,0.25
in December/January,2012,Mississippi,1,0,1,1.0
All Games,2013,Mississippi,8,5,13,0.6153846153846154
at Home,2013,Mississippi,5,2,7,0.7142857142857143
on Road/Neutral Site,2013,Mississippi,3,3,6,0.5
vs. Conference,2013,Mississippi,3,5,8,0.375
vs. Non-Conference,2013,Mississippi,5,0,5,1.0
vs. Ranked (AP),2013,Mississippi,2,4,6,0.3333333333333333
vs. Unranked (AP),2013,Mississippi,6,1,7,0.8571428571428571
vs. FBS (I-A),2013,Mississippi,7,5,12,0.5833333333333334
vs. FCS (I-AA),2013,Mississippi,1,0,1,1.0
vs. FBS Winning,2013,Mississippi,4,5,9,0.4444444444444444
vs. FBS Non-Winning,2013,Mississippi,3,0,3,1.0
vs. BCS AQ,2013,Mississippi,5,5,10,0.5
vs. BCS non-AQ,2013,Mississippi,2,0,2,1.0
vs. FBS Power 5,2013,Mississippi,5,5,10,0.5
vs. FBS non-Power 5,2013,Mississippi,2,0,2,1.0
in August/September,2013,Mississippi,3,1,4,0.75
in October,2013,Mississippi,2,2,4,0.5
in November,2013,Mississippi,2,2,4,0.5
in December/January,2013,Mississippi,1,0,1,1.0
All Games,2014,Mississippi,9,4,13,0.6923076923076923
at Home,2014,Mississippi,6,1,7,0.8571428571428571
on Road/Neutral Site,2014,Mississippi,3,3,6,0.5
vs. Conference,2014,Mississippi,5,3,8,0.625
vs. Non-Conference,2014,Mississippi,4,1,5,0.8
vs. Ranked (AP),2014,Mississippi,4,2,6,0.6666666666666666
vs. Unranked (AP),2014,Mississippi,5,2,7,0.7142857142857143
vs. FBS (I-A),2014,Mississippi,8,4,12,0.6666666666666666
vs. FCS (I-AA),2014,Mississippi,1,0,1,1.0
vs. FBS Winning,2014,Mississippi,7,4,11,0.6363636363636364
vs. FBS Non-Winning,2014,Mississippi,1,0,1,1.0
vs. BCS AQ,2014,Mississippi,6,4,10,0.6
vs. BCS non-AQ,2014,Mississippi,2,0,2,1.0
vs. FBS Power 5,2014,Mississippi,5,4,9,0.5555555555555556
vs. FBS non-Power 5,2014,Mississippi,3,0,3,1.0
in August/September,2014,Mississippi,4,0,4,1.0
in October,2014,Mississippi,3,1,4,0.75
in November,2014,Mississippi,2,2,4,0.5
in December/January,2014,Mississippi,0,1,1,0.0
All Games,2015,Mississippi,10,3,13,0.7692307692307693
at Home,2015,Mississippi,6,1,7,0.8571428571428571
on Road/Neutral Site,2015,Mississippi,4,2,6,0.6666666666666666
vs. Conference,2015,Mississippi,6,2,8,0.75
vs. Non-Conference,2015,Mississippi,4,1,5,0.8
vs. Ranked (AP),2015,Mississippi,3,1,4,0.75
vs. Unranked (AP),2015,Mississippi,7,2,9,0.7777777777777778
vs. FBS (I-A),2015,Mississippi,9,3,12,0.75
vs. FCS (I-AA),2015,Mississippi,1,0,1,1.0
vs. FBS Winning,2015,Mississippi,6,3,9,0.6666666666666666
vs. FBS Non-Winning,2015,Mississippi,3,0,3,1.0
vs. BCS AQ,2015,Mississippi,7,3,10,0.7
vs. BCS non-AQ,2015,Mississippi,2,0,2,1.0
vs. FBS Power 5,2015,Mississippi,7,2,9,0.7777777777777778
vs. FBS non-Power 5,2015,Mississippi,2,1,3,0.6666666666666666
in August/September,2015,Mississippi,4,0,4,1.0
in October,2015,Mississippi,3,2,5,0.6
in November,2015,Mississippi,2,1,3,0.6666666666666666
in December/January,2015,Mississippi,1,0,1,1.0
All Games,2016,Mississippi,5,7,12,0.4166666666666667
at Home,2016,Mississippi,4,3,7,0.5714285714285714
on Road/Neutral Site,2016,Mississippi,1,4,5,0.2
vs. Conference,2016,Mississippi,2,6,8,0.25
vs. Non-Conference,2016,Mississippi,3,1,4,0.75
vs. Ranked (AP),2016,Mississippi,0,4,4,0.0
vs. Unranked (AP),2016,Mississippi,5,3,8,0.625
vs. FBS (I-A),2016,Mississippi,4,7,11,0.36363636363636365
vs. FCS (I-AA),2016,Mississippi,1,0,1,1.0
vs. FBS Winning,2016,Mississippi,3,5,8,0.375
vs. FBS Non-Winning,2016,Mississippi,1,2,3,0.3333333333333333
vs. BCS AQ,2016,Mississippi,3,7,10,0.3
vs. BCS non-AQ,2016,Mississippi,1,0,1,1.0
vs. FBS Power 5,2016,Mississippi,2,7,9,0.2222222222222222
vs. FBS non-Power 5,2016,Mississippi,2,0,2,1.0
in August/September,2016,Mississippi,2,2,4,0.5
in October,2016,Mississippi,1,3,4,0.25
in November,2016,Mississippi,2,2,4,0.5
in December/January,2016,Mississippi,0,0,0,
All Games,2017,Mississippi,6,6,12,0.5
at Home,2017,Mississippi,4,3,7,0.5714285714285714
on Road/Neutral Site,2017,Mississippi,2,3,5,0.4
vs. Conference,2017,Mississippi,3,5,8,0.375
vs. Non-Conference,2017,Mississippi,3,1,4,0.75
vs. Ranked (AP),2017,Mississippi,1,3,4,0.25
vs. Unranked (AP),2017,Mississippi,5,3,8,0.625
vs. FBS (I-A),2017,Mississippi,5,6,11,0.45454545454545453
vs. FCS (I-AA),2017,Mississippi,1,0,1,1.0
vs. FBS Winning,2017,Mississippi,2,4,6,0.3333333333333333
vs. FBS Non-Winning,2017,Mississippi,3,2,5,0.6
vs. BCS AQ,2017,Mississippi,3,6,9,0.3333333333333333
vs. BCS non-AQ,2017,Mississippi,2,0,2,1.0
vs. FBS Power 5,2017,Mississippi,3,6,9,0.3333333333333333
vs. FBS non-Power 5,2017,Mississippi,2,0,2,1.0
in August/September,2017,Mississippi,2,2,4,0.5
in October,2017,Mississippi,1,3,4,0.25
in November,2017,Mississippi,3,1,4,0.75
in December/January,2017,Mississippi,0,0,0,
All Games,2018,Mississippi,5,7,12,0.4166666666666667
at Home,2018,Mississippi,3,4,7,0.42857142857142855
on Road/Neutral Site,2018,Mississippi,2,3,5,0.4
vs. Conference,2018,Mississippi,1,7,8,0.125
vs. Non-Conference,2018,Mississippi,4,0,4,1.0
vs. Ranked (AP),2018,Mississippi,0,3,3,0.0
vs. Unranked (AP),2018,Mississippi,5,4,9,0.5555555555555556
vs. FBS (I-A),2018,Mississippi,4,7,11,0.36363636363636365
vs. FCS (I-AA),2018,Mississippi,1,0,1,1.0
vs. FBS Winning,2018,Mississippi,0,6,6,0.0
vs. FBS Non-Winning,2018,Mississippi,4,1,5,0.8
vs. BCS AQ,2018,Mississippi,2,7,9,0.2222222222222222
vs. BCS non-AQ,2018,Mississippi,2,0,2,1.0
vs. FBS Power 5,2018,Mississippi,2,7,9,0.2222222222222222
vs. FBS non-Power 5,2018,Mississippi,2,0,2,1.0
in August/September,2018,Mississippi,3,2,5,0.6
in October,2018,Mississippi,2,1,3,0.6666666666666666
in November,2018,Mississippi,0,4,4,0.0
in December/January,2018,Mississippi,0,0,0,
All Games,2019,Mississippi,4,8,12,0.3333333333333333
at Home,2019,Mississippi,4,3,7,0.5714285714285714
on Road/Neutral Site,2019,Mississippi,0,5,5,0.0
vs. Conference,2019,Mississippi,2,6,8,0.25
vs. Non-Conference,2019,Mississippi,2,2,4,0.5
vs. Ranked (AP),2019,Mississippi,0,4,4,0.0
vs. Unranked (AP),2019,Mississippi,4,4,8,0.5
vs. FBS (I-A),2019,Mississippi,3,8,11,0.2727272727272727
vs. FCS (I-AA),2019,Mississippi,1,0,1,1.0
vs. FBS Winning,2019,Mississippi,0,6,6,0.0
vs. FBS Non-Winning,2019,Mississippi,3,2,5,0.6
vs. BCS AQ,2019,Mississippi,2,8,10,0.2
vs. BCS non-AQ,2019,Mississippi,1,0,1,1.0
vs. FBS Power 5,2019,Mississippi,2,7,9,0.2222222222222222
vs. FBS non-Power 5,2019,Mississippi,1,1,2,0.5
in August/September,2019,Mississippi,2,3,5,0.4
in October,2019,Mississippi,1,2,3,0.3333333333333333
in November,2019,Mississippi,1,3,4,0.25
in December/January,2019,Mississippi,0,0,0,
All Games,2020,Mississippi,5,5,10,0.5
at Home,2020,Mississippi,2,3,5,0.4
on Road/Neutral Site,2020,Mississippi,3,2,5,0.6
vs. Conference,2020,Mississippi,4,5,9,0.4444444444444444
vs. Non-Conference,2020,Mississippi,1,0,1,1.0
vs. Ranked (AP),2020,Mississippi,1,2,3,0.3333333333333333
vs. Unranked (AP),2020,Mississippi,4,3,7,0.5714285714285714
vs. FBS (I-A),2020,Mississippi,5,5,10,0.5
vs. FCS (I-AA),2020,Mississippi,0,0,0,
vs. FBS Winning,2020,Mississippi,1,3,4,0.25
vs. FBS Non-Winning,2020,Mississippi,4,2,6,0.6666666666666666
vs. BCS AQ,2020,Mississippi,5,5,10,0.5
vs. BCS non-AQ,2020,Mississippi,0,0,0,
vs. FBS Power 5,2020,Mississippi,5,5,10,0.5
vs. FBS non-Power 5,2020,Mississippi,0,0,0,
in August/September,2020,Mississippi,0,1,1,0.0
in October,2020,Mississippi,2,3,5,0.4
in November,2020,Mississippi,2,0,2,1.0
in December/January,2020,Mississippi,1,1,2,0.5
All Games,2021,Mississippi,10,3,13,0.7692307692307693
at Home,2021,Mississippi,7,0,7,1.0
on Road/Neutral Site,2021,Mississippi,3,3,6,0.5
vs. Conference,2021,Mississippi,6,2,8,0.75
vs. Non-Conference,2021,Mississippi,4,1,5,0.8
vs. Ranked (AP),2021,Mississippi,1,2,3,0.3333333333333333
vs. Unranked (AP),2021,Mississippi,9,1,10,0.9
vs. FBS (I-A),2021,Mississippi,9,3,12,0.75
vs. FCS (I-AA),2021,Mississippi,1,0,1,1.0
vs. FBS Winning,2021,Mississippi,5,2,7,0.7142857142857143
vs. FBS Non-Winning,2021,Mississippi,4,1,5,0.8
vs. BCS AQ,2021,Mississippi,8,3,11,0.7272727272727273
vs. BCS non-AQ,2021,Mississippi,1,0,1,1.0
vs. FBS Power 5,2021,Mississippi,7,3,10,0.7
vs. FBS non-Power 5,2021,Mississippi,2,0,2,1.0
in August/September,2021,Mississippi,3,0,3,1.0
in October,2021,Mississippi,3,2,5,0.6
in November,2021,Mississippi,4,0,4,1.0
in December/January,2021,Mississippi,0,1,1,0.0
All Games,2022,Mississippi,8,5,13,0.6153846153846154
at Home,2022,Mississippi,5,2,7,0.7142857142857143
on Road/Neutral Site,2022,Mississippi,3,3,6,0.5
vs. Conference,2022,Mississippi,4,4,8,0.5
vs. Non-Conference,2022,Mississippi,4,1,5,0.8
vs. Ranked (AP),2022,Mississippi,1,3,4,0.25
vs. Unranked (AP),2022,Mississippi,7,2,9,0.7777777777777778
vs. FBS (I-A),2022,Mississippi,7,5,12,0.5833333333333334
vs. FCS (I-AA),2022,Mississippi,1,0,1,1.0
vs. FBS Winning,2022,Mississippi,2,5,7,0.2857142857142857
vs. FBS Non-Winning,2022,Mississippi,5,0,5,1.0
vs. BCS AQ,2022,Mississippi,6,5,11,0.5454545454545454
vs. BCS non-AQ,2022,Mississippi,1,0,1,1.0
vs. FBS Power 5,2022,Mississippi,5,5,10,0.5
vs. FBS non-Power 5,2022,Mississippi,2,0,2,1.0
in August/September,2022,Mississippi,4,0,4,1.0
in October,2022,Mississippi,4,1,5,0.8
in November,2022,Mississippi,0,3,3,0.0
in December/January,2022,Mississippi,0,1,1,0.0
All Games,2009,Mississippi State,5,7,12,0.4166666666666667
at Home,2009,Mississippi State,2,5,7,0.2857142857142857
on Road/Neutral Site,2009,Mississippi State,3,2,5,0.6
vs. Conference,2009,Mississippi State,3,5,8,0.375
vs. Non-Conference,2009,Mississippi State,2,2,4,0.5
vs. Ranked (AP),2009,Mississippi State,1,4,5,0.2
vs. Unranked (AP),2009,Mississippi State,4,3,7,0.5714285714285714
vs. FBS (I-A),2009,Mississippi State,4,7,11,0.36363636363636365
vs. FCS (I-AA),2009,Mississippi State,1,0,1,1.0
vs. FBS Winning,2009,Mississippi State,3,7,10,0.3
vs. FBS Non-Winning,2009,Mississippi State,1,0,1,1.0
vs. BCS AQ,2009,Mississippi State,3,6,9,0.3333333333333333
vs. BCS non-AQ,2009,Mississippi State,1,1,2,0.5
vs. FBS Power 5,2009,Mississippi State,3,6,9,0.3333333333333333
vs. FBS non-Power 5,2009,Mississippi State,1,1,2,0.5
in August/September,2009,Mississippi State,2,2,4,0.5
in October,2009,Mississippi State,2,3,5,0.4
in November,2009,Mississippi State,1,2,3,0.3333333333333333
in December/January,2009,Mississippi State,0,0,0,
All Games,2010,Mississippi State,9,4,13,0.6923076923076923
at Home,2010,Mississippi State,5,2,7,0.7142857142857143
on Road/Neutral Site,2010,Mississippi State,4,2,6,0.6666666666666666
vs. Conference,2010,Mississippi State,4,4,8,0.5
vs. Non-Conference,2010,Mississippi State,5,0,5,1.0
vs. Ranked (AP),2010,Mississippi State,0,4,4,0.0
vs. Unranked (AP),2010,Mississippi State,9,0,9,1.0
vs. FBS (I-A),2010,Mississippi State,8,4,12,0.6666666666666666
vs. FCS (I-AA),2010,Mississippi State,1,0,1,1.0
vs. FBS Winning,2010,Mississippi State,2,4,6,0.3333333333333333
vs. FBS Non-Winning,2010,Mississippi State,6,0,6,1.0
vs. BCS AQ,2010,Mississippi State,5,4,9,0.5555555555555556
vs. BCS non-AQ,2010,Mississippi State,3,0,3,1.0
vs. FBS Power 5,2010,Mississippi State,5,4,9,0.5555555555555556
vs. FBS non-Power 5,2010,Mississippi State,3,0,3,1.0
in August/September,2010,Mississippi State,2,2,4,0.5
in October,2010,Mississippi State,5,0,5,1.0
in November,2010,Mississippi State,1,2,3,0.3333333333333333
in December/January,2010,Mississippi State,1,0,1,1.0
All Games,2011,Mississippi State,7,6,13,0.5384615384615384
at Home,2011,Mississippi State,3,3,6,0.5
on Road/Neutral Site,2011,Mississippi State,4,3,7,0.5714285714285714
vs. Conference,2011,Mississippi State,2,6,8,0.25
vs. Non-Conference,2011,Mississippi State,5,0,5,1.0
vs. Ranked (AP),2011,Mississippi State,0,5,5,0.0
vs. Unranked (AP),2011,Mississippi State,7,1,8,0.875
vs. FBS (I-A),2011,Mississippi State,6,6,12,0.5
vs. FCS (I-AA),2011,Mississippi State,1,0,1,1.0
vs. FBS Winning,2011,Mississippi State,1,6,7,0.14285714285714285
vs. FBS Non-Winning,2011,Mississippi State,5,0,5,1.0
vs. BCS AQ,2011,Mississippi State,3,6,9,0.3333333333333333
vs. BCS non-AQ,2011,Mississippi State,3,0,3,1.0
vs. FBS Power 5,2011,Mississippi State,3,6,9,0.3333333333333333
vs. FBS non-Power 5,2011,Mississippi State,3,0,3,1.0
in August/September,2011,Mississippi State,2,2,4,0.5
in October,2011,Mississippi State,2,2,4,0.5
in November,2011,Mississippi State,2,2,4,0.5
in December/January,2011,Mississippi State,1,0,1,1.0
All Games,2012,Mississippi State,8,5,13,0.6153846153846154
at Home,2012,Mississippi State,6,1,7,0.8571428571428571
on Road/Neutral Site,2012,Mississippi State,2,4,6,0.3333333333333333
vs. Conference,2012,Mississippi State,4,4,8,0.5
vs. Non-Conference,2012,Mississippi State,4,1,5,0.8
vs. Ranked (AP),2012,Mississippi State,0,4,4,0.0
vs. Unranked (AP),2012,Mississippi State,8,1,9,0.8888888888888888
vs. FBS (I-A),2012,Mississippi State,7,5,12,0.5833333333333334
vs. FCS (I-AA),2012,Mississippi State,1,0,1,1.0
vs. FBS Winning,2012,Mississippi State,1,5,6,0.16666666666666666
vs. FBS Non-Winning,2012,Mississippi State,6,0,6,1.0
vs. BCS AQ,2012,Mississippi State,4,5,9,0.4444444444444444
vs. BCS non-AQ,2012,Mississippi State,3,0,3,1.0
vs. FBS Power 5,2012,Mississippi State,4,5,9,0.4444444444444444
vs. FBS non-Power 5,2012,Mississippi State,3,0,3,1.0
in August/September,2012,Mississippi State,4,0,4,1.0
in October,2012,Mississippi State,3,1,4,0.75
in November,2012,Mississippi State,1,3,4,0.25
in December/January,2012,Mississippi State,0,1,1,0.0
All Games,2013,Mississippi State,7,6,13,0.5384615384615384
at Home,2013,Mississippi State,5,2,7,0.7142857142857143
on Road/Neutral Site,2013,Mississippi State,2,4,6,0.3333333333333333
vs. Conference,2013,Mississippi State,3,5,8,0.375
vs. Non-Conference,2013,Mississippi State,4,1,5,0.8
vs. Ranked (AP),2013,Mississippi State,0,6,6,0.0
vs. Unranked (AP),2013,Mississippi State,7,0,7,1.0
vs. FBS (I-A),2013,Mississippi State,6,6,12,0.5
vs. FCS (I-AA),2013,Mississippi State,1,0,1,1.0
vs. FBS Winning,2013,Mississippi State,3,6,9,0.3333333333333333
vs. FBS Non-Winning,2013,Mississippi State,3,0,3,1.0
vs. BCS AQ,2013,Mississippi State,3,6,9,0.3333333333333333
vs. BCS non-AQ,2013,Mississippi State,3,0,3,1.0
vs. FBS Power 5,2013,Mississippi State,3,6,9,0.3333333333333333
vs. FBS non-Power 5,2013,Mississippi State,3,0,3,1.0
in August/September,2013,Mississippi State,2,2,4,0.5
in October,2013,Mississippi State,2,1,3,0.6666666666666666
in November,2013,Mississippi State,2,3,5,0.4
in December/January,2013,Mississippi State,1,0,1,1.0
All Games,2014,Mississippi State,10,3,13,0.7692307692307693
at Home,2014,Mississippi State,7,0,7,1.0
on Road/Neutral Site,2014,Mississippi State,3,3,6,0.5
vs. Conference,2014,Mississippi State,6,2,8,0.75
vs. Non-Conference,2014,Mississippi State,4,1,5,0.8
vs. Ranked (AP),2014,Mississippi State,1,3,4,0.25
vs. Unranked (AP),2014,Mississippi State,9,0,9,1.0
vs. FBS (I-A),2014,Mississippi State,9,3,12,0.75
vs. FCS (I-AA),2014,Mississippi State,1,0,1,1.0
vs. FBS Winning,2014,Mississippi State,4,3,7,0.5714285714285714
vs. FBS Non-Winning,2014,Mississippi State,5,0,5,1.0
vs. BCS AQ,2014,Mississippi State,6,3,9,0.6666666666666666
vs. BCS non-AQ,2014,Mississippi State,3,0,3,1.0
vs. FBS Power 5,2014,Mississippi State,6,3,9,0.6666666666666666
vs. FBS non-Power 5,2014,Mississippi State,3,0,3,1.0
in August/September,2014,Mississippi State,4,0,4,1.0
in October,2014,Mississippi State,3,0,3,1.0
in November,2014,Mississippi State,3,2,5,0.6
in December/January,2014,Mississippi State,0,1,1,0.0
All Games,2015,Mississippi State,9,4,13,0.6923076923076923
at Home,2015,Mississippi State,4,3,7,0.5714285714285714
on Road/Neutral Site,2015,Mississippi State,5,1,6,0.8333333333333334
vs. Conference,2015,Mississippi State,4,4,8,0.5
vs. Non-Conference,2015,Mississippi State,5,0,5,1.0
vs. Ranked (AP),2015,Mississippi State,0,3,3,0.0
vs. Unranked (AP),2015,Mississippi State,9,1,10,0.9
vs. FBS (I-A),2015,Mississippi State,8,4,12,0.6666666666666666
vs. FCS (I-AA),2015,Mississippi State,1,0,1,1.0
vs. FBS Winning,2015,Mississippi State,5,4,9,0.5555555555555556
vs. FBS Non-Winning,2015,Mississippi State,3,0,3,1.0
vs. BCS AQ,2015,Mississippi State,5,4,9,0.5555555555555556
vs. BCS non-AQ,2015,Mississippi State,3,0,3,1.0
vs. FBS Power 5,2015,Mississippi State,5,4,9,0.5555555555555556
vs. FBS non-Power 5,2015,Mississippi State,3,0,3,1.0
in August/September,2015,Mississippi State,3,1,4,0.75
in October,2015,Mississippi State,3,1,4,0.75
in November,2015,Mississippi State,2,2,4,0.5
in December/January,2015,Mississippi State,1,0,1,1.0
All Games,2016,Mississippi State,6,7,13,0.46153846153846156
at Home,2016,Mississippi State,3,3,6,0.5
on Road/Neutral Site,2016,Mississippi State,3,4,7,0.42857142857142855
vs. Conference,2016,Mississippi State,3,5,8,0.375
vs. Non-Conference,2016,Mississippi State,3,2,5,0.6
vs. Ranked (AP),2016,Mississippi State,0,3,3,0.0
vs. Unranked (AP),2016,Mississippi State,6,4,10,0.6
vs. FBS (I-A),2016,Mississippi State,5,7,12,0.4166666666666667
vs. FCS (I-AA),2016,Mississippi State,1,0,1,1.0
vs. FBS Winning,2016,Mississippi State,1,6,7,0.14285714285714285
vs. FBS Non-Winning,2016,Mississippi State,4,1,5,0.8
vs. BCS AQ,2016,Mississippi State,3,5,8,0.375
vs. BCS non-AQ,2016,Mississippi State,2,2,4,0.5
vs. FBS Power 5,2016,Mississippi State,3,5,8,0.375
vs. FBS non-Power 5,2016,Mississippi State,2,2,4,0.5
in August/September,2016,Mississippi State,2,2,4,0.5
in October,2016,Mississippi State,1,3,4,0.25
in November,2016,Mississippi State,2,2,4,0.5
in December/January,2016,Mississippi State,1,0,1,1.0
All Games,2017,Mississippi State,9,4,13,0.6923076923076923
at Home,2017,Mississippi State,5,2,7,0.7142857142857143
on Road/Neutral Site,2017,Mississippi State,4,2,6,0.6666666666666666
vs. Conference,2017,Mississippi State,4,4,8,0.5
vs. Non-Conference,2017,Mississippi State,5,0,5,1.0
vs. Ranked (AP),2017,Mississippi State,1,3,4,0.25
vs. Unranked (AP),2017,Mississippi State,8,1,9,0.8888888888888888
vs. FBS (I-A),2017,Mississippi State,8,4,12,0.6666666666666666
vs. FCS (I-AA),2017,Mississippi State,1,0,1,1.0
vs. FBS Winning,2017,Mississippi State,5,3,8,0.625
vs. FBS Non-Winning,2017,Mississippi State,3,1,4,0.75
vs. BCS AQ,2017,Mississippi State,5,4,9,0.5555555555555556
vs. BCS non-AQ,2017,Mississippi State,3,0,3,1.0
vs. FBS Power 5,2017,Mississippi State,5,4,9,0.5555555555555556
vs. FBS non-Power 5,2017,Mississippi State,3,0,3,1.0
in August/September,2017,Mississippi State,3,2,5,0.6
in October,2017,Mississippi State,3,0,3,1.0
in November,2017,Mississippi State,2,2,4,0.5
in December/January,2017,Mississippi State,1,0,1,1.0
All Games,2018,Mississippi State,8,5,13,0.6153846153846154
at Home,2018,Mississippi State,6,1,7,0.8571428571428571
on Road/Neutral Site,2018,Mississippi State,2,4,6,0.3333333333333333
vs. Conference,2018,Mississippi State,4,4,8,0.5
vs. Non-Conference,2018,Mississippi State,4,1,5,0.8
vs. Ranked (AP),2018,Mississippi State,1,5,6,0.16666666666666666
vs. Unranked (AP),2018,Mississippi State,7,0,7,1.0
vs. FBS (I-A),2018,Mississippi State,7,5,12,0.5833333333333334
vs. FCS (I-AA),2018,Mississippi State,1,0,1,1.0
vs. FBS Winning,2018,Mississippi State,3,5,8,0.375
vs. FBS Non-Winning,2018,Mississippi State,4,0,4,1.0
vs. BCS AQ,2018,Mississippi State,5,5,10,0.5
vs. BCS non-AQ,2018,Mississippi State,2,0,2,1.0
vs. FBS Power 5,2018,Mississippi State,5,5,10,0.5
vs. FBS non-Power 5,2018,Mississippi State,2,0,2,1.0
in August/September,2018,Mississippi State,3,2,5,0.6
in October,2018,Mississippi State,2,1,3,0.6666666666666666
in November,2018,Mississippi State,3,1,4,0.75
in December/January,2018,Mississippi State,0,1,1,0.0
All Games,2019,Mississippi State,6,7,13,0.46153846153846156
at Home,2019,Mississippi State,4,3,7,0.5714285714285714
on Road/Neutral Site,2019,Mississippi State,2,4,6,0.3333333333333333
vs. Conference,2019,Mississippi State,3,5,8,0.375
vs. Non-Conference,2019,Mississippi State,3,2,5,0.6
vs. Ranked (AP),2019,Mississippi State,0,3,3,0.0
vs. Unranked (AP),2019,Mississippi State,6,4,10,0.6
vs. FBS (I-A),2019,Mississippi State,5,7,12,0.4166666666666667
vs. FCS (I-AA),2019,Mississippi State,1,0,1,1.0
vs. FBS Winning,2019,Mississippi State,3,7,10,0.3
vs. FBS Non-Winning,2019,Mississippi State,2,0,2,1.0
vs. BCS AQ,2019,Mississippi State,3,7,10,0.3
vs. BCS non-AQ,2019,Mississippi State,2,0,2,1.0
vs. FBS Power 5,2019,Mississippi State,3,7,10,0.3
vs. FBS non-Power 5,2019,Mississippi State,2,0,2,1.0
in August/September,2019,Mississippi State,3,2,5,0.6
in October,2019,Mississippi State,0,3,3,0.0
in November,2019,Mississippi State,3,1,4,0.75
in December/January,2019,Mississippi State,0,1,1,0.0
All Games,2020,Mississippi State,4,7,11,0.36363636363636365
at Home,2020,Mississippi State,2,3,5,0.4
on Road/Neutral Site,2020,Mississippi State,2,4,6,0.3333333333333333
vs. Conference,2020,Mississippi State,3,7,10,0.3
vs. Non-Conference,2020,Mississippi State,1,0,1,1.0
vs. Ranked (AP),2020,Mississippi State,1,3,4,0.25
vs. Unranked (AP),2020,Mississippi State,3,4,7,0.42857142857142855
vs. FBS (I-A),2020,Mississippi State,4,7,11,0.36363636363636365
vs. FCS (I-AA),2020,Mississippi State,0,0,0,
vs. FBS Winning,2020,Mississippi State,1,4,5,0.2
vs. FBS Non-Winning,2020,Mississippi State,3,3,6,0.5
vs. BCS AQ,2020,Mississippi State,4,7,11,0.36363636363636365
vs. BCS non-AQ,2020,Mississippi State,0,0,0,
vs. FBS Power 5,2020,Mississippi State,3,7,10,0.3
vs. FBS non-Power 5,2020,Mississippi State,1,0,1,1.0
in August/September,2020,Mississippi State,1,0,1,1.0
in October,2020,Mississippi State,0,4,4,0.0
in November,2020,Mississippi State,1,2,3,0.3333333333333333
in December/January,2020,Mississippi State,2,1,3,0.6666666666666666
All Games,2021,Mississippi State,7,6,13,0.5384615384615384
at Home,2021,Mississippi State,4,3,7,0.5714285714285714
on Road/Neutral Site,2021,Mississippi State,3,3,6,0.5
vs. Conference,2021,Mississippi State,4,4,8,0.5
vs. Non-Conference,2021,Mississippi State,3,2,5,0.6
vs. Ranked (AP),2021,Mississippi State,2,3,5,0.4
vs. Unranked (AP),2021,Mississippi State,5,3,8,0.625
vs. FBS (I-A),2021,Mississippi State,6,6,12,0.5
vs. FCS (I-AA),2021,Mississippi State,1,0,1,1.0
vs. FBS Winning,2021,Mississippi State,3,4,7,0.42857142857142855
vs. FBS Non-Winning,2021,Mississippi State,3,2,5,0.6
vs. BCS AQ,2021,Mississippi State,5,6,11,0.45454545454545453
vs. BCS non-AQ,2021,Mississippi State,1,0,1,1.0
vs. FBS Power 5,2021,Mississippi State,5,5,10,0.5
vs. FBS non-Power 5,2021,Mississippi State,1,1,2,0.5
in August/September,2021,Mississippi State,2,2,4,0.5
in October,2021,Mississippi State,3,1,4,0.75
in November,2021,Mississippi State,2,2,4,0.5
in December/January,2021,Mississippi State,0,1,1,0.0
All Games,2022,Mississippi State,9,4,13,0.6923076923076923
at Home,2022,Mississippi State,6,1,7,0.8571428571428571
on Road/Neutral Site,2022,Mississippi State,3,3,6,0.5
vs. Conference,2022,Mississippi State,4,4,8,0.5
vs. Non-Conference,2022,Mississippi State,5,0,5,1.0
vs. Ranked (AP),2022,Mississippi State,0,3,3,0.0
vs. Unranked (AP),2022,Mississippi State,9,1,10,0.9
vs. FBS (I-A),2022,Mississippi State,8,4,12,0.6666666666666666
vs. FCS (I-AA),2022,Mississippi State,1,0,1,1.0
vs. FBS Winning,2022,Mississippi State,4,4,8,0.5
vs. FBS Non-Winning,2022,Mississippi State,4,0,4,1.0
vs. BCS AQ,2022,Mississippi State,7,4,11,0.6363636363636364
vs. BCS non-AQ,2022,Mississippi State,1,0,1,1.0
vs. FBS Power 5,2022,Mississippi State,6,4,10,0.6
vs. FBS non-Power 5,2022,Mississippi State,2,0,2,1.0
in August/September,2022,Mississippi State,3,1,4,0.75
in October,2022,Mississippi State,2,2,4,0.5
in November,2022,Mississippi State,3,1,4,0.75
in December/January,2022,Mississippi State,1,0,1,1.0
All Games,2009,Missouri,8,5,13,0.6153846153846154
at Home,2009,Missouri,3,3,6,0.5
on Road/Neutral Site,2009,Missouri,5,2,7,0.7142857142857143
vs. Conference,2009,Missouri,4,4,8,0.5
vs. Non-Conference,2009,Missouri,4,1,5,0.8
vs. Ranked (AP),2009,Missouri,0,2,2,0.0
vs. Unranked (AP),2009,Missouri,8,3,11,0.7272727272727273
vs. FBS (I-A),2009,Missouri,7,5,12,0.5833333333333334
vs. FCS (I-AA),2009,Missouri,1,0,1,1.0
vs. FBS Winning,2009,Missouri,3,4,7,0.42857142857142855
vs. FBS Non-Winning,2009,Missouri,4,1,5,0.8
vs. BCS AQ,2009,Missouri,5,4,9,0.5555555555555556
vs. BCS non-AQ,2009,Missouri,2,1,3,0.6666666666666666
vs. FBS Power 5,2009,Missouri,5,4,9,0.5555555555555556
vs. FBS non-Power 5,2009,Missouri,2,1,3,0.6666666666666666
in August/September,2009,Missouri,4,0,4,1.0
in October,2009,Missouri,1,3,4,0.25
in November,2009,Missouri,3,1,4,0.75
in December/January,2009,Missouri,0,1,1,0.0
All Games,2010,Missouri,10,3,13,0.7692307692307693
at Home,2010,Missouri,6,0,6,1.0
on Road/Neutral Site,2010,Missouri,4,3,7,0.5714285714285714
vs. Conference,2010,Missouri,6,2,8,0.75
vs. Non-Conference,2010,Missouri,4,1,5,0.8
vs. Ranked (AP),2010,Missouri,2,1,3,0.6666666666666666
vs. Unranked (AP),2010,Missouri,8,2,10,0.8
vs. FBS (I-A),2010,Missouri,9,3,12,0.75
vs. FCS (I-AA),2010,Missouri,1,0,1,1.0
vs. FBS Winning,2010,Missouri,6,3,9,0.6666666666666666
vs. FBS Non-Winning,2010,Missouri,3,0,3,1.0
vs. BCS AQ,2010,Missouri,7,3,10,0.7
vs. BCS non-AQ,2010,Missouri,2,0,2,1.0
vs. FBS Power 5,2010,Missouri,7,3,10,0.7
vs. FBS non-Power 5,2010,Missouri,2,0,2,1.0
in August/September,2010,Missouri,4,0,4,1.0
in October,2010,Missouri,3,1,4,0.75
in November,2010,Missouri,3,1,4,0.75
in December/January,2010,Missouri,0,1,1,0.0
All Games,2011,Missouri,8,5,13,0.6153846153846154
at Home,2011,Missouri,5,1,6,0.8333333333333334
on Road/Neutral Site,2011,Missouri,3,4,7,0.42857142857142855
vs. Conference,2011,Missouri,5,4,9,0.5555555555555556
vs. Non-Conference,2011,Missouri,3,1,4,0.75
vs. Ranked (AP),2011,Missouri,0,4,4,0.0
vs. Unranked (AP),2011,Missouri,8,1,9,0.8888888888888888
vs. FBS (I-A),2011,Missouri,7,5,12,0.5833333333333334
vs. FCS (I-AA),2011,Missouri,1,0,1,1.0
vs. FBS Winning,2011,Missouri,3,4,7,0.42857142857142855
vs. FBS Non-Winning,2011,Missouri,4,1,5,0.8
vs. BCS AQ,2011,Missouri,6,5,11,0.5454545454545454
vs. BCS non-AQ,2011,Missouri,1,0,1,1.0
vs. FBS Power 5,2011,Missouri,6,5,11,0.5454545454545454
vs. FBS non-Power 5,2011,Missouri,1,0,1,1.0
in August/September,2011,Missouri,2,2,4,0.5
in October,2011,Missouri,2,2,4,0.5
in November,2011,Missouri,3,1,4,0.75
in December/January,2011,Missouri,1,0,1,1.0
All Games,2012,Missouri,5,7,12,0.4166666666666667
at Home,2012,Missouri,3,4,7,0.42857142857142855
on Road/Neutral Site,2012,Missouri,2,3,5,0.4
vs. Conference,2012,Missouri,2,6,8,0.25
vs. Non-Conference,2012,Missouri,3,1,4,0.75
vs. Ranked (AP),2012,Missouri,0,6,6,0.0
vs. Unranked (AP),2012,Missouri,5,1,6,0.8333333333333334
vs. FBS (I-A),2012,Missouri,4,7,11,0.36363636363636365
vs. FCS (I-AA),2012,Missouri,1,0,1,1.0
vs. FBS Winning,2012,Missouri,2,7,9,0.2222222222222222
vs. FBS Non-Winning,2012,Missouri,2,0,2,1.0
vs. BCS AQ,2012,Missouri,3,7,10,0.3
vs. BCS non-AQ,2012,Missouri,1,0,1,1.0
vs. FBS Power 5,2012,Missouri,3,6,9,0.3333333333333333
vs. FBS non-Power 5,2012,Missouri,1,1,2,0.5
in August/September,2012,Missouri,3,2,5,0.6
in October,2012,Missouri,1,2,3,0.3333333333333333
in November,2012,Missouri,1,3,4,0.25
in December/January,2012,Missouri,0,0,0,
All Games,2013,Missouri,12,2,14,0.8571428571428571
at Home,2013,Missouri,6,1,7,0.8571428571428571
on Road/Neutral Site,2013,Missouri,6,1,7,0.8571428571428571
vs. Conference,2013,Missouri,7,2,9,0.7777777777777778
vs. Non-Conference,2013,Missouri,5,0,5,1.0
vs. Ranked (AP),2013,Missouri,3,2,5,0.6
vs. Unranked (AP),2013,Missouri,9,0,9,1.0
vs. FBS (I-A),2013,Missouri,11,2,13,0.8461538461538461
vs. FCS (I-AA),2013,Missouri,1,0,1,1.0
vs. FBS Winning,2013,Missouri,7,2,9,0.7777777777777778
vs. FBS Non-Winning,2013,Missouri,4,0,4,1.0
vs. BCS AQ,2013,Missouri,9,2,11,0.8181818181818182
vs. BCS non-AQ,2013,Missouri,2,0,2,1.0
vs. FBS Power 5,2013,Missouri,9,2,11,0.8181818181818182
vs. FBS non-Power 5,2013,Missouri,2,0,2,1.0
in August/September,2013,Missouri,4,0,4,1.0
in October,2013,Missouri,3,1,4,0.75
in November,2013,Missouri,4,0,4,1.0
in December/January,2013,Missouri,1,1,2,0.5
All Games,2014,Missouri,11,3,14,0.7857142857142857
at Home,2014,Missouri,5,2,7,0.7142857142857143
on Road/Neutral Site,2014,Missouri,6,1,7,0.8571428571428571
vs. Conference,2014,Missouri,7,2,9,0.7777777777777778
vs. Non-Conference,2014,Missouri,4,1,5,0.8
vs. Ranked (AP),2014,Missouri,0,2,2,0.0
vs. Unranked (AP),2014,Missouri,11,1,12,0.9166666666666666
vs. FBS (I-A),2014,Missouri,10,3,13,0.7692307692307693
vs. FCS (I-AA),2014,Missouri,1,0,1,1.0
vs. FBS Winning,2014,Missouri,8,2,10,0.8
vs. FBS Non-Winning,2014,Missouri,2,1,3,0.6666666666666666
vs. BCS AQ,2014,Missouri,9,3,12,0.75
vs. BCS non-AQ,2014,Missouri,1,0,1,1.0
vs. FBS Power 5,2014,Missouri,8,3,11,0.7272727272727273
vs. FBS non-Power 5,2014,Missouri,2,0,2,1.0
in August/September,2014,Missouri,4,1,5,0.8
in October,2014,Missouri,2,1,3,0.6666666666666666
in November,2014,Missouri,4,0,4,1.0
in December/January,2014,Missouri,1,1,2,0.5
All Games,2015,Missouri,5,7,12,0.4166666666666667
at Home,2015,Missouri,3,3,6,0.5
on Road/Neutral Site,2015,Missouri,2,4,6,0.3333333333333333
vs. Conference,2015,Missouri,1,7,8,0.125
vs. Non-Conference,2015,Missouri,4,0,4,1.0
vs. Ranked (AP),2015,Missouri,0,2,2,0.0
vs. Unranked (AP),2015,Missouri,5,5,10,0.5
vs. FBS (I-A),2015,Missouri,4,7,11,0.36363636363636365
vs. FCS (I-AA),2015,Missouri,1,0,1,1.0
vs. FBS Winning,2015,Missouri,2,5,7,0.2857142857142857
vs. FBS Non-Winning,2015,Missouri,2,2,4,0.5
vs. BCS AQ,2015,Missouri,2,7,9,0.2222222222222222
vs. BCS non-AQ,2015,Missouri,2,0,2,1.0
vs. FBS Power 5,2015,Missouri,1,7,8,0.125
vs. FBS non-Power 5,2015,Missouri,3,0,3,1.0
in August/September,2015,Missouri,3,1,4,0.75
in October,2015,Missouri,1,3,4,0.25
in November,2015,Missouri,1,3,4,0.25
in December/January,2015,Missouri,0,0,0,
All Games,2016,Missouri,4,8,12,0.3333333333333333
at Home,2016,Missouri,4,3,7,0.5714285714285714
on Road/Neutral Site,2016,Missouri,0,5,5,0.0
vs. Conference,2016,Missouri,2,6,8,0.25
vs. Non-Conference,2016,Missouri,2,2,4,0.5
vs. Ranked (AP),2016,Missouri,0,3,3,0.0
vs. Unranked (AP),2016,Missouri,4,5,9,0.4444444444444444
vs. FBS (I-A),2016,Missouri,3,8,11,0.2727272727272727
vs. FCS (I-AA),2016,Missouri,1,0,1,1.0
vs. FBS Winning,2016,Missouri,2,7,9,0.2222222222222222
vs. FBS Non-Winning,2016,Missouri,1,1,2,0.5
vs. BCS AQ,2016,Missouri,2,7,9,0.2222222222222222
vs. BCS non-AQ,2016,Missouri,1,1,2,0.5
vs. FBS Power 5,2016,Missouri,2,7,9,0.2222222222222222
vs. FBS non-Power 5,2016,Missouri,1,1,2,0.5
in August/September,2016,Missouri,2,2,4,0.5
in October,2016,Missouri,0,4,4,0.0
in November,2016,Missouri,2,2,4,0.5
in December/January,2016,Missouri,0,0,0,
All Games,2017,Missouri,7,6,13,0.5384615384615384
at Home,2017,Missouri,4,3,7,0.5714285714285714
on Road/Neutral Site,2017,Missouri,3,3,6,0.5
vs. Conference,2017,Missouri,4,4,8,0.5
vs. Non-Conference,2017,Missouri,3,2,5,0.6
vs. Ranked (AP),2017,Missouri,0,2,2,0.0
vs. Unranked (AP),2017,Missouri,7,4,11,0.6363636363636364
vs. FBS (I-A),2017,Missouri,6,6,12,0.5
vs. FCS (I-AA),2017,Missouri,1,0,1,1.0
vs. FBS Winning,2017,Missouri,0,6,6,0.0
vs. FBS Non-Winning,2017,Missouri,6,0,6,1.0
vs. BCS AQ,2017,Missouri,5,6,11,0.45454545454545453
vs. BCS non-AQ,2017,Missouri,1,0,1,1.0
vs. FBS Power 5,2017,Missouri,4,6,10,0.4
vs. FBS non-Power 5,2017,Missouri,2,0,2,1.0
in August/September,2017,Missouri,1,3,4,0.25
in October,2017,Missouri,2,2,4,0.5
in November,2017,Missouri,4,0,4,1.0
in December/January,2017,Missouri,0,1,1,0.0
All Games,2018,Missouri,8,5,13,0.6153846153846154
at Home,2018,Missouri,5,2,7,0.7142857142857143
on Road/Neutral Site,2018,Missouri,3,3,6,0.5
vs. Conference,2018,Missouri,4,4,8,0.5
vs. Non-Conference,2018,Missouri,4,1,5,0.8
vs. Ranked (AP),2018,Missouri,1,3,4,0.25
vs. Unranked (AP),2018,Missouri,7,2,9,0.7777777777777778
vs. FBS (I-A),2018,Missouri,7,5,12,0.5833333333333334
vs. FCS (I-AA),2018,Missouri,1,0,1,1.0
vs. FBS Winning,2018,Missouri,2,5,7,0.2857142857142857
vs. FBS Non-Winning,2018,Missouri,5,0,5,1.0
vs. BCS AQ,2018,Missouri,6,5,11,0.5454545454545454
vs. BCS non-AQ,2018,Missouri,1,0,1,1.0
vs. FBS Power 5,2018,Missouri,5,5,10,0.5
vs. FBS non-Power 5,2018,Missouri,2,0,2,1.0
in August/September,2018,Missouri,3,1,4,0.75
in October,2018,Missouri,1,3,4,0.25
in November,2018,Missouri,4,0,4,1.0
in December/January,2018,Missouri,0,1,1,0.0
All Games,2019,Missouri,6,6,12,0.5
at Home,2019,Missouri,5,2,7,0.7142857142857143
on Road/Neutral Site,2019,Missouri,1,4,5,0.2
vs. Conference,2019,Missouri,3,5,8,0.375
vs. Non-Conference,2019,Missouri,3,1,4,0.75
vs. Ranked (AP),2019,Missouri,0,2,2,0.0
vs. Unranked (AP),2019,Missouri,6,4,10,0.6
vs. FBS (I-A),2019,Missouri,5,6,11,0.45454545454545453
vs. FCS (I-AA),2019,Missouri,1,0,1,1.0
vs. FBS Winning,2019,Missouri,0,5,5,0.0
vs. FBS Non-Winning,2019,Missouri,5,1,6,0.8333333333333334
vs. BCS AQ,2019,Missouri,4,5,9,0.4444444444444444
vs. BCS non-AQ,2019,Missouri,1,1,2,0.5
vs. FBS Power 5,2019,Missouri,4,5,9,0.4444444444444444
vs. FBS non-Power 5,2019,Missouri,1,1,2,0.5
in August/September,2019,Missouri,3,1,4,0.75
in October,2019,Missouri,2,2,4,0.5
in November,2019,Missouri,1,3,4,0.25
in December/January,2019,Missouri,0,0,0,
All Games,2020,Missouri,5,5,10,0.5
at Home,2020,Missouri,4,2,6,0.6666666666666666
on Road/Neutral Site,2020,Missouri,1,3,4,0.25
vs. Conference,2020,Missouri,5,5,10,0.5
vs. Non-Conference,2020,Missouri,0,0,0,
vs. Ranked (AP),2020,Missouri,0,3,3,0.0
vs. Unranked (AP),2020,Missouri,5,2,7,0.7142857142857143
vs. FBS (I-A),2020,Missouri,5,5,10,0.5
vs. FCS (I-AA),2020,Missouri,0,0,0,
vs. FBS Winning,2020,Missouri,0,3,3,0.0
vs. FBS Non-Winning,2020,Missouri,5,2,7,0.7142857142857143
vs. BCS AQ,2020,Missouri,5,5,10,0.5
vs. BCS non-AQ,2020,Missouri,0,0,0,
vs. FBS Power 5,2020,Missouri,5,5,10,0.5
vs. FBS non-Power 5,2020,Missouri,0,0,0,
in August/September,2020,Missouri,0,1,1,0.0
in October,2020,Missouri,2,2,4,0.5
in November,2020,Missouri,2,0,2,1.0
in December/January,2020,Missouri,1,2,3,0.3333333333333333
All Games,2021,Missouri,6,7,13,0.46153846153846156
at Home,2021,Missouri,5,2,7,0.7142857142857143
on Road/Neutral Site,2021,Missouri,1,5,6,0.16666666666666666
vs. Conference,2021,Missouri,3,5,8,0.375
vs. Non-Conference,2021,Missouri,3,2,5,0.6
vs. Ranked (AP),2021,Missouri,0,3,3,0.0
vs. Unranked (AP),2021,Missouri,6,4,10,0.6
vs. FBS (I-A),2021,Missouri,5,7,12,0.4166666666666667
vs. FCS (I-AA),2021,Missouri,1,0,1,1.0
vs. FBS Winning,2021,Missouri,2,6,8,0.25
vs. FBS Non-Winning,2021,Missouri,3,1,4,0.75
vs. BCS AQ,2021,Missouri,3,6,9,0.3333333333333333
vs. BCS non-AQ,2021,Missouri,2,1,3,0.6666666666666666
vs. FBS Power 5,2021,Missouri,3,6,9,0.3333333333333333
vs. FBS non-Power 5,2021,Missouri,2,1,3,0.6666666666666666
in August/September,2021,Missouri,2,2,4,0.5
in October,2021,Missouri,2,2,4,0.5
in November,2021,Missouri,2,2,4,0.5
in December/January,2021,Missouri,0,1,1,0.0
All Games,2022,Missouri,6,7,13,0.46153846153846156
at Home,2022,Missouri,5,2,7,0.7142857142857143
on Road/Neutral Site,2022,Missouri,1,5,6,0.16666666666666666
vs. Conference,2022,Missouri,3,5,8,0.375
vs. Non-Conference,2022,Missouri,3,2,5,0.6
vs. Ranked (AP),2022,Missouri,1,3,4,0.25
vs. Unranked (AP),2022,Missouri,5,4,9,0.5555555555555556
vs. FBS (I-A),2022,Missouri,5,7,12,0.4166666666666667
vs. FCS (I-AA),2022,Missouri,1,0,1,1.0
vs. FBS Winning,2022,Missouri,3,5,8,0.375
vs. FBS Non-Winning,2022,Missouri,2,2,4,0.5
vs. BCS AQ,2022,Missouri,3,7,10,0.3
vs. BCS non-AQ,2022,Missouri,2,0,2,1.0
vs. FBS Power 5,2022,Missouri,3,7,10,0.3
vs. FBS non-Power 5,2022,Missouri,2,0,2,1.0
in August/September,2022,Missouri,2,2,4,0.5
in October,2022,Missouri,2,2,4,0.5
in November,2022,Missouri,2,2,4,0.5
in December/January,2022,Missouri,0,1,1,0.0
All Games,2009,Navy,10,4,14,0.7142857142857143
at Home,2009,Navy,5,1,6,0.8333333333333334
on Road/Neutral Site,2009,Navy,5,3,8,0.625
vs. Conference,2009,Navy,2,0,2,1.0
vs. Non-Conference,2009,Navy,8,4,12,0.6666666666666666
vs. Ranked (AP),2009,Navy,0,2,2,0.0
vs. Unranked (AP),2009,Navy,10,2,12,0.8333333333333334
vs. FBS (I-A),2009,Navy,9,4,13,0.6923076923076923
vs. FCS (I-AA),2009,Navy,1,0,1,1.0
vs. FBS Winning,2009,Navy,3,3,6,0.5
vs. FBS Non-Winning,2009,Navy,6,1,7,0.8571428571428571
vs. BCS AQ,2009,Navy,3,2,5,0.6
vs. BCS non-AQ,2009,Navy,6,2,8,0.75
vs. FBS Power 5,2009,Navy,2,1,3,0.6666666666666666
vs. FBS non-Power 5,2009,Navy,7,3,10,0.7
in August/September,2009,Navy,2,2,4,0.5
in October,2009,Navy,4,1,5,0.8
in November,2009,Navy,2,1,3,0.6666666666666666
in December/January,2009,Navy,2,0,2,1.0
All Games,2010,Navy,9,4,13,0.6923076923076923
at Home,2010,Navy,4,1,5,0.8
on Road/Neutral Site,2010,Navy,5,3,8,0.625
vs. Conference,2010,Navy,2,0,2,1.0
vs. Non-Conference,2010,Navy,7,4,11,0.6363636363636364
vs. Ranked (AP),2010,Navy,0,1,1,0.0
vs. Unranked (AP),2010,Navy,9,3,12,0.75
vs. FBS (I-A),2010,Navy,8,4,12,0.6666666666666666
vs. FCS (I-AA),2010,Navy,1,0,1,1.0
vs. FBS Winning,2010,Navy,2,3,5,0.4
vs. FBS Non-Winning,2010,Navy,6,1,7,0.8571428571428571
vs. BCS AQ,2010,Navy,2,2,4,0.5
vs. BCS non-AQ,2010,Navy,6,2,8,0.75
vs. FBS Power 5,2010,Navy,1,2,3,0.3333333333333333
vs. FBS non-Power 5,2010,Navy,7,2,9,0.7777777777777778
in August/September,2010,Navy,2,1,3,0.6666666666666666
in October,2010,Navy,3,2,5,0.6
in November,2010,Navy,3,0,3,1.0
in December/January,2010,Navy,1,1,2,0.5
All Games,2011,Navy,5,7,12,0.4166666666666667
at Home,2011,Navy,2,3,5,0.4
on Road/Neutral Site,2011,Navy,3,4,7,0.42857142857142855
vs. Conference,2011,Navy,1,1,2,0.5
vs. Non-Conference,2011,Navy,4,6,10,0.4
vs. Ranked (AP),2011,Navy,0,2,2,0.0
vs. Unranked (AP),2011,Navy,5,5,10,0.5
vs. FBS (I-A),2011,Navy,4,7,11,0.36363636363636365
vs. FCS (I-AA),2011,Navy,1,0,1,1.0
vs. FBS Winning,2011,Navy,2,5,7,0.2857142857142857
vs. FBS Non-Winning,2011,Navy,2,2,4,0.5
vs. BCS AQ,2011,Navy,0,3,3,0.0
vs. BCS non-AQ,2011,Navy,4,4,8,0.5
vs. FBS Power 5,2011,Navy,0,1,1,0.0
vs. FBS non-Power 5,2011,Navy,4,6,10,0.4
in August/September,2011,Navy,2,1,3,0.6666666666666666
in October,2011,Navy,0,5,5,0.0
in November,2011,Navy,2,1,3,0.6666666666666666
in December/January,2011,Navy,1,0,1,1.0
All Games,2012,Navy,8,5,13,0.6153846153846154
at Home,2012,Navy,4,1,5,0.8
on Road/Neutral Site,2012,Navy,4,4,8,0.5
vs. Conference,2012,Navy,1,1,2,0.5
vs. Non-Conference,2012,Navy,7,4,11,0.6363636363636364
vs. Ranked (AP),2012,Navy,0,2,2,0.0
vs. Unranked (AP),2012,Navy,8,3,11,0.7272727272727273
vs. FBS (I-A),2012,Navy,7,5,12,0.5833333333333334
vs. FCS (I-AA),2012,Navy,1,0,1,1.0
vs. FBS Winning,2012,Navy,2,4,6,0.3333333333333333
vs. FBS Non-Winning,2012,Navy,5,1,6,0.8333333333333334
vs. BCS AQ,2012,Navy,1,3,4,0.25
vs. BCS non-AQ,2012,Navy,6,2,8,0.75
vs. FBS Power 5,2012,Navy,1,2,3,0.3333333333333333
vs. FBS non-Power 5,2012,Navy,6,3,9,0.6666666666666666
in August/September,2012,Navy,1,3,4,0.25
in October,2012,Navy,4,0,4,1.0
in November,2012,Navy,2,1,3,0.6666666666666666
in December/January,2012,Navy,1,1,2,0.5
All Games,2013,Navy,9,4,13,0.6923076923076923
at Home,2013,Navy,5,0,5,1.0
on Road/Neutral Site,2013,Navy,4,4,8,0.5
vs. Conference,2013,Navy,1,1,2,0.5
vs. Non-Conference,2013,Navy,8,3,11,0.7272727272727273
vs. Ranked (AP),2013,Navy,0,2,2,0.0
vs. Unranked (AP),2013,Navy,9,2,11,0.8181818181818182
vs. FBS (I-A),2013,Navy,8,4,12,0.6666666666666666
vs. FCS (I-AA),2013,Navy,1,0,1,1.0
vs. FBS Winning,2013,Navy,2,4,6,0.3333333333333333
vs. FBS Non-Winning,2013,Navy,6,0,6,1.0
vs. BCS AQ,2013,Navy,2,2,4,0.5
vs. BCS non-AQ,2013,Navy,6,2,8,0.75
vs. FBS Power 5,2013,Navy,2,1,3,0.6666666666666666
vs. FBS non-Power 5,2013,Navy,6,3,9,0.6666666666666666
in August/September,2013,Navy,2,1,3,0.6666666666666666
in October,2013,Navy,2,2,4,0.5
in November,2013,Navy,3,1,4,0.75
in December/January,2013,Navy,2,0,2,1.0
All Games,2014,Navy,8,5,13,0.6153846153846154
at Home,2014,Navy,3,2,5,0.6
on Road/Neutral Site,2014,Navy,5,3,8,0.625
vs. Conference,2014,Navy,1,1,2,0.5
vs. Non-Conference,2014,Navy,7,4,11,0.6363636363636364
vs. Ranked (AP),2014,Navy,0,1,1,0.0
vs. Unranked (AP),2014,Navy,8,4,12,0.6666666666666666
vs. FBS (I-A),2014,Navy,7,5,12,0.5833333333333334
vs. FCS (I-AA),2014,Navy,1,0,1,1.0
vs. FBS Winning,2014,Navy,3,5,8,0.375
vs. FBS Non-Winning,2014,Navy,4,0,4,1.0
vs. BCS AQ,2014,Navy,1,3,4,0.25
vs. BCS non-AQ,2014,Navy,6,2,8,0.75
vs. FBS Power 5,2014,Navy,0,2,2,0.0
vs. FBS non-Power 5,2014,Navy,7,3,10,0.7
in August/September,2014,Navy,2,3,5,0.4
in October,2014,Navy,2,1,3,0.6666666666666666
in November,2014,Navy,2,1,3,0.6666666666666666
in December/January,2014,Navy,2,0,2,1.0
All Games,2015,Navy,11,2,13,0.8461538461538461
at Home,2015,Navy,6,0,6,1.0
on Road/Neutral Site,2015,Navy,5,2,7,0.7142857142857143
vs. Conference,2015,Navy,7,1,8,0.875
vs. Non-Conference,2015,Navy,4,1,5,0.8
vs. Ranked (AP),2015,Navy,0,2,2,0.0
vs. Unranked (AP),2015,Navy,11,0,11,1.0
vs. FBS (I-A),2015,Navy,10,2,12,0.8333333333333334
vs. FCS (I-AA),2015,Navy,1,0,1,1.0
vs. FBS Winning,2015,Navy,4,2,6,0.6666666666666666
vs. FBS Non-Winning,2015,Navy,6,0,6,1.0
vs. BCS AQ,2015,Navy,8,2,10,0.8
vs. BCS non-AQ,2015,Navy,2,0,2,1.0
vs. FBS Power 5,2015,Navy,1,0,1,1.0
vs. FBS non-Power 5,2015,Navy,9,2,11,0.8181818181818182
in August/September,2015,Navy,3,0,3,1.0
in October,2015,Navy,3,1,4,0.75
in November,2015,Navy,3,1,4,0.75
in December/January,2015,Navy,2,0,2,1.0
All Games,2016,Navy,9,5,14,0.6428571428571429
at Home,2016,Navy,5,1,6,0.8333333333333334
on Road/Neutral Site,2016,Navy,4,4,8,0.5
vs. Conference,2016,Navy,7,2,9,0.7777777777777778
vs. Non-Conference,2016,Navy,2,3,5,0.4
vs. Ranked (AP),2016,Navy,0,2,2,0.0
vs. Unranked (AP),2016,Navy,9,3,12,0.75
vs. FBS (I-A),2016,Navy,8,5,13,0.6153846153846154
vs. FCS (I-AA),2016,Navy,1,0,1,1.0
vs. FBS Winning,2016,Navy,3,5,8,0.375
vs. FBS Non-Winning,2016,Navy,5,0,5,1.0
vs. BCS AQ,2016,Navy,8,2,10,0.8
vs. BCS non-AQ,2016,Navy,0,3,3,0.0
vs. FBS Power 5,2016,Navy,0,0,0,
vs. FBS non-Power 5,2016,Navy,8,5,13,0.6153846153846154
in August/September,2016,Navy,3,0,3,1.0
in October,2016,Navy,2,2,4,0.5
in November,2016,Navy,4,0,4,1.0
in December/January,2016,Navy,0,3,3,0.0
All Games,2017,Navy,7,6,13,0.5384615384615384
at Home,2017,Navy,5,1,6,0.8333333333333334
on Road/Neutral Site,2017,Navy,2,5,7,0.2857142857142857
vs. Conference,2017,Navy,4,4,8,0.5
vs. Non-Conference,2017,Navy,3,2,5,0.6
vs. Ranked (AP),2017,Navy,0,3,3,0.0
vs. Unranked (AP),2017,Navy,7,3,10,0.7
vs. FBS (I-A),2017,Navy,7,6,13,0.5384615384615384
vs. FCS (I-AA),2017,Navy,0,0,0,
vs. FBS Winning,2017,Navy,2,6,8,0.25
vs. FBS Non-Winning,2017,Navy,5,0,5,1.0
vs. BCS AQ,2017,Navy,5,5,10,0.5
vs. BCS non-AQ,2017,Navy,2,1,3,0.6666666666666666
vs. FBS Power 5,2017,Navy,1,0,1,1.0
vs. FBS non-Power 5,2017,Navy,6,6,12,0.5
in August/September,2017,Navy,4,0,4,1.0
in October,2017,Navy,1,2,3,0.3333333333333333
in November,2017,Navy,1,3,4,0.25
in December/January,2017,Navy,1,1,2,0.5
All Games,2018,Navy,3,10,13,0.23076923076923078
at Home,2018,Navy,3,2,5,0.6
on Road/Neutral Site,2018,Navy,0,8,8,0.0
vs. Conference,2018,Navy,2,6,8,0.25
vs. Non-Conference,2018,Navy,1,4,5,0.2
vs. Ranked (AP),2018,Navy,0,4,4,0.0
vs. Unranked (AP),2018,Navy,3,6,9,0.3333333333333333
vs. FBS (I-A),2018,Navy,2,10,12,0.16666666666666666
vs. FCS (I-AA),2018,Navy,1,0,1,1.0
vs. FBS Winning,2018,Navy,1,8,9,0.1111111111111111
vs. FBS Non-Winning,2018,Navy,1,2,3,0.3333333333333333
vs. BCS AQ,2018,Navy,2,7,9,0.2222222222222222
vs. BCS non-AQ,2018,Navy,0,3,3,0.0
vs. FBS Power 5,2018,Navy,0,0,0,
vs. FBS non-Power 5,2018,Navy,2,10,12,0.16666666666666666
in August/September,2018,Navy,2,2,4,0.5
in October,2018,Navy,0,4,4,0.0
in November,2018,Navy,1,3,4,0.25
in December/January,2018,Navy,0,1,1,0.0
All Games,2019,Navy,11,2,13,0.8461538461538461
at Home,2019,Navy,6,0,6,1.0
on Road/Neutral Site,2019,Navy,5,2,7,0.7142857142857143
vs. Conference,2019,Navy,7,1,8,0.875
vs. Non-Conference,2019,Navy,4,1,5,0.8
vs. Ranked (AP),2019,Navy,1,2,3,0.3333333333333333
vs. Unranked (AP),2019,Navy,10,0,10,1.0
vs. FBS (I-A),2019,Navy,10,2,12,0.8333333333333334
vs. FCS (I-AA),2019,Navy,1,0,1,1.0
vs. FBS Winning,2019,Navy,4,2,6,0.6666666666666666
vs. FBS Non-Winning,2019,Navy,6,0,6,1.0
vs. BCS AQ,2019,Navy,8,2,10,0.8
vs. BCS non-AQ,2019,Navy,2,0,2,1.0
vs. FBS Power 5,2019,Navy,1,0,1,1.0
vs. FBS non-Power 5,2019,Navy,9,2,11,0.8181818181818182
in August/September,2019,Navy,2,1,3,0.6666666666666666
in October,2019,Navy,4,0,4,1.0
in November,2019,Navy,3,1,4,0.75
in December/January,2019,Navy,2,0,2,1.0
All Games,2020,Navy,3,7,10,0.3
at Home,2020,Navy,1,4,5,0.2
on Road/Neutral Site,2020,Navy,2,3,5,0.4
vs. Conference,2020,Navy,3,4,7,0.42857142857142855
vs. Non-Conference,2020,Navy,0,3,3,0.0
vs. Ranked (AP),2020,Navy,0,2,2,0.0
vs. Unranked (AP),2020,Navy,3,5,8,0.375
vs. FBS (I-A),2020,Navy,3,7,10,0.3
vs. FCS (I-AA),2020,Navy,0,0,0,
vs. FBS Winning,2020,Navy,0,5,5,0.0
vs. FBS Non-Winning,2020,Navy,3,2,5,0.6
vs. BCS AQ,2020,Navy,3,4,7,0.42857142857142855
vs. BCS non-AQ,2020,Navy,0,3,3,0.0
vs. FBS Power 5,2020,Navy,0,0,0,
vs. FBS non-Power 5,2020,Navy,3,7,10,0.3
in August/September,2020,Navy,1,1,2,0.5
in October,2020,Navy,2,3,5,0.4
in November,2020,Navy,0,1,1,0.0
in December/January,2020,Navy,0,2,2,0.0
All Games,2021,Navy,4,8,12,0.3333333333333333
at Home,2021,Navy,1,5,6,0.16666666666666666
on Road/Neutral Site,2021,Navy,3,3,6,0.5
vs. Conference,2021,Navy,3,5,8,0.375
vs. Non-Conference,2021,Navy,1,3,4,0.25
vs. Ranked (AP),2021,Navy,0,3,3,0.0
vs. Unranked (AP),2021,Navy,4,5,9,0.4444444444444444
vs. FBS (I-A),2021,Navy,4,8,12,0.3333333333333333
vs. FCS (I-AA),2021,Navy,0,0,0,
vs. FBS Winning,2021,Navy,3,7,10,0.3
vs. FBS Non-Winning,2021,Navy,1,1,2,0.5
vs. BCS AQ,2021,Navy,3,6,9,0.3333333333333333
vs. BCS non-AQ,2021,Navy,1,2,3,0.3333333333333333
vs. FBS Power 5,2021,Navy,0,0,0,
vs. FBS non-Power 5,2021,Navy,4,8,12,0.3333333333333333
in August/September,2021,Navy,0,3,3,0.0
in October,2021,Navy,2,3,5,0.4
in November,2021,Navy,1,2,3,0.3333333333333333
in December/January,2021,Navy,1,0,1,1.0
All Games,2022,Navy,4,8,12,0.3333333333333333
at Home,2022,Navy,2,3,5,0.4
on Road/Neutral Site,2022,Navy,2,5,7,0.2857142857142857
vs. Conference,2022,Navy,4,4,8,0.5
vs. Non-Conference,2022,Navy,0,4,4,0.0
vs. Ranked (AP),2022,Navy,0,1,1,0.0
vs. Unranked (AP),2022,Navy,4,7,11,0.36363636363636365
vs. FBS (I-A),2022,Navy,4,7,11,0.36363636363636365
vs. FCS (I-AA),2022,Navy,0,1,1,0.0
vs. FBS Winning,2022,Navy,2,6,8,0.25
vs. FBS Non-Winning,2022,Navy,2,1,3,0.6666666666666666
vs. BCS AQ,2022,Navy,4,5,9,0.4444444444444444
vs. BCS non-AQ,2022,Navy,0,2,2,0.0
vs. FBS Power 5,2022,Navy,0,0,0,
vs. FBS non-Power 5,2022,Navy,4,7,11,0.36363636363636365
in August/September,2022,Navy,1,2,3,0.3333333333333333
in October,2022,Navy,2,3,5,0.4
in November,2022,Navy,1,2,3,0.3333333333333333
in December/January,2022,Navy,0,1,1,0.0
All Games,2009,Nebraska,10,4,14,0.7142857142857143
at Home,2009,Nebraska,5,2,7,0.7142857142857143
on Road/Neutral Site,2009,Nebraska,5,2,7,0.7142857142857143
vs. Conference,2009,Nebraska,6,3,9,0.6666666666666666
vs. Non-Conference,2009,Nebraska,4,1,5,0.8
vs. Ranked (AP),2009,Nebraska,0,3,3,0.0
vs. Unranked (AP),2009,Nebraska,10,1,11,0.9090909090909091
vs. FBS (I-A),2009,Nebraska,10,4,14,0.7142857142857143
vs. FCS (I-AA),2009,Nebraska,0,0,0,
vs. FBS Winning,2009,Nebraska,3,4,7,0.42857142857142855
vs. FBS Non-Winning,2009,Nebraska,7,0,7,1.0
vs. BCS AQ,2009,Nebraska,7,4,11,0.6363636363636364
vs. BCS non-AQ,2009,Nebraska,3,0,3,1.0
vs. FBS Power 5,2009,Nebraska,7,4,11,0.6363636363636364
vs. FBS non-Power 5,2009,Nebraska,3,0,3,1.0
in August/September,2009,Nebraska,3,1,4,0.75
in October,2009,Nebraska,2,2,4,0.5
in November,2009,Nebraska,4,0,4,1.0
in December/January,2009,Nebraska,1,1,2,0.5
All Games,2010,Nebraska,10,4,14,0.7142857142857143
at Home,2010,Nebraska,6,1,7,0.8571428571428571
on Road/Neutral Site,2010,Nebraska,4,3,7,0.5714285714285714
vs. Conference,2010,Nebraska,6,3,9,0.6666666666666666
vs. Non-Conference,2010,Nebraska,4,1,5,0.8
vs. Ranked (AP),2010,Nebraska,2,2,4,0.5
vs. Unranked (AP),2010,Nebraska,8,2,10,0.8
vs. FBS (I-A),2010,Nebraska,9,4,13,0.6923076923076923
vs. FCS (I-AA),2010,Nebraska,1,0,1,1.0
vs. FBS Winning,2010,Nebraska,4,3,7,0.5714285714285714
vs. FBS Non-Winning,2010,Nebraska,5,1,6,0.8333333333333334
vs. BCS AQ,2010,Nebraska,7,4,11,0.6363636363636364
vs. BCS non-AQ,2010,Nebraska,2,0,2,1.0
vs. FBS Power 5,2010,Nebraska,7,4,11,0.6363636363636364
vs. FBS non-Power 5,2010,Nebraska,2,0,2,1.0
in August/September,2010,Nebraska,4,0,4,1.0
in October,2010,Nebraska,3,1,4,0.75
in November,2010,Nebraska,3,1,4,0.75
in December/January,2010,Nebraska,0,2,2,0.0
All Games,2011,Nebraska,9,4,13,0.6923076923076923
at Home,2011,Nebraska,6,1,7,0.8571428571428571
on Road/Neutral Site,2011,Nebraska,3,3,6,0.5
vs. Conference,2011,Nebraska,5,3,8,0.625
vs. Non-Conference,2011,Nebraska,4,1,5,0.8
vs. Ranked (AP),2011,Nebraska,1,3,4,0.25
vs. Unranked (AP),2011,Nebraska,8,1,9,0.8888888888888888
vs. FBS (I-A),2011,Nebraska,8,4,12,0.6666666666666666
vs. FCS (I-AA),2011,Nebraska,1,0,1,1.0
vs. FBS Winning,2011,Nebraska,5,3,8,0.625
vs. FBS Non-Winning,2011,Nebraska,3,1,4,0.75
vs. BCS AQ,2011,Nebraska,6,4,10,0.6
vs. BCS non-AQ,2011,Nebraska,2,0,2,1.0
vs. FBS Power 5,2011,Nebraska,6,4,10,0.6
vs. FBS non-Power 5,2011,Nebraska,2,0,2,1.0
in August/September,2011,Nebraska,4,0,4,1.0
in October,2011,Nebraska,3,1,4,0.75
in November,2011,Nebraska,2,2,4,0.5
in December/January,2011,Nebraska,0,1,1,0.0
All Games,2012,Nebraska,10,4,14,0.7142857142857143
at Home,2012,Nebraska,7,0,7,1.0
on Road/Neutral Site,2012,Nebraska,3,4,7,0.42857142857142855
vs. Conference,2012,Nebraska,7,2,9,0.7777777777777778
vs. Non-Conference,2012,Nebraska,3,2,5,0.6
vs. Ranked (AP),2012,Nebraska,2,2,4,0.5
vs. Unranked (AP),2012,Nebraska,8,2,10,0.8
vs. FBS (I-A),2012,Nebraska,9,4,13,0.6923076923076923
vs. FCS (I-AA),2012,Nebraska,1,0,1,1.0
vs. FBS Winning,2012,Nebraska,6,4,10,0.6
vs. FBS Non-Winning,2012,Nebraska,3,0,3,1.0
vs. BCS AQ,2012,Nebraska,7,4,11,0.6363636363636364
vs. BCS non-AQ,2012,Nebraska,2,0,2,1.0
vs. FBS Power 5,2012,Nebraska,7,4,11,0.6363636363636364
vs. FBS non-Power 5,2012,Nebraska,2,0,2,1.0
in August/September,2012,Nebraska,4,1,5,0.8
in October,2012,Nebraska,2,1,3,0.6666666666666666
in November,2012,Nebraska,4,0,4,1.0
in December/January,2012,Nebraska,0,2,2,0.0
All Games,2013,Nebraska,9,4,13,0.6923076923076923
at Home,2013,Nebraska,5,3,8,0.625
on Road/Neutral Site,2013,Nebraska,4,1,5,0.8
vs. Conference,2013,Nebraska,5,3,8,0.625
vs. Non-Conference,2013,Nebraska,4,1,5,0.8
vs. Ranked (AP),2013,Nebraska,0,2,2,0.0
vs. Unranked (AP),2013,Nebraska,9,2,11,0.8181818181818182
vs. FBS (I-A),2013,Nebraska,8,4,12,0.6666666666666666
vs. FCS (I-AA),2013,Nebraska,1,0,1,1.0
vs. FBS Winning,2013,Nebraska,3,4,7,0.42857142857142855
vs. FBS Non-Winning,2013,Nebraska,5,0,5,1.0
vs. BCS AQ,2013,Nebraska,6,4,10,0.6
vs. BCS non-AQ,2013,Nebraska,2,0,2,1.0
vs. FBS Power 5,2013,Nebraska,6,4,10,0.6
vs. FBS non-Power 5,2013,Nebraska,2,0,2,1.0
in August/September,2013,Nebraska,3,1,4,0.75
in October,2013,Nebraska,2,1,3,0.6666666666666666
in November,2013,Nebraska,3,2,5,0.6
in December/January,2013,Nebraska,1,0,1,1.0
All Games,2014,Nebraska,9,4,13,0.6923076923076923
at Home,2014,Nebraska,6,1,7,0.8571428571428571
on Road/Neutral Site,2014,Nebraska,3,3,6,0.5
vs. Conference,2014,Nebraska,5,3,8,0.625
vs. Non-Conference,2014,Nebraska,4,1,5,0.8
vs. Ranked (AP),2014,Nebraska,0,3,3,0.0
vs. Unranked (AP),2014,Nebraska,9,1,10,0.9
vs. FBS (I-A),2014,Nebraska,8,4,12,0.6666666666666666
vs. FCS (I-AA),2014,Nebraska,1,0,1,1.0
vs. FBS Winning,2014,Nebraska,2,4,6,0.3333333333333333
vs. FBS Non-Winning,2014,Nebraska,6,0,6,1.0
vs. BCS AQ,2014,Nebraska,6,4,10,0.6
vs. BCS non-AQ,2014,Nebraska,2,0,2,1.0
vs. FBS Power 5,2014,Nebraska,6,4,10,0.6
vs. FBS non-Power 5,2014,Nebraska,2,0,2,1.0
in August/September,2014,Nebraska,5,0,5,1.0
in October,2014,Nebraska,2,1,3,0.6666666666666666
in November,2014,Nebraska,2,2,4,0.5
in December/January,2014,Nebraska,0,1,1,0.0
All Games,2015,Nebraska,6,7,13,0.46153846153846156
at Home,2015,Nebraska,3,4,7,0.42857142857142855
on Road/Neutral Site,2015,Nebraska,3,3,6,0.5
vs. Conference,2015,Nebraska,3,5,8,0.375
vs. Non-Conference,2015,Nebraska,3,2,5,0.6
vs. Ranked (AP),2015,Nebraska,1,3,4,0.25
vs. Unranked (AP),2015,Nebraska,5,4,9,0.5555555555555556
vs. FBS (I-A),2015,Nebraska,6,7,13,0.46153846153846156
vs. FCS (I-AA),2015,Nebraska,0,0,0,
vs. FBS Winning,2015,Nebraska,3,5,8,0.375
vs. FBS Non-Winning,2015,Nebraska,3,2,5,0.6
vs. BCS AQ,2015,Nebraska,4,6,10,0.4
vs. BCS non-AQ,2015,Nebraska,2,1,3,0.6666666666666666
vs. FBS Power 5,2015,Nebraska,4,6,10,0.4
vs. FBS non-Power 5,2015,Nebraska,2,1,3,0.6666666666666666
in August/September,2015,Nebraska,2,2,4,0.5
in October,2015,Nebraska,1,4,5,0.2
in November,2015,Nebraska,2,1,3,0.6666666666666666
in December/January,2015,Nebraska,1,0,1,1.0
All Games,2016,Nebraska,9,4,13,0.6923076923076923
at Home,2016,Nebraska,7,0,7,1.0
on Road/Neutral Site,2016,Nebraska,2,4,6,0.3333333333333333
vs. Conference,2016,Nebraska,6,3,9,0.6666666666666666
vs. Non-Conference,2016,Nebraska,3,1,4,0.75
vs. Ranked (AP),2016,Nebraska,0,3,3,0.0
vs. Unranked (AP),2016,Nebraska,9,1,10,0.9
vs. FBS (I-A),2016,Nebraska,9,4,13,0.6923076923076923
vs. FCS (I-AA),2016,Nebraska,0,0,0,
vs. FBS Winning,2016,Nebraska,3,4,7,0.42857142857142855
vs. FBS Non-Winning,2016,Nebraska,6,0,6,1.0
vs. BCS AQ,2016,Nebraska,7,4,11,0.6363636363636364
vs. BCS non-AQ,2016,Nebraska,2,0,2,1.0
vs. FBS Power 5,2016,Nebraska,7,4,11,0.6363636363636364
vs. FBS non-Power 5,2016,Nebraska,2,0,2,1.0
in August/September,2016,Nebraska,4,0,4,1.0
in October,2016,Nebraska,3,1,4,0.75
in November,2016,Nebraska,2,2,4,0.5
in December/January,2016,Nebraska,0,1,1,0.0
All Games,2017,Nebraska,4,8,12,0.3333333333333333
at Home,2017,Nebraska,2,5,7,0.2857142857142857
on Road/Neutral Site,2017,Nebraska,2,3,5,0.4
vs. Conference,2017,Nebraska,3,6,9,0.3333333333333333
vs. Non-Conference,2017,Nebraska,1,2,3,0.3333333333333333
vs. Ranked (AP),2017,Nebraska,0,4,4,0.0
vs. Unranked (AP),2017,Nebraska,4,4,8,0.5
vs. FBS (I-A),2017,Nebraska,4,8,12,0.3333333333333333
vs. FCS (I-AA),2017,Nebraska,0,0,0,
vs. FBS Winning,2017,Nebraska,2,7,9,0.2222222222222222
vs. FBS Non-Winning,2017,Nebraska,2,1,3,0.6666666666666666
vs. BCS AQ,2017,Nebraska,3,7,10,0.3
vs. BCS non-AQ,2017,Nebraska,1,1,2,0.5
vs. FBS Power 5,2017,Nebraska,3,7,10,0.3
vs. FBS non-Power 5,2017,Nebraska,1,1,2,0.5
in August/September,2017,Nebraska,3,2,5,0.6
in October,2017,Nebraska,1,2,3,0.3333333333333333
in November,2017,Nebraska,0,4,4,0.0
in December/January,2017,Nebraska,0,0,0,
All Games,2018,Nebraska,4,8,12,0.3333333333333333
at Home,2018,Nebraska,4,3,7,0.5714285714285714
on Road/Neutral Site,2018,Nebraska,0,5,5,0.0
vs. Conference,2018,Nebraska,3,6,9,0.3333333333333333
vs. Non-Conference,2018,Nebraska,1,2,3,0.3333333333333333
vs. Ranked (AP),2018,Nebraska,0,4,4,0.0
vs. Unranked (AP),2018,Nebraska,4,4,8,0.5
vs. FBS (I-A),2018,Nebraska,3,8,11,0.2727272727272727
vs. FCS (I-AA),2018,Nebraska,1,0,1,1.0
vs. FBS Winning,2018,Nebraska,2,6,8,0.25
vs. FBS Non-Winning,2018,Nebraska,1,2,3,0.3333333333333333
vs. BCS AQ,2018,Nebraska,3,7,10,0.3
vs. BCS non-AQ,2018,Nebraska,0,1,1,0.0
vs. FBS Power 5,2018,Nebraska,3,7,10,0.3
vs. FBS non-Power 5,2018,Nebraska,0,1,1,0.0
in August/September,2018,Nebraska,0,4,4,0.0
in October,2018,Nebraska,2,2,4,0.5
in November,2018,Nebraska,2,2,4,0.5
in December/January,2018,Nebraska,0,0,0,
All Games,2019,Nebraska,5,7,12,0.4166666666666667
at Home,2019,Nebraska,3,4,7,0.42857142857142855
on Road/Neutral Site,2019,Nebraska,2,3,5,0.4
vs. Conference,2019,Nebraska,3,6,9,0.3333333333333333
vs. Non-Conference,2019,Nebraska,2,1,3,0.6666666666666666
vs. Ranked (AP),2019,Nebraska,0,4,4,0.0
vs. Unranked (AP),2019,Nebraska,5,3,8,0.625
vs. FBS (I-A),2019,Nebraska,5,7,12,0.4166666666666667
vs. FCS (I-AA),2019,Nebraska,0,0,0,
vs. FBS Winning,2019,Nebraska,0,5,5,0.0
vs. FBS Non-Winning,2019,Nebraska,5,2,7,0.7142857142857143
vs. BCS AQ,2019,Nebraska,3,7,10,0.3
vs. BCS non-AQ,2019,Nebraska,2,0,2,1.0
vs. FBS Power 5,2019,Nebraska,3,7,10,0.3
vs. FBS non-Power 5,2019,Nebraska,2,0,2,1.0
in August/September,2019,Nebraska,3,2,5,0.6
in October,2019,Nebraska,1,2,3,0.3333333333333333
in November,2019,Nebraska,1,3,4,0.25
in December/January,2019,Nebraska,0,0,0,
All Games,2020,Nebraska,3,5,8,0.375
at Home,2020,Nebraska,1,2,3,0.3333333333333333
on Road/Neutral Site,2020,Nebraska,2,3,5,0.4
vs. Conference,2020,Nebraska,3,5,8,0.375
vs. Non-Conference,2020,Nebraska,0,0,0,
vs. Ranked (AP),2020,Nebraska,0,3,3,0.0
vs. Unranked (AP),2020,Nebraska,3,2,5,0.6
vs. FBS (I-A),2020,Nebraska,3,5,8,0.375
vs. FCS (I-AA),2020,Nebraska,0,0,0,
vs. FBS Winning,2020,Nebraska,0,3,3,0.0
vs. FBS Non-Winning,2020,Nebraska,3,2,5,0.6
vs. BCS AQ,2020,Nebraska,3,5,8,0.375
vs. BCS non-AQ,2020,Nebraska,0,0,0,
vs. FBS Power 5,2020,Nebraska,3,5,8,0.375
vs. FBS non-Power 5,2020,Nebraska,0,0,0,
in August/September,2020,Nebraska,0,0,0,
in October,2020,Nebraska,0,1,1,0.0
in November,2020,Nebraska,1,3,4,0.25
in December/January,2020,Nebraska,2,1,3,0.6666666666666666
All Games,2021,Nebraska,3,9,12,0.25
at Home,2021,Nebraska,3,4,7,0.42857142857142855
on Road/Neutral Site,2021,Nebraska,0,5,5,0.0
vs. Conference,2021,Nebraska,1,8,9,0.1111111111111111
vs. Non-Conference,2021,Nebraska,2,1,3,0.6666666666666666
vs. Ranked (AP),2021,Nebraska,0,5,5,0.0
vs. Unranked (AP),2021,Nebraska,3,4,7,0.42857142857142855
vs. FBS (I-A),2021,Nebraska,2,9,11,0.18181818181818182
vs. FCS (I-AA),2021,Nebraska,1,0,1,1.0
vs. FBS Winning,2021,Nebraska,0,8,8,0.0
vs. FBS Non-Winning,2021,Nebraska,2,1,3,0.6666666666666666
vs. BCS AQ,2021,Nebraska,1,9,10,0.1
vs. BCS non-AQ,2021,Nebraska,1,0,1,1.0
vs. FBS Power 5,2021,Nebraska,1,9,10,0.1
vs. FBS non-Power 5,2021,Nebraska,1,0,1,1.0
in August/September,2021,Nebraska,2,3,5,0.4
in October,2021,Nebraska,1,3,4,0.25
in November,2021,Nebraska,0,3,3,0.0
in December/January,2021,Nebraska,0,0,0,
All Games,2022,Nebraska,4,8,12,0.3333333333333333
at Home,2022,Nebraska,2,5,7,0.2857142857142857
on Road/Neutral Site,2022,Nebraska,2,3,5,0.4
vs. Conference,2022,Nebraska,3,6,9,0.3333333333333333
vs. Non-Conference,2022,Nebraska,1,2,3,0.3333333333333333
vs. Ranked (AP),2022,Nebraska,0,1,1,0.0
vs. Unranked (AP),2022,Nebraska,4,7,11,0.36363636363636365
vs. FBS (I-A),2022,Nebraska,3,8,11,0.2727272727272727
vs. FCS (I-AA),2022,Nebraska,1,0,1,1.0
vs. FBS Winning,2022,Nebraska,1,5,6,0.16666666666666666
vs. FBS Non-Winning,2022,Nebraska,2,3,5,0.4
vs. BCS AQ,2022,Nebraska,3,7,10,0.3
vs. BCS non-AQ,2022,Nebraska,0,1,1,0.0
vs. FBS Power 5,2022,Nebraska,3,7,10,0.3
vs. FBS non-Power 5,2022,Nebraska,0,1,1,0.0
in August/September,2022,Nebraska,1,3,4,0.25
in October,2022,Nebraska,2,2,4,0.5
in November,2022,Nebraska,1,3,4,0.25
in December/January,2022,Nebraska,0,0,0,
All Games,2009,Nevada,8,5,13,0.6153846153846154
at Home,2009,Nevada,5,1,6,0.8333333333333334
on Road/Neutral Site,2009,Nevada,3,4,7,0.42857142857142855
vs. Conference,2009,Nevada,7,1,8,0.875
vs. Non-Conference,2009,Nevada,1,4,5,0.2
vs. Ranked (AP),2009,Nevada,0,1,1,0.0
vs. Unranked (AP),2009,Nevada,8,4,12,0.6666666666666666
vs. FBS (I-A),2009,Nevada,8,5,13,0.6153846153846154
vs. FCS (I-AA),2009,Nevada,0,0,0,
vs. FBS Winning,2009,Nevada,2,3,5,0.4
vs. FBS Non-Winning,2009,Nevada,6,2,8,0.75
vs. BCS AQ,2009,Nevada,0,2,2,0.0
vs. BCS non-AQ,2009,Nevada,8,3,11,0.7272727272727273
vs. FBS Power 5,2009,Nevada,0,1,1,0.0
vs. FBS non-Power 5,2009,Nevada,8,4,12,0.6666666666666666
in August/September,2009,Nevada,0,3,3,0.0
in October,2009,Nevada,5,0,5,1.0
in November,2009,Nevada,3,1,4,0.75
in December/January,2009,Nevada,0,1,1,0.0
All Games,2010,Nevada,13,1,14,0.9285714285714286
at Home,2010,Nevada,7,0,7,1.0
on Road/Neutral Site,2010,Nevada,6,1,7,0.8571428571428571
vs. Conference,2010,Nevada,7,1,8,0.875
vs. Non-Conference,2010,Nevada,6,0,6,1.0
vs. Ranked (AP),2010,Nevada,1,0,1,1.0
vs. Unranked (AP),2010,Nevada,12,1,13,0.9230769230769231
vs. FBS (I-A),2010,Nevada,12,1,13,0.9230769230769231
vs. FCS (I-AA),2010,Nevada,1,0,1,1.0
vs. FBS Winning,2010,Nevada,4,1,5,0.8
vs. FBS Non-Winning,2010,Nevada,8,0,8,1.0
vs. BCS AQ,2010,Nevada,2,0,2,1.0
vs. BCS non-AQ,2010,Nevada,10,1,11,0.9090909090909091
vs. FBS Power 5,2010,Nevada,2,0,2,1.0
vs. FBS non-Power 5,2010,Nevada,10,1,11,0.9090909090909091
in August/September,2010,Nevada,4,0,4,1.0
in October,2010,Nevada,3,1,4,0.75
in November,2010,Nevada,4,0,4,1.0
in December/January,2010,Nevada,2,0,2,1.0
All Games,2011,Nevada,7,6,13,0.5384615384615384
at Home,2011,Nevada,5,1,6,0.8333333333333334
on Road/Neutral Site,2011,Nevada,2,5,7,0.2857142857142857
vs. Conference,2011,Nevada,5,2,7,0.7142857142857143
vs. Non-Conference,2011,Nevada,2,4,6,0.3333333333333333
vs. Ranked (AP),2011,Nevada,0,3,3,0.0
vs. Unranked (AP),2011,Nevada,7,3,10,0.7
vs. FBS (I-A),2011,Nevada,7,6,13,0.5384615384615384
vs. FCS (I-AA),2011,Nevada,0,0,0,
vs. FBS Winning,2011,Nevada,0,5,5,0.0
vs. FBS Non-Winning,2011,Nevada,7,1,8,0.875
vs. BCS AQ,2011,Nevada,0,2,2,0.0
vs. BCS non-AQ,2011,Nevada,7,4,11,0.6363636363636364
vs. FBS Power 5,2011,Nevada,0,2,2,0.0
vs. FBS non-Power 5,2011,Nevada,7,4,11,0.6363636363636364
in August/September,2011,Nevada,1,2,3,0.3333333333333333
in October,2011,Nevada,4,1,5,0.8
in November,2011,Nevada,1,2,3,0.3333333333333333
in December/January,2011,Nevada,1,1,2,0.5
All Games,2012,Nevada,7,6,13,0.5384615384615384
at Home,2012,Nevada,2,4,6,0.3333333333333333
on Road/Neutral Site,2012,Nevada,5,2,7,0.7142857142857143
vs. Conference,2012,Nevada,4,4,8,0.5
vs. Non-Conference,2012,Nevada,3,2,5,0.6
vs. Ranked (AP),2012,Nevada,0,1,1,0.0
vs. Unranked (AP),2012,Nevada,7,5,12,0.5833333333333334
vs. FBS (I-A),2012,Nevada,6,6,12,0.5
vs. FCS (I-AA),2012,Nevada,1,0,1,1.0
vs. FBS Winning,2012,Nevada,0,4,4,0.0
vs. FBS Non-Winning,2012,Nevada,6,2,8,0.75
vs. BCS AQ,2012,Nevada,1,2,3,0.3333333333333333
vs. BCS non-AQ,2012,Nevada,5,4,9,0.5555555555555556
vs. FBS Power 5,2012,Nevada,1,1,2,0.5
vs. FBS non-Power 5,2012,Nevada,5,5,10,0.5
in August/September,2012,Nevada,4,1,5,0.8
in October,2012,Nevada,2,2,4,0.5
in November,2012,Nevada,1,1,2,0.5
in December/January,2012,Nevada,0,2,2,0.0
All Games,2013,Nevada,4,8,12,0.3333333333333333
at Home,2013,Nevada,4,2,6,0.6666666666666666
on Road/Neutral Site,2013,Nevada,0,6,6,0.0
vs. Conference,2013,Nevada,3,5,8,0.375
vs. Non-Conference,2013,Nevada,1,3,4,0.25
vs. Ranked (AP),2013,Nevada,0,2,2,0.0
vs. Unranked (AP),2013,Nevada,4,6,10,0.4
vs. FBS (I-A),2013,Nevada,3,8,11,0.2727272727272727
vs. FCS (I-AA),2013,Nevada,1,0,1,1.0
vs. FBS Winning,2013,Nevada,0,8,8,0.0
vs. FBS Non-Winning,2013,Nevada,3,0,3,1.0
vs. BCS AQ,2013,Nevada,0,2,2,0.0
vs. BCS non-AQ,2013,Nevada,3,6,9,0.3333333333333333
vs. FBS Power 5,2013,Nevada,0,2,2,0.0
vs. FBS non-Power 5,2013,Nevada,3,6,9,0.3333333333333333
in August/September,2013,Nevada,3,2,5,0.6
in October,2013,Nevada,0,3,3,0.0
in November,2013,Nevada,1,3,4,0.25
in December/January,2013,Nevada,0,0,0,
All Games,2014,Nevada,7,6,13,0.5384615384615384
at Home,2014,Nevada,3,3,6,0.5
on Road/Neutral Site,2014,Nevada,4,3,7,0.5714285714285714
vs. Conference,2014,Nevada,4,4,8,0.5
vs. Non-Conference,2014,Nevada,3,2,5,0.6
vs. Ranked (AP),2014,Nevada,0,2,2,0.0
vs. Unranked (AP),2014,Nevada,7,4,11,0.6363636363636364
vs. FBS (I-A),2014,Nevada,6,6,12,0.5
vs. FCS (I-AA),2014,Nevada,1,0,1,1.0
vs. FBS Winning,2014,Nevada,2,5,7,0.2857142857142857
vs. FBS Non-Winning,2014,Nevada,4,1,5,0.8
vs. BCS AQ,2014,Nevada,1,1,2,0.5
vs. BCS non-AQ,2014,Nevada,5,5,10,0.5
vs. FBS Power 5,2014,Nevada,1,1,2,0.5
vs. FBS non-Power 5,2014,Nevada,5,5,10,0.5
in August/September,2014,Nevada,3,1,4,0.75
in October,2014,Nevada,2,2,4,0.5
in November,2014,Nevada,2,2,4,0.5
in December/January,2014,Nevada,0,1,1,0.0
All Games,2015,Nevada,7,6,13,0.5384615384615384
at Home,2015,Nevada,4,2,6,0.6666666666666666
on Road/Neutral Site,2015,Nevada,3,4,7,0.42857142857142855
vs. Conference,2015,Nevada,5,4,9,0.5555555555555556
vs. Non-Conference,2015,Nevada,2,2,4,0.5
vs. Ranked (AP),2015,Nevada,0,0,0,
vs. Unranked (AP),2015,Nevada,7,6,13,0.5384615384615384
vs. FBS (I-A),2015,Nevada,6,6,12,0.5
vs. FCS (I-AA),2015,Nevada,1,0,1,1.0
vs. FBS Winning,2015,Nevada,2,3,5,0.4
vs. FBS Non-Winning,2015,Nevada,4,3,7,0.5714285714285714
vs. BCS AQ,2015,Nevada,0,2,2,0.0
vs. BCS non-AQ,2015,Nevada,6,4,10,0.6
vs. FBS Power 5,2015,Nevada,0,2,2,0.0
vs. FBS non-Power 5,2015,Nevada,6,4,10,0.6
in August/September,2015,Nevada,2,2,4,0.5
in October,2015,Nevada,2,2,4,0.5
in November,2015,Nevada,2,2,4,0.5
in December/January,2015,Nevada,1,0,1,1.0
All Games,2016,Nevada,5,7,12,0.4166666666666667
at Home,2016,Nevada,4,2,6,0.6666666666666666
on Road/Neutral Site,2016,Nevada,1,5,6,0.16666666666666666
vs. Conference,2016,Nevada,3,5,8,0.375
vs. Non-Conference,2016,Nevada,2,2,4,0.5
vs. Ranked (AP),2016,Nevada,0,0,0,
vs. Unranked (AP),2016,Nevada,5,7,12,0.4166666666666667
vs. FBS (I-A),2016,Nevada,4,7,11,0.36363636363636365
vs. FCS (I-AA),2016,Nevada,1,0,1,1.0
vs. FBS Winning,2016,Nevada,0,3,3,0.0
vs. FBS Non-Winning,2016,Nevada,4,4,8,0.5
vs. BCS AQ,2016,Nevada,0,2,2,0.0
vs. BCS non-AQ,2016,Nevada,4,5,9,0.4444444444444444
vs. FBS Power 5,2016,Nevada,0,1,1,0.0
vs. FBS non-Power 5,2016,Nevada,4,6,10,0.4
in August/September,2016,Nevada,2,2,4,0.5
in October,2016,Nevada,1,3,4,0.25
in November,2016,Nevada,2,2,4,0.5
in December/January,2016,Nevada,0,0,0,
All Games,2017,Nevada,3,9,12,0.25
at Home,2017,Nevada,3,3,6,0.5
on Road/Neutral Site,2017,Nevada,0,6,6,0.0
vs. Conference,2017,Nevada,3,5,8,0.375
vs. Non-Conference,2017,Nevada,0,4,4,0.0
vs. Ranked (AP),2017,Nevada,0,2,2,0.0
vs. Unranked (AP),2017,Nevada,3,7,10,0.3
vs. FBS (I-A),2017,Nevada,3,8,11,0.2727272727272727
vs. FCS (I-AA),2017,Nevada,0,1,1,0.0
vs. FBS Winning,2017,Nevada,0,7,7,0.0
vs. FBS Non-Winning,2017,Nevada,3,1,4,0.75
vs. BCS AQ,2017,Nevada,0,2,2,0.0
vs. BCS non-AQ,2017,Nevada,3,6,9,0.3333333333333333
vs. FBS Power 5,2017,Nevada,0,2,2,0.0
vs. FBS non-Power 5,2017,Nevada,3,6,9,0.3333333333333333
in August/September,2017,Nevada,0,5,5,0.0
in October,2017,Nevada,1,2,3,0.3333333333333333
in November,2017,Nevada,2,2,4,0.5
in December/January,2017,Nevada,0,0,0,
All Games,2018,Nevada,8,5,13,0.6153846153846154
at Home,2018,Nevada,4,2,6,0.6666666666666666
on Road/Neutral Site,2018,Nevada,4,3,7,0.5714285714285714
vs. Conference,2018,Nevada,5,3,8,0.625
vs. Non-Conference,2018,Nevada,3,2,5,0.6
vs. Ranked (AP),2018,Nevada,0,2,2,0.0
vs. Unranked (AP),2018,Nevada,8,3,11,0.7272727272727273
vs. FBS (I-A),2018,Nevada,7,5,12,0.5833333333333334
vs. FCS (I-AA),2018,Nevada,1,0,1,1.0
vs. FBS Winning,2018,Nevada,3,3,6,0.5
vs. FBS Non-Winning,2018,Nevada,4,2,6,0.6666666666666666
vs. BCS AQ,2018,Nevada,1,1,2,0.5
vs. BCS non-AQ,2018,Nevada,6,4,10,0.6
vs. FBS Power 5,2018,Nevada,1,1,2,0.5
vs. FBS non-Power 5,2018,Nevada,6,4,10,0.6
in August/September,2018,Nevada,3,2,5,0.6
in October,2018,Nevada,2,2,4,0.5
in November,2018,Nevada,2,1,3,0.6666666666666666
in December/January,2018,Nevada,1,0,1,1.0
All Games,2019,Nevada,7,6,13,0.5384615384615384
at Home,2019,Nevada,4,2,6,0.6666666666666666
on Road/Neutral Site,2019,Nevada,3,4,7,0.42857142857142855
vs. Conference,2019,Nevada,4,4,8,0.5
vs. Non-Conference,2019,Nevada,3,2,5,0.6
vs. Ranked (AP),2019,Nevada,0,1,1,0.0
vs. Unranked (AP),2019,Nevada,7,5,12,0.5833333333333334
vs. FBS (I-A),2019,Nevada,6,6,12,0.5
vs. FCS (I-AA),2019,Nevada,1,0,1,1.0
vs. FBS Winning,2019,Nevada,1,5,6,0.16666666666666666
vs. FBS Non-Winning,2019,Nevada,5,1,6,0.8333333333333334
vs. BCS AQ,2019,Nevada,1,1,2,0.5
vs. BCS non-AQ,2019,Nevada,5,5,10,0.5
vs. FBS Power 5,2019,Nevada,1,1,2,0.5
vs. FBS non-Power 5,2019,Nevada,5,5,10,0.5
in August/September,2019,Nevada,3,2,5,0.6
in October,2019,Nevada,1,2,3,0.3333333333333333
in November,2019,Nevada,3,1,4,0.75
in December/January,2019,Nevada,0,1,1,0.0
All Games,2020,Nevada,7,2,9,0.7777777777777778
at Home,2020,Nevada,4,0,4,1.0
on Road/Neutral Site,2020,Nevada,3,2,5,0.6
vs. Conference,2020,Nevada,6,2,8,0.75
vs. Non-Conference,2020,Nevada,1,0,1,1.0
vs. Ranked (AP),2020,Nevada,0,1,1,0.0
vs. Unranked (AP),2020,Nevada,7,1,8,0.875
vs. FBS (I-A),2020,Nevada,7,2,9,0.7777777777777778
vs. FCS (I-AA),2020,Nevada,0,0,0,
vs. FBS Winning,2020,Nevada,0,2,2,0.0
vs. FBS Non-Winning,2020,Nevada,7,0,7,1.0
vs. BCS AQ,2020,Nevada,1,0,1,1.0
vs. BCS non-AQ,2020,Nevada,6,2,8,0.75
vs. FBS Power 5,2020,Nevada,0,0,0,
vs. FBS non-Power 5,2020,Nevada,7,2,9,0.7777777777777778
in August/September,2020,Nevada,0,0,0,
in October,2020,Nevada,2,0,2,1.0
in November,2020,Nevada,3,1,4,0.75
in December/January,2020,Nevada,2,1,3,0.6666666666666666
All Games,2021,Nevada,8,5,13,0.6153846153846154
at Home,2021,Nevada,5,1,6,0.8333333333333334
on Road/Neutral Site,2021,Nevada,3,4,7,0.42857142857142855
vs. Conference,2021,Nevada,5,3,8,0.625
vs. Non-Conference,2021,Nevada,3,2,5,0.6
vs. Ranked (AP),2021,Nevada,0,1,1,0.0
vs. Unranked (AP),2021,Nevada,8,4,12,0.6666666666666666
vs. FBS (I-A),2021,Nevada,7,5,12,0.5833333333333334
vs. FCS (I-AA),2021,Nevada,1,0,1,1.0
vs. FBS Winning,2021,Nevada,1,5,6,0.16666666666666666
vs. FBS Non-Winning,2021,Nevada,6,0,6,1.0
vs. BCS AQ,2021,Nevada,1,1,2,0.5
vs. BCS non-AQ,2021,Nevada,6,4,10,0.6
vs. FBS Power 5,2021,Nevada,1,1,2,0.5
vs. FBS non-Power 5,2021,Nevada,6,4,10,0.6
in August/September,2021,Nevada,2,1,3,0.6666666666666666
in October,2021,Nevada,4,1,5,0.8
in November,2021,Nevada,2,2,4,0.5
in December/January,2021,Nevada,0,1,1,0.0
All Games,2022,Nevada,2,10,12,0.16666666666666666
at Home,2022,Nevada,1,5,6,0.16666666666666666
on Road/Neutral Site,2022,Nevada,1,5,6,0.16666666666666666
vs. Conference,2022,Nevada,0,8,8,0.0
vs. Non-Conference,2022,Nevada,2,2,4,0.5
vs. Ranked (AP),2022,Nevada,0,1,1,0.0
vs. Unranked (AP),2022,Nevada,2,9,11,0.18181818181818182
vs. FBS (I-A),2022,Nevada,2,9,11,0.18181818181818182
vs. FCS (I-AA),2022,Nevada,0,1,1,0.0
vs. FBS Winning,2022,Nevada,1,6,7,0.14285714285714285
vs. FBS Non-Winning,2022,Nevada,1,3,4,0.25
vs. BCS AQ,2022,Nevada,0,1,1,0.0
vs. BCS non-AQ,2022,Nevada,2,8,10,0.2
vs. FBS Power 5,2022,Nevada,0,1,1,0.0
vs. FBS non-Power 5,2022,Nevada,2,8,10,0.2
in August/September,2022,Nevada,2,3,5,0.4
in October,2022,Nevada,0,4,4,0.0
in November,2022,Nevada,0,3,3,0.0
in December/January,2022,Nevada,0,0,0,
All Games,2009,New Mexico,1,11,12,0.08333333333333333
at Home,2009,New Mexico,1,5,6,0.16666666666666666
on Road/Neutral Site,2009,New Mexico,0,6,6,0.0
vs. Conference,2009,New Mexico,1,7,8,0.125
vs. Non-Conference,2009,New Mexico,0,4,4,0.0
vs. Ranked (AP),2009,New Mexico,0,4,4,0.0
vs. Unranked (AP),2009,New Mexico,1,7,8,0.125
vs. FBS (I-A),2009,New Mexico,1,11,12,0.08333333333333333
vs. FCS (I-AA),2009,New Mexico,0,0,0,
vs. FBS Winning,2009,New Mexico,0,6,6,0.0
vs. FBS Non-Winning,2009,New Mexico,1,5,6,0.16666666666666666
vs. BCS AQ,2009,New Mexico,0,2,2,0.0
vs. BCS non-AQ,2009,New Mexico,1,9,10,0.1
vs. FBS Power 5,2009,New Mexico,0,2,2,0.0
vs. FBS non-Power 5,2009,New Mexico,1,9,10,0.1
in August/September,2009,New Mexico,0,4,4,0.0
in October,2009,New Mexico,0,4,4,0.0
in November,2009,New Mexico,1,3,4,0.25
in December/January,2009,New Mexico,0,0,0,
All Games,2010,New Mexico,1,11,12,0.08333333333333333
at Home,2010,New Mexico,1,5,6,0.16666666666666666
on Road/Neutral Site,2010,New Mexico,0,6,6,0.0
vs. Conference,2010,New Mexico,1,7,8,0.125
vs. Non-Conference,2010,New Mexico,0,4,4,0.0
vs. Ranked (AP),2010,New Mexico,0,2,2,0.0
vs. Unranked (AP),2010,New Mexico,1,9,10,0.1
vs. FBS (I-A),2010,New Mexico,1,11,12,0.08333333333333333
vs. FCS (I-AA),2010,New Mexico,0,0,0,
vs. FBS Winning,2010,New Mexico,0,7,7,0.0
vs. FBS Non-Winning,2010,New Mexico,1,4,5,0.2
vs. BCS AQ,2010,New Mexico,0,2,2,0.0
vs. BCS non-AQ,2010,New Mexico,1,9,10,0.1
vs. FBS Power 5,2010,New Mexico,0,2,2,0.0
vs. FBS non-Power 5,2010,New Mexico,1,9,10,0.1
in August/September,2010,New Mexico,0,4,4,0.0
in October,2010,New Mexico,0,4,4,0.0
in November,2010,New Mexico,1,3,4,0.25
in December/January,2010,New Mexico,0,0,0,
All Games,2011,New Mexico,1,11,12,0.08333333333333333
at Home,2011,New Mexico,1,5,6,0.16666666666666666
on Road/Neutral Site,2011,New Mexico,0,6,6,0.0
vs. Conference,2011,New Mexico,1,6,7,0.14285714285714285
vs. Non-Conference,2011,New Mexico,0,5,5,0.0
vs. Ranked (AP),2011,New Mexico,0,3,3,0.0
vs. Unranked (AP),2011,New Mexico,1,8,9,0.1111111111111111
vs. FBS (I-A),2011,New Mexico,1,10,11,0.09090909090909091
vs. FCS (I-AA),2011,New Mexico,0,1,1,0.0
vs. FBS Winning,2011,New Mexico,0,7,7,0.0
vs. FBS Non-Winning,2011,New Mexico,1,3,4,0.25
vs. BCS AQ,2011,New Mexico,0,2,2,0.0
vs. BCS non-AQ,2011,New Mexico,1,8,9,0.1111111111111111
vs. FBS Power 5,2011,New Mexico,0,2,2,0.0
vs. FBS non-Power 5,2011,New Mexico,1,8,9,0.1111111111111111
in August/September,2011,New Mexico,0,4,4,0.0
in October,2011,New Mexico,0,4,4,0.0
in November,2011,New Mexico,1,2,3,0.3333333333333333
in December/January,2011,New Mexico,0,1,1,0.0
All Games,2012,New Mexico,4,9,13,0.3076923076923077
at Home,2012,New Mexico,2,4,6,0.3333333333333333
on Road/Neutral Site,2012,New Mexico,2,5,7,0.2857142857142857
vs. Conference,2012,New Mexico,1,7,8,0.125
vs. Non-Conference,2012,New Mexico,3,2,5,0.6
vs. Ranked (AP),2012,New Mexico,0,2,2,0.0
vs. Unranked (AP),2012,New Mexico,4,7,11,0.36363636363636365
vs. FBS (I-A),2012,New Mexico,3,9,12,0.25
vs. FCS (I-AA),2012,New Mexico,1,0,1,1.0
vs. FBS Winning,2012,New Mexico,0,5,5,0.0
vs. FBS Non-Winning,2012,New Mexico,3,4,7,0.42857142857142855
vs. BCS AQ,2012,New Mexico,0,2,2,0.0
vs. BCS non-AQ,2012,New Mexico,3,7,10,0.3
vs. FBS Power 5,2012,New Mexico,0,2,2,0.0
vs. FBS non-Power 5,2012,New Mexico,3,7,10,0.3
in August/September,2012,New Mexico,2,3,5,0.4
in October,2012,New Mexico,2,2,4,0.5
in November,2012,New Mexico,0,4,4,0.0
in December/January,2012,New Mexico,0,0,0,
All Games,2013,New Mexico,3,9,12,0.25
at Home,2013,New Mexico,2,4,6,0.3333333333333333
on Road/Neutral Site,2013,New Mexico,1,5,6,0.16666666666666666
vs. Conference,2013,New Mexico,1,7,8,0.125
vs. Non-Conference,2013,New Mexico,2,2,4,0.5
vs. Ranked (AP),2013,New Mexico,0,0,0,
vs. Unranked (AP),2013,New Mexico,3,9,12,0.25
vs. FBS (I-A),2013,New Mexico,3,9,12,0.25
vs. FCS (I-AA),2013,New Mexico,0,0,0,
vs. FBS Winning,2013,New Mexico,0,8,8,0.0
vs. FBS Non-Winning,2013,New Mexico,3,1,4,0.75
vs. BCS AQ,2013,New Mexico,0,1,1,0.0
vs. BCS non-AQ,2013,New Mexico,3,8,11,0.2727272727272727
vs. FBS Power 5,2013,New Mexico,0,1,1,0.0
vs. FBS non-Power 5,2013,New Mexico,3,8,11,0.2727272727272727
in August/September,2013,New Mexico,1,3,4,0.25
in October,2013,New Mexico,1,2,3,0.3333333333333333
in November,2013,New Mexico,1,4,5,0.2
in December/January,2013,New Mexico,0,0,0,
All Games,2014,New Mexico,4,8,12,0.3333333333333333
at Home,2014,New Mexico,1,5,6,0.16666666666666666
on Road/Neutral Site,2014,New Mexico,3,3,6,0.5
vs. Conference,2014,New Mexico,2,6,8,0.25
vs. Non-Conference,2014,New Mexico,2,2,4,0.5
vs. Ranked (AP),2014,New Mexico,0,2,2,0.0
vs. Unranked (AP),2014,New Mexico,4,6,10,0.4
vs. FBS (I-A),2014,New Mexico,4,8,12,0.3333333333333333
vs. FCS (I-AA),2014,New Mexico,0,0,0,
vs. FBS Winning,2014,New Mexico,0,7,7,0.0
vs. FBS Non-Winning,2014,New Mexico,4,1,5,0.8
vs. BCS AQ,2014,New Mexico,0,1,1,0.0
vs. BCS non-AQ,2014,New Mexico,4,7,11,0.36363636363636365
vs. FBS Power 5,2014,New Mexico,0,1,1,0.0
vs. FBS non-Power 5,2014,New Mexico,4,7,11,0.36363636363636365
in August/September,2014,New Mexico,1,3,4,0.25
in October,2014,New Mexico,1,2,3,0.3333333333333333
in November,2014,New Mexico,2,3,5,0.4
in December/January,2014,New Mexico,0,0,0,
All Games,2015,New Mexico,7,6,13,0.5384615384615384
at Home,2015,New Mexico,5,2,7,0.7142857142857143
on Road/Neutral Site,2015,New Mexico,2,4,6,0.3333333333333333
vs. Conference,2015,New Mexico,5,3,8,0.625
vs. Non-Conference,2015,New Mexico,2,3,5,0.4
vs. Ranked (AP),2015,New Mexico,0,0,0,
vs. Unranked (AP),2015,New Mexico,7,6,13,0.5384615384615384
vs. FBS (I-A),2015,New Mexico,6,6,12,0.5
vs. FCS (I-AA),2015,New Mexico,1,0,1,1.0
vs. FBS Winning,2015,New Mexico,2,3,5,0.4
vs. FBS Non-Winning,2015,New Mexico,4,3,7,0.5714285714285714
vs. BCS AQ,2015,New Mexico,0,3,3,0.0
vs. BCS non-AQ,2015,New Mexico,6,3,9,0.6666666666666666
vs. FBS Power 5,2015,New Mexico,0,2,2,0.0
vs. FBS non-Power 5,2015,New Mexico,6,4,10,0.6
in August/September,2015,New Mexico,2,2,4,0.5
in October,2015,New Mexico,2,2,4,0.5
in November,2015,New Mexico,3,1,4,0.75
in December/January,2015,New Mexico,0,1,1,0.0
All Games,2016,New Mexico,9,4,13,0.6923076923076923
at Home,2016,New Mexico,5,1,6,0.8333333333333334
on Road/Neutral Site,2016,New Mexico,4,3,7,0.5714285714285714
vs. Conference,2016,New Mexico,6,2,8,0.75
vs. Non-Conference,2016,New Mexico,3,2,5,0.6
vs. Ranked (AP),2016,New Mexico,0,0,0,
vs. Unranked (AP),2016,New Mexico,9,4,13,0.6923076923076923
vs. FBS (I-A),2016,New Mexico,8,4,12,0.6666666666666666
vs. FCS (I-AA),2016,New Mexico,1,0,1,1.0
vs. FBS Winning,2016,New Mexico,2,2,4,0.5
vs. FBS Non-Winning,2016,New Mexico,6,2,8,0.75
vs. BCS AQ,2016,New Mexico,0,1,1,0.0
vs. BCS non-AQ,2016,New Mexico,8,3,11,0.7272727272727273
vs. FBS Power 5,2016,New Mexico,0,1,1,0.0
vs. FBS non-Power 5,2016,New Mexico,8,3,11,0.7272727272727273
in August/September,2016,New Mexico,1,2,3,0.3333333333333333
in October,2016,New Mexico,4,1,5,0.8
in November,2016,New Mexico,3,1,4,0.75
in December/January,2016,New Mexico,1,0,1,1.0
All Games,2017,New Mexico,3,9,12,0.25
at Home,2017,New Mexico,2,4,6,0.3333333333333333
on Road/Neutral Site,2017,New Mexico,1,5,6,0.16666666666666666
vs. Conference,2017,New Mexico,1,7,8,0.125
vs. Non-Conference,2017,New Mexico,2,2,4,0.5
vs. Ranked (AP),2017,New Mexico,0,1,1,0.0
vs. Unranked (AP),2017,New Mexico,3,8,11,0.2727272727272727
vs. FBS (I-A),2017,New Mexico,2,9,11,0.18181818181818182
vs. FCS (I-AA),2017,New Mexico,1,0,1,1.0
vs. FBS Winning,2017,New Mexico,0,7,7,0.0
vs. FBS Non-Winning,2017,New Mexico,2,2,4,0.5
vs. BCS AQ,2017,New Mexico,1,1,2,0.5
vs. BCS non-AQ,2017,New Mexico,1,8,9,0.1111111111111111
vs. FBS Power 5,2017,New Mexico,0,1,1,0.0
vs. FBS non-Power 5,2017,New Mexico,2,8,10,0.2
in August/September,2017,New Mexico,3,2,5,0.6
in October,2017,New Mexico,0,3,3,0.0
in November,2017,New Mexico,0,4,4,0.0
in December/January,2017,New Mexico,0,0,0,
All Games,2018,New Mexico,3,9,12,0.25
at Home,2018,New Mexico,1,5,6,0.16666666666666666
on Road/Neutral Site,2018,New Mexico,2,4,6,0.3333333333333333
vs. Conference,2018,New Mexico,1,7,8,0.125
vs. Non-Conference,2018,New Mexico,2,2,4,0.5
vs. Ranked (AP),2018,New Mexico,0,3,3,0.0
vs. Unranked (AP),2018,New Mexico,3,6,9,0.3333333333333333
vs. FBS (I-A),2018,New Mexico,2,9,11,0.18181818181818182
vs. FCS (I-AA),2018,New Mexico,1,0,1,1.0
vs. FBS Winning,2018,New Mexico,0,5,5,0.0
vs. FBS Non-Winning,2018,New Mexico,2,4,6,0.3333333333333333
vs. BCS AQ,2018,New Mexico,0,1,1,0.0
vs. BCS non-AQ,2018,New Mexico,2,8,10,0.2
vs. FBS Power 5,2018,New Mexico,0,1,1,0.0
vs. FBS non-Power 5,2018,New Mexico,2,8,10,0.2
in August/September,2018,New Mexico,2,2,4,0.5
in October,2018,New Mexico,1,3,4,0.25
in November,2018,New Mexico,0,4,4,0.0
in December/January,2018,New Mexico,0,0,0,
All Games,2019,New Mexico,2,10,12,0.16666666666666666
at Home,2019,New Mexico,2,4,6,0.3333333333333333
on Road/Neutral Site,2019,New Mexico,0,6,6,0.0
vs. Conference,2019,New Mexico,0,8,8,0.0
vs. Non-Conference,2019,New Mexico,2,2,4,0.5
vs. Ranked (AP),2019,New Mexico,0,3,3,0.0
vs. Unranked (AP),2019,New Mexico,2,7,9,0.2222222222222222
vs. FBS (I-A),2019,New Mexico,1,10,11,0.09090909090909091
vs. FCS (I-AA),2019,New Mexico,1,0,1,1.0
vs. FBS Winning,2019,New Mexico,0,8,8,0.0
vs. FBS Non-Winning,2019,New Mexico,1,2,3,0.3333333333333333
vs. BCS AQ,2019,New Mexico,0,1,1,0.0
vs. BCS non-AQ,2019,New Mexico,1,9,10,0.1
vs. FBS Power 5,2019,New Mexico,0,0,0,
vs. FBS non-Power 5,2019,New Mexico,1,10,11,0.09090909090909091
in August/September,2019,New Mexico,2,2,4,0.5
in October,2019,New Mexico,0,4,4,0.0
in November,2019,New Mexico,0,4,4,0.0
in December/January,2019,New Mexico,0,0,0,
All Games,2020,New Mexico,2,5,7,0.2857142857142857
at Home,2020,New Mexico,0,0,0,
on Road/Neutral Site,2020,New Mexico,2,5,7,0.2857142857142857
vs. Conference,2020,New Mexico,2,5,7,0.2857142857142857
vs. Non-Conference,2020,New Mexico,0,0,0,
vs. Ranked (AP),2020,New Mexico,0,1,1,0.0
vs. Unranked (AP),2020,New Mexico,2,4,6,0.3333333333333333
vs. FBS (I-A),2020,New Mexico,2,5,7,0.2857142857142857
vs. FCS (I-AA),2020,New Mexico,0,0,0,
vs. FBS Winning,2020,New Mexico,0,3,3,0.0
vs. FBS Non-Winning,2020,New Mexico,2,2,4,0.5
vs. BCS AQ,2020,New Mexico,0,0,0,
vs. BCS non-AQ,2020,New Mexico,2,5,7,0.2857142857142857
vs. FBS Power 5,2020,New Mexico,0,0,0,
vs. FBS non-Power 5,2020,New Mexico,2,5,7,0.2857142857142857
in August/September,2020,New Mexico,0,0,0,
in October,2020,New Mexico,0,1,1,0.0
in November,2020,New Mexico,0,4,4,0.0
in December/January,2020,New Mexico,2,0,2,1.0
All Games,2021,New Mexico,3,9,12,0.25
at Home,2021,New Mexico,2,4,6,0.3333333333333333
on Road/Neutral Site,2021,New Mexico,1,5,6,0.16666666666666666
vs. Conference,2021,New Mexico,1,7,8,0.125
vs. Non-Conference,2021,New Mexico,2,2,4,0.5
vs. Ranked (AP),2021,New Mexico,0,2,2,0.0
vs. Unranked (AP),2021,New Mexico,3,7,10,0.3
vs. FBS (I-A),2021,New Mexico,2,9,11,0.18181818181818182
vs. FCS (I-AA),2021,New Mexico,1,0,1,1.0
vs. FBS Winning,2021,New Mexico,1,7,8,0.125
vs. FBS Non-Winning,2021,New Mexico,1,2,3,0.3333333333333333
vs. BCS AQ,2021,New Mexico,0,1,1,0.0
vs. BCS non-AQ,2021,New Mexico,2,8,10,0.2
vs. FBS Power 5,2021,New Mexico,0,1,1,0.0
vs. FBS non-Power 5,2021,New Mexico,2,8,10,0.2
in August/September,2021,New Mexico,2,2,4,0.5
in October,2021,New Mexico,1,3,4,0.25
in November,2021,New Mexico,0,4,4,0.0
in December/January,2021,New Mexico,0,0,0,
All Games,2022,New Mexico,2,10,12,0.16666666666666666
at Home,2022,New Mexico,2,4,6,0.3333333333333333
on Road/Neutral Site,2022,New Mexico,0,6,6,0.0
vs. Conference,2022,New Mexico,0,8,8,0.0
vs. Non-Conference,2022,New Mexico,2,2,4,0.5
vs. Ranked (AP),2022,New Mexico,0,2,2,0.0
vs. Unranked (AP),2022,New Mexico,2,8,10,0.2
vs. FBS (I-A),2022,New Mexico,1,10,11,0.09090909090909091
vs. FCS (I-AA),2022,New Mexico,1,0,1,1.0
vs. FBS Winning,2022,New Mexico,0,7,7,0.0
vs. FBS Non-Winning,2022,New Mexico,1,3,4,0.25
vs. BCS AQ,2022,New Mexico,0,1,1,0.0
vs. BCS non-AQ,2022,New Mexico,1,9,10,0.1
vs. FBS Power 5,2022,New Mexico,0,1,1,0.0
vs. FBS non-Power 5,2022,New Mexico,1,9,10,0.1
in August/September,2022,New Mexico,2,3,5,0.4
in October,2022,New Mexico,0,3,3,0.0
in November,2022,New Mexico,0,4,4,0.0
in December/January,2022,New Mexico,0,0,0,
All Games,2009,New Mexico State,3,10,13,0.23076923076923078
at Home,2009,New Mexico State,2,4,6,0.3333333333333333
on Road/Neutral Site,2009,New Mexico State,1,6,7,0.14285714285714285
vs. Conference,2009,New Mexico State,1,7,8,0.125
vs. Non-Conference,2009,New Mexico State,2,3,5,0.4
vs. Ranked (AP),2009,New Mexico State,0,2,2,0.0
vs. Unranked (AP),2009,New Mexico State,3,8,11,0.2727272727272727
vs. FBS (I-A),2009,New Mexico State,2,10,12,0.16666666666666666
vs. FCS (I-AA),2009,New Mexico State,1,0,1,1.0
vs. FBS Winning,2009,New Mexico State,0,5,5,0.0
vs. FBS Non-Winning,2009,New Mexico State,2,5,7,0.2857142857142857
vs. BCS AQ,2009,New Mexico State,0,1,1,0.0
vs. BCS non-AQ,2009,New Mexico State,2,9,11,0.18181818181818182
vs. FBS Power 5,2009,New Mexico State,0,1,1,0.0
vs. FBS non-Power 5,2009,New Mexico State,2,9,11,0.18181818181818182
in August/September,2009,New Mexico State,2,2,4,0.5
in October,2009,New Mexico State,1,4,5,0.2
in November,2009,New Mexico State,0,3,3,0.0
in December/January,2009,New Mexico State,0,1,1,0.0
All Games,2010,New Mexico State,2,10,12,0.16666666666666666
at Home,2010,New Mexico State,2,4,6,0.3333333333333333
on Road/Neutral Site,2010,New Mexico State,0,6,6,0.0
vs. Conference,2010,New Mexico State,1,7,8,0.125
vs. Non-Conference,2010,New Mexico State,1,3,4,0.25
vs. Ranked (AP),2010,New Mexico State,0,2,2,0.0
vs. Unranked (AP),2010,New Mexico State,2,8,10,0.2
vs. FBS (I-A),2010,New Mexico State,2,10,12,0.16666666666666666
vs. FCS (I-AA),2010,New Mexico State,0,0,0,
vs. FBS Winning,2010,New Mexico State,0,5,5,0.0
vs. FBS Non-Winning,2010,New Mexico State,2,5,7,0.2857142857142857
vs. BCS AQ,2010,New Mexico State,0,1,1,0.0
vs. BCS non-AQ,2010,New Mexico State,2,9,11,0.18181818181818182
vs. FBS Power 5,2010,New Mexico State,0,1,1,0.0
vs. FBS non-Power 5,2010,New Mexico State,2,9,11,0.18181818181818182
in August/September,2010,New Mexico State,0,3,3,0.0
in October,2010,New Mexico State,2,3,5,0.4
in November,2010,New Mexico State,0,4,4,0.0
in December/January,2010,New Mexico State,0,0,0,
All Games,2011,New Mexico State,4,9,13,0.3076923076923077
at Home,2011,New Mexico State,2,4,6,0.3333333333333333
on Road/Neutral Site,2011,New Mexico State,2,5,7,0.2857142857142857
vs. Conference,2011,New Mexico State,2,5,7,0.2857142857142857
vs. Non-Conference,2011,New Mexico State,2,4,6,0.3333333333333333
vs. Ranked (AP),2011,New Mexico State,0,1,1,0.0
vs. Unranked (AP),2011,New Mexico State,4,8,12,0.3333333333333333
vs. FBS (I-A),2011,New Mexico State,4,9,13,0.3076923076923077
vs. FCS (I-AA),2011,New Mexico State,0,0,0,
vs. FBS Winning,2011,New Mexico State,0,6,6,0.0
vs. FBS Non-Winning,2011,New Mexico State,4,3,7,0.5714285714285714
vs. BCS AQ,2011,New Mexico State,1,1,2,0.5
vs. BCS non-AQ,2011,New Mexico State,3,8,11,0.2727272727272727
vs. FBS Power 5,2011,New Mexico State,1,1,2,0.5
vs. FBS non-Power 5,2011,New Mexico State,3,8,11,0.2727272727272727
in August/September,2011,New Mexico State,1,3,4,0.25
in October,2011,New Mexico State,2,2,4,0.5
in November,2011,New Mexico State,1,3,4,0.25
in December/January,2011,New Mexico State,0,1,1,0.0
All Games,2012,New Mexico State,1,11,12,0.08333333333333333
at Home,2012,New Mexico State,1,5,6,0.16666666666666666
on Road/Neutral Site,2012,New Mexico State,0,6,6,0.0
vs. Conference,2012,New Mexico State,0,6,6,0.0
vs. Non-Conference,2012,New Mexico State,1,5,6,0.16666666666666666
vs. Ranked (AP),2012,New Mexico State,0,2,2,0.0
vs. Unranked (AP),2012,New Mexico State,1,9,10,0.1
vs. FBS (I-A),2012,New Mexico State,0,11,11,0.0
vs. FCS (I-AA),2012,New Mexico State,1,0,1,1.0
vs. FBS Winning,2012,New Mexico State,0,6,6,0.0
vs. FBS Non-Winning,2012,New Mexico State,0,5,5,0.0
vs. BCS AQ,2012,New Mexico State,0,1,1,0.0
vs. BCS non-AQ,2012,New Mexico State,0,10,10,0.0
vs. FBS Power 5,2012,New Mexico State,0,1,1,0.0
vs. FBS non-Power 5,2012,New Mexico State,0,10,10,0.0
in August/September,2012,New Mexico State,1,4,5,0.2
in October,2012,New Mexico State,0,3,3,0.0
in November,2012,New Mexico State,0,3,3,0.0
in December/January,2012,New Mexico State,0,1,1,0.0
All Games,2013,New Mexico State,2,10,12,0.16666666666666666
at Home,2013,New Mexico State,2,5,7,0.2857142857142857
on Road/Neutral Site,2013,New Mexico State,0,5,5,0.0
vs. Conference,2013,New Mexico State,1,0,1,1.0
vs. Non-Conference,2013,New Mexico State,1,10,11,0.09090909090909091
vs. Ranked (AP),2013,New Mexico State,0,1,1,0.0
vs. Unranked (AP),2013,New Mexico State,2,9,11,0.18181818181818182
vs. FBS (I-A),2013,New Mexico State,1,10,11,0.09090909090909091
vs. FCS (I-AA),2013,New Mexico State,1,0,1,1.0
vs. FBS Winning,2013,New Mexico State,0,7,7,0.0
vs. FBS Non-Winning,2013,New Mexico State,1,3,4,0.25
vs. BCS AQ,2013,New Mexico State,0,4,4,0.0
vs. BCS non-AQ,2013,New Mexico State,1,6,7,0.14285714285714285
vs. FBS Power 5,2013,New Mexico State,0,4,4,0.0
vs. FBS non-Power 5,2013,New Mexico State,1,6,7,0.14285714285714285
in August/September,2013,New Mexico State,0,5,5,0.0
in October,2013,New Mexico State,1,2,3,0.3333333333333333
in November,2013,New Mexico State,1,3,4,0.25
in December/January,2013,New Mexico State,0,0,0,
All Games,2014,New Mexico State,2,10,12,0.16666666666666666
at Home,2014,New Mexico State,1,5,6,0.16666666666666666
on Road/Neutral Site,2014,New Mexico State,1,5,6,0.16666666666666666
vs. Conference,2014,New Mexico State,1,7,8,0.125
vs. Non-Conference,2014,New Mexico State,1,3,4,0.25
vs. Ranked (AP),2014,New Mexico State,0,0,0,
vs. Unranked (AP),2014,New Mexico State,2,10,12,0.16666666666666666
vs. FBS (I-A),2014,New Mexico State,1,10,11,0.09090909090909091
vs. FCS (I-AA),2014,New Mexico State,1,0,1,1.0
vs. FBS Winning,2014,New Mexico State,0,6,6,0.0
vs. FBS Non-Winning,2014,New Mexico State,1,4,5,0.2
vs. BCS AQ,2014,New Mexico State,0,1,1,0.0
vs. BCS non-AQ,2014,New Mexico State,1,9,10,0.1
vs. FBS Power 5,2014,New Mexico State,0,1,1,0.0
vs. FBS non-Power 5,2014,New Mexico State,1,9,10,0.1
in August/September,2014,New Mexico State,2,3,5,0.4
in October,2014,New Mexico State,0,3,3,0.0
in November,2014,New Mexico State,0,4,4,0.0
in December/January,2014,New Mexico State,0,0,0,
All Games,2015,New Mexico State,3,9,12,0.25
at Home,2015,New Mexico State,1,4,5,0.2
on Road/Neutral Site,2015,New Mexico State,2,5,7,0.2857142857142857
vs. Conference,2015,New Mexico State,3,5,8,0.375
vs. Non-Conference,2015,New Mexico State,0,4,4,0.0
vs. Ranked (AP),2015,New Mexico State,0,2,2,0.0
vs. Unranked (AP),2015,New Mexico State,3,7,10,0.3
vs. FBS (I-A),2015,New Mexico State,3,9,12,0.25
vs. FCS (I-AA),2015,New Mexico State,0,0,0,
vs. FBS Winning,2015,New Mexico State,0,5,5,0.0
vs. FBS Non-Winning,2015,New Mexico State,3,4,7,0.42857142857142855
vs. BCS AQ,2015,New Mexico State,0,2,2,0.0
vs. BCS non-AQ,2015,New Mexico State,3,7,10,0.3
vs. FBS Power 5,2015,New Mexico State,0,2,2,0.0
vs. FBS non-Power 5,2015,New Mexico State,3,7,10,0.3
in August/September,2015,New Mexico State,0,3,3,0.0
in October,2015,New Mexico State,1,4,5,0.2
in November,2015,New Mexico State,2,1,3,0.6666666666666666
in December/January,2015,New Mexico State,0,1,1,0.0
All Games,2016,New Mexico State,3,9,12,0.25
at Home,2016,New Mexico State,3,2,5,0.6
on Road/Neutral Site,2016,New Mexico State,0,7,7,0.0
vs. Conference,2016,New Mexico State,2,6,8,0.25
vs. Non-Conference,2016,New Mexico State,1,3,4,0.25
vs. Ranked (AP),2016,New Mexico State,0,0,0,
vs. Unranked (AP),2016,New Mexico State,3,9,12,0.25
vs. FBS (I-A),2016,New Mexico State,3,9,12,0.25
vs. FCS (I-AA),2016,New Mexico State,0,0,0,
vs. FBS Winning,2016,New Mexico State,1,6,7,0.14285714285714285
vs. FBS Non-Winning,2016,New Mexico State,2,3,5,0.4
vs. BCS AQ,2016,New Mexico State,0,2,2,0.0
vs. BCS non-AQ,2016,New Mexico State,3,7,10,0.3
vs. FBS Power 5,2016,New Mexico State,0,2,2,0.0
vs. FBS non-Power 5,2016,New Mexico State,3,7,10,0.3
in August/September,2016,New Mexico State,1,3,4,0.25
in October,2016,New Mexico State,1,3,4,0.25
in November,2016,New Mexico State,1,2,3,0.3333333333333333
in December/January,2016,New Mexico State,0,1,1,0.0
All Games,2017,New Mexico State,7,6,13,0.5384615384615384
at Home,2017,New Mexico State,3,2,5,0.6
on Road/Neutral Site,2017,New Mexico State,4,4,8,0.5
vs. Conference,2017,New Mexico State,4,4,8,0.5
vs. Non-Conference,2017,New Mexico State,3,2,5,0.6
vs. Ranked (AP),2017,New Mexico State,0,0,0,
vs. Unranked (AP),2017,New Mexico State,7,6,13,0.5384615384615384
vs. FBS (I-A),2017,New Mexico State,7,6,13,0.5384615384615384
vs. FCS (I-AA),2017,New Mexico State,0,0,0,
vs. FBS Winning,2017,New Mexico State,0,4,4,0.0
vs. FBS Non-Winning,2017,New Mexico State,7,2,9,0.7777777777777778
vs. BCS AQ,2017,New Mexico State,0,2,2,0.0
vs. BCS non-AQ,2017,New Mexico State,7,4,11,0.6363636363636364
vs. FBS Power 5,2017,New Mexico State,0,2,2,0.0
vs. FBS non-Power 5,2017,New Mexico State,7,4,11,0.6363636363636364
in August/September,2017,New Mexico State,2,3,5,0.4
in October,2017,New Mexico State,1,2,3,0.3333333333333333
in November,2017,New Mexico State,2,1,3,0.6666666666666666
in December/January,2017,New Mexico State,2,0,2,1.0
All Games,2018,New Mexico State,3,9,12,0.25
at Home,2018,New Mexico State,2,3,5,0.4
on Road/Neutral Site,2018,New Mexico State,1,6,7,0.14285714285714285
vs. Conference,2018,New Mexico State,1,2,3,0.3333333333333333
vs. Non-Conference,2018,New Mexico State,2,7,9,0.2222222222222222
vs. Ranked (AP),2018,New Mexico State,0,1,1,0.0
vs. Unranked (AP),2018,New Mexico State,3,8,11,0.2727272727272727
vs. FBS (I-A),2018,New Mexico State,2,9,11,0.18181818181818182
vs. FCS (I-AA),2018,New Mexico State,1,0,1,1.0
vs. FBS Winning,2018,New Mexico State,0,4,4,0.0
vs. FBS Non-Winning,2018,New Mexico State,2,5,7,0.2857142857142857
vs. BCS AQ,2018,New Mexico State,0,1,1,0.0
vs. BCS non-AQ,2018,New Mexico State,2,8,10,0.2
vs. FBS Power 5,2018,New Mexico State,0,1,1,0.0
vs. FBS non-Power 5,2018,New Mexico State,2,8,10,0.2
in August/September,2018,New Mexico State,1,4,5,0.2
in October,2018,New Mexico State,1,3,4,0.25
in November,2018,New Mexico State,1,2,3,0.3333333333333333
in December/January,2018,New Mexico State,0,0,0,
All Games,2019,New Mexico State,2,10,12,0.16666666666666666
at Home,2019,New Mexico State,2,3,5,0.4
on Road/Neutral Site,2019,New Mexico State,0,7,7,0.0
vs. Conference,2019,New Mexico State,0,2,2,0.0
vs. Non-Conference,2019,New Mexico State,2,8,10,0.2
vs. Ranked (AP),2019,New Mexico State,0,1,1,0.0
vs. Unranked (AP),2019,New Mexico State,2,9,11,0.18181818181818182
vs. FBS (I-A),2019,New Mexico State,1,10,11,0.09090909090909091
vs. FCS (I-AA),2019,New Mexico State,1,0,1,1.0
vs. FBS Winning,2019,New Mexico State,0,6,6,0.0
vs. FBS Non-Winning,2019,New Mexico State,1,4,5,0.2
vs. BCS AQ,2019,New Mexico State,0,3,3,0.0
vs. BCS non-AQ,2019,New Mexico State,1,7,8,0.125
vs. FBS Power 5,2019,New Mexico State,0,3,3,0.0
vs. FBS non-Power 5,2019,New Mexico State,1,7,8,0.125
in August/September,2019,New Mexico State,0,5,5,0.0
in October,2019,New Mexico State,0,3,3,0.0
in November,2019,New Mexico State,2,2,4,0.5
in December/January,2019,New Mexico State,0,0,0,
All Games,2020,New Mexico State,0,0,0,
at Home,2020,New Mexico State,0,0,0,
on Road/Neutral Site,2020,New Mexico State,0,0,0,
vs. Conference,2020,New Mexico State,0,0,0,
vs. Non-Conference,2020,New Mexico State,0,0,0,
vs. Ranked (AP),2020,New Mexico State,0,0,0,
vs. Unranked (AP),2020,New Mexico State,0,0,0,
vs. FBS (I-A),2020,New Mexico State,0,0,0,
vs. FCS (I-AA),2020,New Mexico State,0,0,0,
vs. FBS Winning,2020,New Mexico State,0,0,0,
vs. FBS Non-Winning,2020,New Mexico State,0,0,0,
vs. BCS AQ,2020,New Mexico State,0,0,0,
vs. BCS non-AQ,2020,New Mexico State,0,0,0,
vs. FBS Power 5,2020,New Mexico State,0,0,0,
vs. FBS non-Power 5,2020,New Mexico State,0,0,0,
in August/September,2020,New Mexico State,0,0,0,
in October,2020,New Mexico State,0,0,0,
in November,2020,New Mexico State,0,0,0,
in December/January,2020,New Mexico State,0,0,0,
All Games,2021,New Mexico State,2,10,12,0.16666666666666666
at Home,2021,New Mexico State,2,3,5,0.4
on Road/Neutral Site,2021,New Mexico State,0,7,7,0.0
vs. Conference,2021,New Mexico State,1,0,1,1.0
vs. Non-Conference,2021,New Mexico State,1,10,11,0.09090909090909091
vs. Ranked (AP),2021,New Mexico State,0,4,4,0.0
vs. Unranked (AP),2021,New Mexico State,2,6,8,0.25
vs. FBS (I-A),2021,New Mexico State,1,10,11,0.09090909090909091
vs. FCS (I-AA),2021,New Mexico State,1,0,1,1.0
vs. FBS Winning,2021,New Mexico State,0,6,6,0.0
vs. FBS Non-Winning,2021,New Mexico State,1,4,5,0.2
vs. BCS AQ,2021,New Mexico State,0,2,2,0.0
vs. BCS non-AQ,2021,New Mexico State,1,8,9,0.1111111111111111
vs. FBS Power 5,2021,New Mexico State,0,2,2,0.0
vs. FBS non-Power 5,2021,New Mexico State,1,8,9,0.1111111111111111
in August/September,2021,New Mexico State,1,4,5,0.2
in October,2021,New Mexico State,0,3,3,0.0
in November,2021,New Mexico State,1,3,4,0.25
in December/January,2021,New Mexico State,0,0,0,
All Games,2022,New Mexico State,7,6,13,0.5384615384615384
at Home,2022,New Mexico State,4,2,6,0.6666666666666666
on Road/Neutral Site,2022,New Mexico State,3,4,7,0.42857142857142855
vs. Conference,2022,New Mexico State,2,0,2,1.0
vs. Non-Conference,2022,New Mexico State,5,6,11,0.45454545454545453
vs. Ranked (AP),2022,New Mexico State,0,0,0,
vs. Unranked (AP),2022,New Mexico State,7,6,13,0.5384615384615384
vs. FBS (I-A),2022,New Mexico State,5,6,11,0.45454545454545453
vs. FCS (I-AA),2022,New Mexico State,2,0,2,1.0
vs. FBS Winning,2022,New Mexico State,1,2,3,0.3333333333333333
vs. FBS Non-Winning,2022,New Mexico State,4,4,8,0.5
vs. BCS AQ,2022,New Mexico State,0,3,3,0.0
vs. BCS non-AQ,2022,New Mexico State,5,3,8,0.625
vs. FBS Power 5,2022,New Mexico State,0,3,3,0.0
vs. FBS non-Power 5,2022,New Mexico State,5,3,8,0.625
in August/September,2022,New Mexico State,1,4,5,0.2
in October,2022,New Mexico State,2,1,3,0.6666666666666666
in November,2022,New Mexico State,2,1,3,0.6666666666666666
in December/January,2022,New Mexico State,2,0,2,1.0
All Games,2009,North Carolina,8,5,13,0.6153846153846154
at Home,2009,North Carolina,5,2,7,0.7142857142857143
on Road/Neutral Site,2009,North Carolina,3,3,6,0.5
vs. Conference,2009,North Carolina,4,4,8,0.5
vs. Non-Conference,2009,North Carolina,4,1,5,0.8
vs. Ranked (AP),2009,North Carolina,2,2,4,0.5
vs. Unranked (AP),2009,North Carolina,6,3,9,0.6666666666666666
vs. FBS (I-A),2009,North Carolina,6,5,11,0.5454545454545454
vs. FCS (I-AA),2009,North Carolina,2,0,2,1.0
vs. FBS Winning,2009,North Carolina,5,3,8,0.625
vs. FBS Non-Winning,2009,North Carolina,1,2,3,0.3333333333333333
vs. BCS AQ,2009,North Carolina,5,5,10,0.5
vs. BCS non-AQ,2009,North Carolina,1,0,1,1.0
vs. FBS Power 5,2009,North Carolina,4,4,8,0.5
vs. FBS non-Power 5,2009,North Carolina,2,1,3,0.6666666666666666
in August/September,2009,North Carolina,3,1,4,0.75
in October,2009,North Carolina,2,2,4,0.5
in November,2009,North Carolina,3,1,4,0.75
in December/January,2009,North Carolina,0,1,1,0.0
All Games,2010,North Carolina,8,5,13,0.6153846153846154
at Home,2010,North Carolina,3,3,6,0.5
on Road/Neutral Site,2010,North Carolina,5,2,7,0.7142857142857143
vs. Conference,2010,North Carolina,4,4,8,0.5
vs. Non-Conference,2010,North Carolina,4,1,5,0.8
vs. Ranked (AP),2010,North Carolina,1,3,4,0.25
vs. Unranked (AP),2010,North Carolina,7,2,9,0.7777777777777778
vs. FBS (I-A),2010,North Carolina,7,5,12,0.5833333333333334
vs. FCS (I-AA),2010,North Carolina,1,0,1,1.0
vs. FBS Winning,2010,North Carolina,1,4,5,0.2
vs. FBS Non-Winning,2010,North Carolina,6,1,7,0.8571428571428571
vs. BCS AQ,2010,North Carolina,6,5,11,0.5454545454545454
vs. BCS non-AQ,2010,North Carolina,1,0,1,1.0
vs. FBS Power 5,2010,North Carolina,5,5,10,0.5
vs. FBS non-Power 5,2010,North Carolina,2,0,2,1.0
in August/September,2010,North Carolina,1,2,3,0.3333333333333333
in October,2010,North Carolina,4,1,5,0.8
in November,2010,North Carolina,2,2,4,0.5
in December/January,2010,North Carolina,1,0,1,1.0
All Games,2011,North Carolina,7,6,13,0.5384615384615384
at Home,2011,North Carolina,6,1,7,0.8571428571428571
on Road/Neutral Site,2011,North Carolina,1,5,6,0.16666666666666666
vs. Conference,2011,North Carolina,3,5,8,0.375
vs. Non-Conference,2011,North Carolina,4,1,5,0.8
vs. Ranked (AP),2011,North Carolina,0,2,2,0.0
vs. Unranked (AP),2011,North Carolina,7,4,11,0.6363636363636364
vs. FBS (I-A),2011,North Carolina,6,6,12,0.5
vs. FCS (I-AA),2011,North Carolina,1,0,1,1.0
vs. FBS Winning,2011,North Carolina,3,5,8,0.375
vs. FBS Non-Winning,2011,North Carolina,3,1,4,0.75
vs. BCS AQ,2011,North Carolina,5,6,11,0.45454545454545453
vs. BCS non-AQ,2011,North Carolina,1,0,1,1.0
vs. FBS Power 5,2011,North Carolina,3,6,9,0.3333333333333333
vs. FBS non-Power 5,2011,North Carolina,3,0,3,1.0
in August/September,2011,North Carolina,3,1,4,0.75
in October,2011,North Carolina,3,2,5,0.6
in November,2011,North Carolina,1,2,3,0.3333333333333333
in December/January,2011,North Carolina,0,1,1,0.0
All Games,2012,North Carolina,8,4,12,0.6666666666666666
at Home,2012,North Carolina,6,1,7,0.8571428571428571
on Road/Neutral Site,2012,North Carolina,2,3,5,0.4
vs. Conference,2012,North Carolina,5,3,8,0.625
vs. Non-Conference,2012,North Carolina,3,1,4,0.75
vs. Ranked (AP),2012,North Carolina,0,1,1,0.0
vs. Unranked (AP),2012,North Carolina,8,3,11,0.7272727272727273
vs. FBS (I-A),2012,North Carolina,7,4,11,0.6363636363636364
vs. FCS (I-AA),2012,North Carolina,1,0,1,1.0
vs. FBS Winning,2012,North Carolina,4,1,5,0.8
vs. FBS Non-Winning,2012,North Carolina,3,3,6,0.5
vs. BCS AQ,2012,North Carolina,5,4,9,0.5555555555555556
vs. BCS non-AQ,2012,North Carolina,2,0,2,1.0
vs. FBS Power 5,2012,North Carolina,5,3,8,0.625
vs. FBS non-Power 5,2012,North Carolina,2,1,3,0.6666666666666666
in August/September,2012,North Carolina,3,2,5,0.6
in October,2012,North Carolina,3,1,4,0.75
in November,2012,North Carolina,2,1,3,0.6666666666666666
in December/January,2012,North Carolina,0,0,0,
All Games,2013,North Carolina,7,6,13,0.5384615384615384
at Home,2013,North Carolina,4,3,7,0.5714285714285714
on Road/Neutral Site,2013,North Carolina,3,3,6,0.5
vs. Conference,2013,North Carolina,4,4,8,0.5
vs. Non-Conference,2013,North Carolina,3,2,5,0.6
vs. Ranked (AP),2013,North Carolina,0,2,2,0.0
vs. Unranked (AP),2013,North Carolina,7,4,11,0.6363636363636364
vs. FBS (I-A),2013,North Carolina,6,6,12,0.5
vs. FCS (I-AA),2013,North Carolina,1,0,1,1.0
vs. FBS Winning,2013,North Carolina,4,6,10,0.4
vs. FBS Non-Winning,2013,North Carolina,2,0,2,1.0
vs. BCS AQ,2013,North Carolina,5,5,10,0.5
vs. BCS non-AQ,2013,North Carolina,1,1,2,0.5
vs. FBS Power 5,2013,North Carolina,4,5,9,0.4444444444444444
vs. FBS non-Power 5,2013,North Carolina,2,1,3,0.6666666666666666
in August/September,2013,North Carolina,1,3,4,0.25
in October,2013,North Carolina,1,2,3,0.3333333333333333
in November,2013,North Carolina,4,1,5,0.8
in December/January,2013,North Carolina,1,0,1,1.0
All Games,2014,North Carolina,6,7,13,0.46153846153846156
at Home,2014,North Carolina,4,2,6,0.6666666666666666
on Road/Neutral Site,2014,North Carolina,2,5,7,0.2857142857142857
vs. Conference,2014,North Carolina,4,4,8,0.5
vs. Non-Conference,2014,North Carolina,2,3,5,0.4
vs. Ranked (AP),2014,North Carolina,1,1,2,0.5
vs. Unranked (AP),2014,North Carolina,5,6,11,0.45454545454545453
vs. FBS (I-A),2014,North Carolina,5,7,12,0.4166666666666667
vs. FCS (I-AA),2014,North Carolina,1,0,1,1.0
vs. FBS Winning,2014,North Carolina,3,6,9,0.3333333333333333
vs. FBS Non-Winning,2014,North Carolina,2,1,3,0.6666666666666666
vs. BCS AQ,2014,North Carolina,4,7,11,0.36363636363636365
vs. BCS non-AQ,2014,North Carolina,1,0,1,1.0
vs. FBS Power 5,2014,North Carolina,4,5,9,0.4444444444444444
vs. FBS non-Power 5,2014,North Carolina,1,2,3,0.3333333333333333
in August/September,2014,North Carolina,2,2,4,0.5
in October,2014,North Carolina,2,2,4,0.5
in November,2014,North Carolina,2,2,4,0.5
in December/January,2014,North Carolina,0,1,1,0.0
All Games,2015,North Carolina,11,3,14,0.7857142857142857
at Home,2015,North Carolina,7,0,7,1.0
on Road/Neutral Site,2015,North Carolina,4,3,7,0.5714285714285714
vs. Conference,2015,North Carolina,8,1,9,0.8888888888888888
vs. Non-Conference,2015,North Carolina,3,2,5,0.6
vs. Ranked (AP),2015,North Carolina,0,2,2,0.0
vs. Unranked (AP),2015,North Carolina,11,1,12,0.9166666666666666
vs. FBS (I-A),2015,North Carolina,9,3,12,0.75
vs. FCS (I-AA),2015,North Carolina,2,0,2,1.0
vs. FBS Winning,2015,North Carolina,5,2,7,0.7142857142857143
vs. FBS Non-Winning,2015,North Carolina,4,1,5,0.8
vs. BCS AQ,2015,North Carolina,9,3,12,0.75
vs. BCS non-AQ,2015,North Carolina,0,0,0,
vs. FBS Power 5,2015,North Carolina,9,3,12,0.75
vs. FBS non-Power 5,2015,North Carolina,0,0,0,
in August/September,2015,North Carolina,3,1,4,0.75
in October,2015,North Carolina,4,0,4,1.0
in November,2015,North Carolina,4,0,4,1.0
in December/January,2015,North Carolina,0,2,2,0.0
All Games,2016,North Carolina,8,5,13,0.6153846153846154
at Home,2016,North Carolina,4,2,6,0.6666666666666666
on Road/Neutral Site,2016,North Carolina,4,3,7,0.5714285714285714
vs. Conference,2016,North Carolina,5,3,8,0.625
vs. Non-Conference,2016,North Carolina,3,2,5,0.6
vs. Ranked (AP),2016,North Carolina,2,2,4,0.5
vs. Unranked (AP),2016,North Carolina,6,3,9,0.6666666666666666
vs. FBS (I-A),2016,North Carolina,6,5,11,0.5454545454545454
vs. FCS (I-AA),2016,North Carolina,2,0,2,1.0
vs. FBS Winning,2016,North Carolina,4,4,8,0.5
vs. FBS Non-Winning,2016,North Carolina,2,1,3,0.6666666666666666
vs. BCS AQ,2016,North Carolina,6,5,11,0.5454545454545454
vs. BCS non-AQ,2016,North Carolina,0,0,0,
vs. FBS Power 5,2016,North Carolina,6,5,11,0.5454545454545454
vs. FBS non-Power 5,2016,North Carolina,0,0,0,
in August/September,2016,North Carolina,3,1,4,0.75
in October,2016,North Carolina,3,1,4,0.75
in November,2016,North Carolina,2,2,4,0.5
in December/January,2016,North Carolina,0,1,1,0.0
All Games,2017,North Carolina,3,9,12,0.25
at Home,2017,North Carolina,1,6,7,0.14285714285714285
on Road/Neutral Site,2017,North Carolina,2,3,5,0.4
vs. Conference,2017,North Carolina,1,7,8,0.125
vs. Non-Conference,2017,North Carolina,2,2,4,0.5
vs. Ranked (AP),2017,North Carolina,0,4,4,0.0
vs. Unranked (AP),2017,North Carolina,3,5,8,0.375
vs. FBS (I-A),2017,North Carolina,2,9,11,0.18181818181818182
vs. FCS (I-AA),2017,North Carolina,1,0,1,1.0
vs. FBS Winning,2017,North Carolina,0,6,6,0.0
vs. FBS Non-Winning,2017,North Carolina,2,3,5,0.4
vs. BCS AQ,2017,North Carolina,1,9,10,0.1
vs. BCS non-AQ,2017,North Carolina,1,0,1,1.0
vs. FBS Power 5,2017,North Carolina,1,8,9,0.1111111111111111
vs. FBS non-Power 5,2017,North Carolina,1,1,2,0.5
in August/September,2017,North Carolina,1,4,5,0.2
in October,2017,North Carolina,0,4,4,0.0
in November,2017,North Carolina,2,1,3,0.6666666666666666
in December/January,2017,North Carolina,0,0,0,
All Games,2018,North Carolina,2,9,11,0.18181818181818182
at Home,2018,North Carolina,2,3,5,0.4
on Road/Neutral Site,2018,North Carolina,0,6,6,0.0
vs. Conference,2018,North Carolina,1,7,8,0.125
vs. Non-Conference,2018,North Carolina,1,2,3,0.3333333333333333
vs. Ranked (AP),2018,North Carolina,0,1,1,0.0
vs. Unranked (AP),2018,North Carolina,2,8,10,0.2
vs. FBS (I-A),2018,North Carolina,1,9,10,0.1
vs. FCS (I-AA),2018,North Carolina,1,0,1,1.0
vs. FBS Winning,2018,North Carolina,0,7,7,0.0
vs. FBS Non-Winning,2018,North Carolina,1,2,3,0.3333333333333333
vs. BCS AQ,2018,North Carolina,1,9,10,0.1
vs. BCS non-AQ,2018,North Carolina,0,0,0,
vs. FBS Power 5,2018,North Carolina,1,8,9,0.1111111111111111
vs. FBS non-Power 5,2018,North Carolina,0,1,1,0.0
in August/September,2018,North Carolina,1,3,4,0.25
in October,2018,North Carolina,0,3,3,0.0
in November,2018,North Carolina,1,3,4,0.25
in December/January,2018,North Carolina,0,0,0,
All Games,2019,North Carolina,7,6,13,0.5384615384615384
at Home,2019,North Carolina,3,3,6,0.5
on Road/Neutral Site,2019,North Carolina,4,3,7,0.5714285714285714
vs. Conference,2019,North Carolina,4,5,9,0.4444444444444444
vs. Non-Conference,2019,North Carolina,3,1,4,0.75
vs. Ranked (AP),2019,North Carolina,0,2,2,0.0
vs. Unranked (AP),2019,North Carolina,7,4,11,0.6363636363636364
vs. FBS (I-A),2019,North Carolina,6,6,12,0.5
vs. FCS (I-AA),2019,North Carolina,1,0,1,1.0
vs. FBS Winning,2019,North Carolina,1,6,7,0.14285714285714285
vs. FBS Non-Winning,2019,North Carolina,5,0,5,1.0
vs. BCS AQ,2019,North Carolina,6,5,11,0.5454545454545454
vs. BCS non-AQ,2019,North Carolina,0,1,1,0.0
vs. FBS Power 5,2019,North Carolina,5,5,10,0.5
vs. FBS non-Power 5,2019,North Carolina,1,1,2,0.5
in August/September,2019,North Carolina,2,3,5,0.4
in October,2019,North Carolina,2,1,3,0.6666666666666666
in November,2019,North Carolina,2,2,4,0.5
in December/January,2019,North Carolina,1,0,1,1.0
All Games,2020,North Carolina,8,4,12,0.6666666666666666
at Home,2020,North Carolina,5,1,6,0.8333333333333334
on Road/Neutral Site,2020,North Carolina,3,3,6,0.5
vs. Conference,2020,North Carolina,7,3,10,0.7
vs. Non-Conference,2020,North Carolina,1,1,2,0.5
vs. Ranked (AP),2020,North Carolina,2,2,4,0.5
vs. Unranked (AP),2020,North Carolina,6,2,8,0.75
vs. FBS (I-A),2020,North Carolina,7,4,11,0.6363636363636364
vs. FCS (I-AA),2020,North Carolina,1,0,1,1.0
vs. FBS Winning,2020,North Carolina,3,2,5,0.6
vs. FBS Non-Winning,2020,North Carolina,4,2,6,0.6666666666666666
vs. BCS AQ,2020,North Carolina,7,4,11,0.6363636363636364
vs. BCS non-AQ,2020,North Carolina,0,0,0,
vs. FBS Power 5,2020,North Carolina,7,4,11,0.6363636363636364
vs. FBS non-Power 5,2020,North Carolina,0,0,0,
in August/September,2020,North Carolina,1,0,1,1.0
in October,2020,North Carolina,3,2,5,0.6
in November,2020,North Carolina,2,1,3,0.6666666666666666
in December/January,2020,North Carolina,2,1,3,0.6666666666666666
All Games,2021,North Carolina,6,7,13,0.46153846153846156
at Home,2021,North Carolina,6,1,7,0.8571428571428571
on Road/Neutral Site,2021,North Carolina,0,6,6,0.0
vs. Conference,2021,North Carolina,4,5,9,0.4444444444444444
vs. Non-Conference,2021,North Carolina,2,2,4,0.5
vs. Ranked (AP),2021,North Carolina,1,3,4,0.25
vs. Unranked (AP),2021,North Carolina,5,4,9,0.5555555555555556
vs. FBS (I-A),2021,North Carolina,5,7,12,0.4166666666666667
vs. FCS (I-AA),2021,North Carolina,1,0,1,1.0
vs. FBS Winning,2021,North Carolina,3,4,7,0.42857142857142855
vs. FBS Non-Winning,2021,North Carolina,2,3,5,0.4
vs. BCS AQ,2021,North Carolina,4,7,11,0.36363636363636365
vs. BCS non-AQ,2021,North Carolina,1,0,1,1.0
vs. FBS Power 5,2021,North Carolina,4,6,10,0.4
vs. FBS non-Power 5,2021,North Carolina,1,1,2,0.5
in August/September,2021,North Carolina,2,2,4,0.5
in October,2021,North Carolina,2,2,4,0.5
in November,2021,North Carolina,2,2,4,0.5
in December/January,2021,North Carolina,0,1,1,0.0
All Games,2022,North Carolina,9,5,14,0.6428571428571429
at Home,2022,North Carolina,3,3,6,0.5
on Road/Neutral Site,2022,North Carolina,6,2,8,0.75
vs. Conference,2022,North Carolina,6,3,9,0.6666666666666666
vs. Non-Conference,2022,North Carolina,3,2,5,0.6
vs. Ranked (AP),2022,North Carolina,1,3,4,0.25
vs. Unranked (AP),2022,North Carolina,8,2,10,0.8
vs. FBS (I-A),2022,North Carolina,8,5,13,0.6153846153846154
vs. FCS (I-AA),2022,North Carolina,1,0,1,1.0
vs. FBS Winning,2022,North Carolina,3,4,7,0.42857142857142855
vs. FBS Non-Winning,2022,North Carolina,5,1,6,0.8333333333333334
vs. BCS AQ,2022,North Carolina,6,5,11,0.5454545454545454
vs. BCS non-AQ,2022,North Carolina,2,0,2,1.0
vs. FBS Power 5,2022,North Carolina,6,4,10,0.6
vs. FBS non-Power 5,2022,North Carolina,2,1,3,0.6666666666666666
in August/September,2022,North Carolina,3,1,4,0.75
in October,2022,North Carolina,4,0,4,1.0
in November,2022,North Carolina,2,2,4,0.5
in December/January,2022,North Carolina,0,2,2,0.0
All Games,2009,North Carolina State,5,7,12,0.4166666666666667
at Home,2009,North Carolina State,5,3,8,0.625
on Road/Neutral Site,2009,North Carolina State,0,4,4,0.0
vs. Conference,2009,North Carolina State,2,6,8,0.25
vs. Non-Conference,2009,North Carolina State,3,1,4,0.75
vs. Ranked (AP),2009,North Carolina State,1,2,3,0.3333333333333333
vs. Unranked (AP),2009,North Carolina State,4,5,9,0.4444444444444444
vs. FBS (I-A),2009,North Carolina State,3,7,10,0.3
vs. FCS (I-AA),2009,North Carolina State,2,0,2,1.0
vs. FBS Winning,2009,North Carolina State,2,5,7,0.2857142857142857
vs. FBS Non-Winning,2009,North Carolina State,1,2,3,0.3333333333333333
vs. BCS AQ,2009,North Carolina State,3,7,10,0.3
vs. BCS non-AQ,2009,North Carolina State,0,0,0,
vs. FBS Power 5,2009,North Carolina State,2,7,9,0.2222222222222222
vs. FBS non-Power 5,2009,North Carolina State,1,0,1,1.0
in August/September,2009,North Carolina State,3,1,4,0.75
in October,2009,North Carolina State,0,4,4,0.0
in November,2009,North Carolina State,2,2,4,0.5
in December/January,2009,North Carolina State,0,0,0,
All Games,2010,North Carolina State,9,4,13,0.6923076923076923
at Home,2010,North Carolina State,5,1,6,0.8333333333333334
on Road/Neutral Site,2010,North Carolina State,4,3,7,0.5714285714285714
vs. Conference,2010,North Carolina State,5,3,8,0.625
vs. Non-Conference,2010,North Carolina State,4,1,5,0.8
vs. Ranked (AP),2010,North Carolina State,2,2,4,0.5
vs. Unranked (AP),2010,North Carolina State,7,2,9,0.7777777777777778
vs. FBS (I-A),2010,North Carolina State,8,4,12,0.6666666666666666
vs. FCS (I-AA),2010,North Carolina State,1,0,1,1.0
vs. FBS Winning,2010,North Carolina State,5,2,7,0.7142857142857143
vs. FBS Non-Winning,2010,North Carolina State,3,2,5,0.6
vs. BCS AQ,2010,North Carolina State,7,3,10,0.7
vs. BCS non-AQ,2010,North Carolina State,1,1,2,0.5
vs. FBS Power 5,2010,North Carolina State,5,3,8,0.625
vs. FBS non-Power 5,2010,North Carolina State,3,1,4,0.75
in August/September,2010,North Carolina State,4,0,4,1.0
in October,2010,North Carolina State,2,2,4,0.5
in November,2010,North Carolina State,2,2,4,0.5
in December/January,2010,North Carolina State,1,0,1,1.0
All Games,2011,North Carolina State,8,5,13,0.6153846153846154
at Home,2011,North Carolina State,6,1,7,0.8571428571428571
on Road/Neutral Site,2011,North Carolina State,2,4,6,0.3333333333333333
vs. Conference,2011,North Carolina State,4,4,8,0.5
vs. Non-Conference,2011,North Carolina State,4,1,5,0.8
vs. Ranked (AP),2011,North Carolina State,1,2,3,0.3333333333333333
vs. Unranked (AP),2011,North Carolina State,7,3,10,0.7
vs. FBS (I-A),2011,North Carolina State,6,5,11,0.5454545454545454
vs. FCS (I-AA),2011,North Carolina State,2,0,2,1.0
vs. FBS Winning,2011,North Carolina State,4,3,7,0.5714285714285714
vs. FBS Non-Winning,2011,North Carolina State,2,2,4,0.5
vs. BCS AQ,2011,North Carolina State,5,5,10,0.5
vs. BCS non-AQ,2011,North Carolina State,1,0,1,1.0
vs. FBS Power 5,2011,North Carolina State,4,4,8,0.5
vs. FBS non-Power 5,2011,North Carolina State,2,1,3,0.6666666666666666
in August/September,2011,North Carolina State,2,2,4,0.5
in October,2011,North Carolina State,2,2,4,0.5
in November,2011,North Carolina State,3,1,4,0.75
in December/January,2011,North Carolina State,1,0,1,1.0
All Games,2012,North Carolina State,7,6,13,0.5384615384615384
at Home,2012,North Carolina State,5,1,6,0.8333333333333334
on Road/Neutral Site,2012,North Carolina State,2,5,7,0.2857142857142857
vs. Conference,2012,North Carolina State,4,4,8,0.5
vs. Non-Conference,2012,North Carolina State,3,2,5,0.6
vs. Ranked (AP),2012,North Carolina State,1,2,3,0.3333333333333333
vs. Unranked (AP),2012,North Carolina State,6,4,10,0.6
vs. FBS (I-A),2012,North Carolina State,6,6,12,0.5
vs. FCS (I-AA),2012,North Carolina State,1,0,1,1.0
vs. FBS Winning,2012,North Carolina State,1,4,5,0.2
vs. FBS Non-Winning,2012,North Carolina State,5,2,7,0.7142857142857143
vs. BCS AQ,2012,North Carolina State,5,6,11,0.45454545454545453
vs. BCS non-AQ,2012,North Carolina State,1,0,1,1.0
vs. FBS Power 5,2012,North Carolina State,4,6,10,0.4
vs. FBS non-Power 5,2012,North Carolina State,2,0,2,1.0
in August/September,2012,North Carolina State,3,2,5,0.6
in October,2012,North Carolina State,2,1,3,0.6666666666666666
in November,2012,North Carolina State,2,2,4,0.5
in December/January,2012,North Carolina State,0,1,1,0.0
All Games,2013,North Carolina State,3,9,12,0.25
at Home,2013,North Carolina State,3,5,8,0.375
on Road/Neutral Site,2013,North Carolina State,0,4,4,0.0
vs. Conference,2013,North Carolina State,0,8,8,0.0
vs. Non-Conference,2013,North Carolina State,3,1,4,0.75
vs. Ranked (AP),2013,North Carolina State,0,3,3,0.0
vs. Unranked (AP),2013,North Carolina State,3,6,9,0.3333333333333333
vs. FBS (I-A),2013,North Carolina State,2,9,11,0.18181818181818182
vs. FCS (I-AA),2013,North Carolina State,1,0,1,1.0
vs. FBS Winning,2013,North Carolina State,0,8,8,0.0
vs. FBS Non-Winning,2013,North Carolina State,2,1,3,0.6666666666666666
vs. BCS AQ,2013,North Carolina State,0,8,8,0.0
vs. BCS non-AQ,2013,North Carolina State,2,1,3,0.6666666666666666
vs. FBS Power 5,2013,North Carolina State,0,8,8,0.0
vs. FBS non-Power 5,2013,North Carolina State,2,1,3,0.6666666666666666
in August/September,2013,North Carolina State,3,1,4,0.75
in October,2013,North Carolina State,0,3,3,0.0
in November,2013,North Carolina State,0,5,5,0.0
in December/January,2013,North Carolina State,0,0,0,
All Games,2014,North Carolina State,8,5,13,0.6153846153846154
at Home,2014,North Carolina State,4,3,7,0.5714285714285714
on Road/Neutral Site,2014,North Carolina State,4,2,6,0.6666666666666666
vs. Conference,2014,North Carolina State,3,5,8,0.375
vs. Non-Conference,2014,North Carolina State,5,0,5,1.0
vs. Ranked (AP),2014,North Carolina State,0,4,4,0.0
vs. Unranked (AP),2014,North Carolina State,8,1,9,0.8888888888888888
vs. FBS (I-A),2014,North Carolina State,7,5,12,0.5833333333333334
vs. FCS (I-AA),2014,North Carolina State,1,0,1,1.0
vs. FBS Winning,2014,North Carolina State,2,5,7,0.2857142857142857
vs. FBS Non-Winning,2014,North Carolina State,5,0,5,1.0
vs. BCS AQ,2014,North Carolina State,5,5,10,0.5
vs. BCS non-AQ,2014,North Carolina State,2,0,2,1.0
vs. FBS Power 5,2014,North Carolina State,3,5,8,0.375
vs. FBS non-Power 5,2014,North Carolina State,4,0,4,1.0
in August/September,2014,North Carolina State,4,1,5,0.8
in October,2014,North Carolina State,0,3,3,0.0
in November,2014,North Carolina State,3,1,4,0.75
in December/January,2014,North Carolina State,1,0,1,1.0
All Games,2015,North Carolina State,7,6,13,0.5384615384615384
at Home,2015,North Carolina State,3,3,6,0.5
on Road/Neutral Site,2015,North Carolina State,4,3,7,0.5714285714285714
vs. Conference,2015,North Carolina State,3,5,8,0.375
vs. Non-Conference,2015,North Carolina State,4,1,5,0.8
vs. Ranked (AP),2015,North Carolina State,0,3,3,0.0
vs. Unranked (AP),2015,North Carolina State,7,3,10,0.7
vs. FBS (I-A),2015,North Carolina State,6,6,12,0.5
vs. FCS (I-AA),2015,North Carolina State,1,0,1,1.0
vs. FBS Winning,2015,North Carolina State,0,6,6,0.0
vs. FBS Non-Winning,2015,North Carolina State,6,0,6,1.0
vs. BCS AQ,2015,North Carolina State,3,6,9,0.3333333333333333
vs. BCS non-AQ,2015,North Carolina State,3,0,3,1.0
vs. FBS Power 5,2015,North Carolina State,3,6,9,0.3333333333333333
vs. FBS non-Power 5,2015,North Carolina State,3,0,3,1.0
in August/September,2015,North Carolina State,4,0,4,1.0
in October,2015,North Carolina State,1,3,4,0.25
in November,2015,North Carolina State,2,2,4,0.5
in December/January,2015,North Carolina State,0,1,1,0.0
All Games,2016,North Carolina State,7,6,13,0.5384615384615384
at Home,2016,North Carolina State,4,3,7,0.5714285714285714
on Road/Neutral Site,2016,North Carolina State,3,3,6,0.5
vs. Conference,2016,North Carolina State,3,5,8,0.375
vs. Non-Conference,2016,North Carolina State,4,1,5,0.8
vs. Ranked (AP),2016,North Carolina State,0,3,3,0.0
vs. Unranked (AP),2016,North Carolina State,7,3,10,0.7
vs. FBS (I-A),2016,North Carolina State,6,6,12,0.5
vs. FCS (I-AA),2016,North Carolina State,1,0,1,1.0
vs. FBS Winning,2016,North Carolina State,3,5,8,0.375
vs. FBS Non-Winning,2016,North Carolina State,3,1,4,0.75
vs. BCS AQ,2016,North Carolina State,5,6,11,0.45454545454545453
vs. BCS non-AQ,2016,North Carolina State,1,0,1,1.0
vs. FBS Power 5,2016,North Carolina State,4,5,9,0.4444444444444444
vs. FBS non-Power 5,2016,North Carolina State,2,1,3,0.6666666666666666
in August/September,2016,North Carolina State,2,1,3,0.6666666666666666
in October,2016,North Carolina State,2,3,5,0.4
in November,2016,North Carolina State,2,2,4,0.5
in December/January,2016,North Carolina State,1,0,1,1.0
All Games,2017,North Carolina State,9,4,13,0.6923076923076923
at Home,2017,North Carolina State,5,1,6,0.8333333333333334
on Road/Neutral Site,2017,North Carolina State,4,3,7,0.5714285714285714
vs. Conference,2017,North Carolina State,6,2,8,0.75
vs. Non-Conference,2017,North Carolina State,3,2,5,0.6
vs. Ranked (AP),2017,North Carolina State,0,2,2,0.0
vs. Unranked (AP),2017,North Carolina State,9,2,11,0.8181818181818182
vs. FBS (I-A),2017,North Carolina State,8,4,12,0.6666666666666666
vs. FCS (I-AA),2017,North Carolina State,1,0,1,1.0
vs. FBS Winning,2017,North Carolina State,5,4,9,0.5555555555555556
vs. FBS Non-Winning,2017,North Carolina State,3,0,3,1.0
vs. BCS AQ,2017,North Carolina State,7,4,11,0.6363636363636364
vs. BCS non-AQ,2017,North Carolina State,1,0,1,1.0
vs. FBS Power 5,2017,North Carolina State,7,3,10,0.7
vs. FBS non-Power 5,2017,North Carolina State,1,1,2,0.5
in August/September,2017,North Carolina State,4,1,5,0.8
in October,2017,North Carolina State,2,1,3,0.6666666666666666
in November,2017,North Carolina State,2,2,4,0.5
in December/January,2017,North Carolina State,1,0,1,1.0
All Games,2018,North Carolina State,9,4,13,0.6923076923076923
at Home,2018,North Carolina State,6,1,7,0.8571428571428571
on Road/Neutral Site,2018,North Carolina State,3,3,6,0.5
vs. Conference,2018,North Carolina State,5,3,8,0.625
vs. Non-Conference,2018,North Carolina State,4,1,5,0.8
vs. Ranked (AP),2018,North Carolina State,0,3,3,0.0
vs. Unranked (AP),2018,North Carolina State,9,1,10,0.9
vs. FBS (I-A),2018,North Carolina State,8,4,12,0.6666666666666666
vs. FCS (I-AA),2018,North Carolina State,1,0,1,1.0
vs. FBS Winning,2018,North Carolina State,3,4,7,0.42857142857142855
vs. FBS Non-Winning,2018,North Carolina State,5,0,5,1.0
vs. BCS AQ,2018,North Carolina State,6,4,10,0.6
vs. BCS non-AQ,2018,North Carolina State,2,0,2,1.0
vs. FBS Power 5,2018,North Carolina State,5,4,9,0.5555555555555556
vs. FBS non-Power 5,2018,North Carolina State,3,0,3,1.0
in August/September,2018,North Carolina State,4,0,4,1.0
in October,2018,North Carolina State,1,2,3,0.3333333333333333
in November,2018,North Carolina State,3,1,4,0.75
in December/January,2018,North Carolina State,1,1,2,0.5
All Games,2019,North Carolina State,4,8,12,0.3333333333333333
at Home,2019,North Carolina State,4,3,7,0.5714285714285714
on Road/Neutral Site,2019,North Carolina State,0,5,5,0.0
vs. Conference,2019,North Carolina State,1,7,8,0.125
vs. Non-Conference,2019,North Carolina State,3,1,4,0.75
vs. Ranked (AP),2019,North Carolina State,0,1,1,0.0
vs. Unranked (AP),2019,North Carolina State,4,7,11,0.36363636363636365
vs. FBS (I-A),2019,North Carolina State,3,8,11,0.2727272727272727
vs. FCS (I-AA),2019,North Carolina State,1,0,1,1.0
vs. FBS Winning,2019,North Carolina State,0,4,4,0.0
vs. FBS Non-Winning,2019,North Carolina State,3,4,7,0.42857142857142855
vs. BCS AQ,2019,North Carolina State,2,8,10,0.2
vs. BCS non-AQ,2019,North Carolina State,1,0,1,1.0
vs. FBS Power 5,2019,North Carolina State,1,8,9,0.1111111111111111
vs. FBS non-Power 5,2019,North Carolina State,2,0,2,1.0
in August/September,2019,North Carolina State,3,2,5,0.6
in October,2019,North Carolina State,1,1,2,0.5
in November,2019,North Carolina State,0,5,5,0.0
in December/January,2019,North Carolina State,0,0,0,
All Games,2020,North Carolina State,8,4,12,0.6666666666666666
at Home,2020,North Carolina State,5,1,6,0.8333333333333334
on Road/Neutral Site,2020,North Carolina State,3,3,6,0.5
vs. Conference,2020,North Carolina State,7,3,10,0.7
vs. Non-Conference,2020,North Carolina State,1,1,2,0.5
vs. Ranked (AP),2020,North Carolina State,1,2,3,0.3333333333333333
vs. Unranked (AP),2020,North Carolina State,7,2,9,0.7777777777777778
vs. FBS (I-A),2020,North Carolina State,8,4,12,0.6666666666666666
vs. FCS (I-AA),2020,North Carolina State,0,0,0,
vs. FBS Winning,2020,North Carolina State,2,2,4,0.5
vs. FBS Non-Winning,2020,North Carolina State,6,2,8,0.75
vs. BCS AQ,2020,North Carolina State,7,4,11,0.6363636363636364
vs. BCS non-AQ,2020,North Carolina State,1,0,1,1.0
vs. FBS Power 5,2020,North Carolina State,7,4,11,0.6363636363636364
vs. FBS non-Power 5,2020,North Carolina State,1,0,1,1.0
in August/September,2020,North Carolina State,1,1,2,0.5
in October,2020,North Carolina State,3,1,4,0.75
in November,2020,North Carolina State,3,1,4,0.75
in December/January,2020,North Carolina State,1,1,2,0.5
All Games,2021,North Carolina State,9,3,12,0.75
at Home,2021,North Carolina State,7,0,7,1.0
on Road/Neutral Site,2021,North Carolina State,2,3,5,0.4
vs. Conference,2021,North Carolina State,6,2,8,0.75
vs. Non-Conference,2021,North Carolina State,3,1,4,0.75
vs. Ranked (AP),2021,North Carolina State,1,1,2,0.5
vs. Unranked (AP),2021,North Carolina State,8,2,10,0.8
vs. FBS (I-A),2021,North Carolina State,8,3,11,0.7272727272727273
vs. FCS (I-AA),2021,North Carolina State,1,0,1,1.0
vs. FBS Winning,2021,North Carolina State,1,3,4,0.25
vs. FBS Non-Winning,2021,North Carolina State,7,0,7,1.0
vs. BCS AQ,2021,North Carolina State,7,3,10,0.7
vs. BCS non-AQ,2021,North Carolina State,1,0,1,1.0
vs. FBS Power 5,2021,North Carolina State,6,3,9,0.6666666666666666
vs. FBS non-Power 5,2021,North Carolina State,2,0,2,1.0
in August/September,2021,North Carolina State,3,1,4,0.75
in October,2021,North Carolina State,3,1,4,0.75
in November,2021,North Carolina State,3,1,4,0.75
in December/January,2021,North Carolina State,0,0,0,
All Games,2022,North Carolina State,8,5,13,0.6153846153846154
at Home,2022,North Carolina State,6,1,7,0.8571428571428571
on Road/Neutral Site,2022,North Carolina State,2,4,6,0.3333333333333333
vs. Conference,2022,North Carolina State,4,4,8,0.5
vs. Non-Conference,2022,North Carolina State,4,1,5,0.8
vs. Ranked (AP),2022,North Carolina State,1,1,2,0.5
vs. Unranked (AP),2022,North Carolina State,7,4,11,0.6363636363636364
vs. FBS (I-A),2022,North Carolina State,7,5,12,0.5833333333333334
vs. FCS (I-AA),2022,North Carolina State,1,0,1,1.0
vs. FBS Winning,2022,North Carolina State,5,4,9,0.5555555555555556
vs. FBS Non-Winning,2022,North Carolina State,2,1,3,0.6666666666666666
vs. BCS AQ,2022,North Carolina State,6,5,11,0.5454545454545454
vs. BCS non-AQ,2022,North Carolina State,1,0,1,1.0
vs. FBS Power 5,2022,North Carolina State,5,5,10,0.5
vs. FBS non-Power 5,2022,North Carolina State,2,0,2,1.0
in August/September,2022,North Carolina State,4,0,4,1.0
in October,2022,North Carolina State,2,2,4,0.5
in November,2022,North Carolina State,2,2,4,0.5
in December/January,2022,North Carolina State,0,1,1,0.0
All Games,2009,North Texas,2,10,12,0.16666666666666666
at Home,2009,North Texas,1,5,6,0.16666666666666666
on Road/Neutral Site,2009,North Texas,1,5,6,0.16666666666666666
vs. Conference,2009,North Texas,1,7,8,0.125
vs. Non-Conference,2009,North Texas,1,3,4,0.25
vs. Ranked (AP),2009,North Texas,0,1,1,0.0
vs. Unranked (AP),2009,North Texas,2,9,11,0.18181818181818182
vs. FBS (I-A),2009,North Texas,2,10,12,0.16666666666666666
vs. FCS (I-AA),2009,North Texas,0,0,0,
vs. FBS Winning,2009,North Texas,0,4,4,0.0
vs. FBS Non-Winning,2009,North Texas,2,6,8,0.25
vs. BCS AQ,2009,North Texas,0,1,1,0.0
vs. BCS non-AQ,2009,North Texas,2,9,11,0.18181818181818182
vs. FBS Power 5,2009,North Texas,0,1,1,0.0
vs. FBS non-Power 5,2009,North Texas,2,9,11,0.18181818181818182
in August/September,2009,North Texas,1,3,4,0.25
in October,2009,North Texas,1,3,4,0.25
in November,2009,North Texas,0,4,4,0.0
in December/January,2009,North Texas,0,0,0,
All Games,2010,North Texas,3,9,12,0.25
at Home,2010,North Texas,0,6,6,0.0
on Road/Neutral Site,2010,North Texas,3,3,6,0.5
vs. Conference,2010,North Texas,3,5,8,0.375
vs. Non-Conference,2010,North Texas,0,4,4,0.0
vs. Ranked (AP),2010,North Texas,0,0,0,
vs. Unranked (AP),2010,North Texas,3,9,12,0.25
vs. FBS (I-A),2010,North Texas,3,9,12,0.25
vs. FCS (I-AA),2010,North Texas,0,0,0,
vs. FBS Winning,2010,North Texas,0,4,4,0.0
vs. FBS Non-Winning,2010,North Texas,3,5,8,0.375
vs. BCS AQ,2010,North Texas,0,2,2,0.0
vs. BCS non-AQ,2010,North Texas,3,7,10,0.3
vs. FBS Power 5,2010,North Texas,0,2,2,0.0
vs. FBS non-Power 5,2010,North Texas,3,7,10,0.3
in August/September,2010,North Texas,1,3,4,0.25
in October,2010,North Texas,1,3,4,0.25
in November,2010,North Texas,1,3,4,0.25
in December/January,2010,North Texas,0,0,0,
All Games,2011,North Texas,5,7,12,0.4166666666666667
at Home,2011,North Texas,4,2,6,0.6666666666666666
on Road/Neutral Site,2011,North Texas,1,5,6,0.16666666666666666
vs. Conference,2011,North Texas,4,4,8,0.5
vs. Non-Conference,2011,North Texas,1,3,4,0.25
vs. Ranked (AP),2011,North Texas,0,2,2,0.0
vs. Unranked (AP),2011,North Texas,5,5,10,0.5
vs. FBS (I-A),2011,North Texas,5,7,12,0.4166666666666667
vs. FCS (I-AA),2011,North Texas,0,0,0,
vs. FBS Winning,2011,North Texas,0,7,7,0.0
vs. FBS Non-Winning,2011,North Texas,5,0,5,1.0
vs. BCS AQ,2011,North Texas,1,1,2,0.5
vs. BCS non-AQ,2011,North Texas,4,6,10,0.4
vs. FBS Power 5,2011,North Texas,1,1,2,0.5
vs. FBS non-Power 5,2011,North Texas,4,6,10,0.4
in August/September,2011,North Texas,1,3,4,0.25
in October,2011,North Texas,2,3,5,0.4
in November,2011,North Texas,1,1,2,0.5
in December/January,2011,North Texas,1,0,1,1.0
All Games,2012,North Texas,4,8,12,0.3333333333333333
at Home,2012,North Texas,3,2,5,0.6
on Road/Neutral Site,2012,North Texas,1,6,7,0.14285714285714285
vs. Conference,2012,North Texas,3,5,8,0.375
vs. Non-Conference,2012,North Texas,1,3,4,0.25
vs. Ranked (AP),2012,North Texas,0,2,2,0.0
vs. Unranked (AP),2012,North Texas,4,6,10,0.4
vs. FBS (I-A),2012,North Texas,3,8,11,0.2727272727272727
vs. FCS (I-AA),2012,North Texas,1,0,1,1.0
vs. FBS Winning,2012,North Texas,1,6,7,0.14285714285714285
vs. FBS Non-Winning,2012,North Texas,2,2,4,0.5
vs. BCS AQ,2012,North Texas,0,2,2,0.0
vs. BCS non-AQ,2012,North Texas,3,6,9,0.3333333333333333
vs. FBS Power 5,2012,North Texas,0,2,2,0.0
vs. FBS non-Power 5,2012,North Texas,3,6,9,0.3333333333333333
in August/September,2012,North Texas,2,3,5,0.4
in October,2012,North Texas,1,2,3,0.3333333333333333
in November,2012,North Texas,1,3,4,0.25
in December/January,2012,North Texas,0,0,0,
All Games,2013,North Texas,9,4,13,0.6923076923076923
at Home,2013,North Texas,5,1,6,0.8333333333333334
on Road/Neutral Site,2013,North Texas,4,3,7,0.5714285714285714
vs. Conference,2013,North Texas,6,2,8,0.75
vs. Non-Conference,2013,North Texas,3,2,5,0.6
vs. Ranked (AP),2013,North Texas,0,0,0,
vs. Unranked (AP),2013,North Texas,9,4,13,0.6923076923076923
vs. FBS (I-A),2013,North Texas,9,4,13,0.6923076923076923
vs. FCS (I-AA),2013,North Texas,0,0,0,
vs. FBS Winning,2013,North Texas,4,4,8,0.5
vs. FBS Non-Winning,2013,North Texas,5,0,5,1.0
vs. BCS AQ,2013,North Texas,0,1,1,0.0
vs. BCS non-AQ,2013,North Texas,9,3,12,0.75
vs. FBS Power 5,2013,North Texas,0,1,1,0.0
vs. FBS non-Power 5,2013,North Texas,9,3,12,0.75
in August/September,2013,North Texas,2,2,4,0.5
in October,2013,North Texas,4,1,5,0.8
in November,2013,North Texas,2,1,3,0.6666666666666666
in December/January,2013,North Texas,1,0,1,1.0
All Games,2014,North Texas,4,8,12,0.3333333333333333
at Home,2014,North Texas,4,2,6,0.6666666666666666
on Road/Neutral Site,2014,North Texas,0,6,6,0.0
vs. Conference,2014,North Texas,2,6,8,0.25
vs. Non-Conference,2014,North Texas,2,2,4,0.5
vs. Ranked (AP),2014,North Texas,0,0,0,
vs. Unranked (AP),2014,North Texas,4,8,12,0.3333333333333333
vs. FBS (I-A),2014,North Texas,3,8,11,0.2727272727272727
vs. FCS (I-AA),2014,North Texas,1,0,1,1.0
vs. FBS Winning,2014,North Texas,0,3,3,0.0
vs. FBS Non-Winning,2014,North Texas,3,5,8,0.375
vs. BCS AQ,2014,North Texas,1,2,3,0.3333333333333333
vs. BCS non-AQ,2014,North Texas,2,6,8,0.25
vs. FBS Power 5,2014,North Texas,0,2,2,0.0
vs. FBS non-Power 5,2014,North Texas,3,6,9,0.3333333333333333
in August/September,2014,North Texas,2,2,4,0.5
in October,2014,North Texas,0,4,4,0.0
in November,2014,North Texas,2,2,4,0.5
in December/January,2014,North Texas,0,0,0,
All Games,2015,North Texas,1,11,12,0.08333333333333333
at Home,2015,North Texas,1,4,5,0.2
on Road/Neutral Site,2015,North Texas,0,7,7,0.0
vs. Conference,2015,North Texas,1,7,8,0.125
vs. Non-Conference,2015,North Texas,0,4,4,0.0
vs. Ranked (AP),2015,North Texas,0,3,3,0.0
vs. Unranked (AP),2015,North Texas,1,8,9,0.1111111111111111
vs. FBS (I-A),2015,North Texas,1,10,11,0.09090909090909091
vs. FCS (I-AA),2015,North Texas,0,1,1,0.0
vs. FBS Winning,2015,North Texas,0,7,7,0.0
vs. FBS Non-Winning,2015,North Texas,1,3,4,0.25
vs. BCS AQ,2015,North Texas,0,3,3,0.0
vs. BCS non-AQ,2015,North Texas,1,7,8,0.125
vs. FBS Power 5,2015,North Texas,0,2,2,0.0
vs. FBS non-Power 5,2015,North Texas,1,8,9,0.1111111111111111
in August/September,2015,North Texas,0,3,3,0.0
in October,2015,North Texas,1,4,5,0.2
in November,2015,North Texas,0,4,4,0.0
in December/January,2015,North Texas,0,0,0,
All Games,2016,North Texas,5,8,13,0.38461538461538464
at Home,2016,North Texas,3,3,6,0.5
on Road/Neutral Site,2016,North Texas,2,5,7,0.2857142857142857
vs. Conference,2016,North Texas,3,5,8,0.375
vs. Non-Conference,2016,North Texas,2,3,5,0.4
vs. Ranked (AP),2016,North Texas,0,1,1,0.0
vs. Unranked (AP),2016,North Texas,5,7,12,0.4166666666666667
vs. FBS (I-A),2016,North Texas,4,8,12,0.3333333333333333
vs. FCS (I-AA),2016,North Texas,1,0,1,1.0
vs. FBS Winning,2016,North Texas,2,5,7,0.2857142857142857
vs. FBS Non-Winning,2016,North Texas,2,3,5,0.4
vs. BCS AQ,2016,North Texas,0,2,2,0.0
vs. BCS non-AQ,2016,North Texas,4,6,10,0.4
vs. FBS Power 5,2016,North Texas,0,1,1,0.0
vs. FBS non-Power 5,2016,North Texas,4,7,11,0.36363636363636365
in August/September,2016,North Texas,2,2,4,0.5
in October,2016,North Texas,2,2,4,0.5
in November,2016,North Texas,1,3,4,0.25
in December/January,2016,North Texas,0,1,1,0.0
All Games,2017,North Texas,9,5,14,0.6428571428571429
at Home,2017,North Texas,6,0,6,1.0
on Road/Neutral Site,2017,North Texas,3,5,8,0.375
vs. Conference,2017,North Texas,7,2,9,0.7777777777777778
vs. Non-Conference,2017,North Texas,2,3,5,0.4
vs. Ranked (AP),2017,North Texas,0,0,0,
vs. Unranked (AP),2017,North Texas,9,5,14,0.6428571428571429
vs. FBS (I-A),2017,North Texas,8,5,13,0.6153846153846154
vs. FCS (I-AA),2017,North Texas,1,0,1,1.0
vs. FBS Winning,2017,North Texas,5,5,10,0.5
vs. FBS Non-Winning,2017,North Texas,3,0,3,1.0
vs. BCS AQ,2017,North Texas,0,2,2,0.0
vs. BCS non-AQ,2017,North Texas,8,3,11,0.7272727272727273
vs. FBS Power 5,2017,North Texas,0,1,1,0.0
vs. FBS non-Power 5,2017,North Texas,8,4,12,0.6666666666666666
in August/September,2017,North Texas,3,2,5,0.6
in October,2017,North Texas,2,1,3,0.6666666666666666
in November,2017,North Texas,4,0,4,1.0
in December/January,2017,North Texas,0,2,2,0.0
All Games,2018,North Texas,9,4,13,0.6923076923076923
at Home,2018,North Texas,5,1,6,0.8333333333333334
on Road/Neutral Site,2018,North Texas,4,3,7,0.5714285714285714
vs. Conference,2018,North Texas,5,3,8,0.625
vs. Non-Conference,2018,North Texas,4,1,5,0.8
vs. Ranked (AP),2018,North Texas,0,1,1,0.0
vs. Unranked (AP),2018,North Texas,9,3,12,0.75
vs. FBS (I-A),2018,North Texas,8,4,12,0.6666666666666666
vs. FCS (I-AA),2018,North Texas,1,0,1,1.0
vs. FBS Winning,2018,North Texas,1,3,4,0.25
vs. FBS Non-Winning,2018,North Texas,7,1,8,0.875
vs. BCS AQ,2018,North Texas,2,0,2,1.0
vs. BCS non-AQ,2018,North Texas,6,4,10,0.6
vs. FBS Power 5,2018,North Texas,1,0,1,1.0
vs. FBS non-Power 5,2018,North Texas,7,4,11,0.6363636363636364
in August/September,2018,North Texas,4,1,5,0.8
in October,2018,North Texas,3,1,4,0.75
in November,2018,North Texas,2,1,3,0.6666666666666666
in December/January,2018,North Texas,0,1,1,0.0
All Games,2019,North Texas,4,8,12,0.3333333333333333
at Home,2019,North Texas,4,2,6,0.6666666666666666
on Road/Neutral Site,2019,North Texas,0,6,6,0.0
vs. Conference,2019,North Texas,3,5,8,0.375
vs. Non-Conference,2019,North Texas,1,3,4,0.25
vs. Ranked (AP),2019,North Texas,0,0,0,
vs. Unranked (AP),2019,North Texas,4,8,12,0.3333333333333333
vs. FBS (I-A),2019,North Texas,3,8,11,0.2727272727272727
vs. FCS (I-AA),2019,North Texas,1,0,1,1.0
vs. FBS Winning,2019,North Texas,0,6,6,0.0
vs. FBS Non-Winning,2019,North Texas,3,2,5,0.6
vs. BCS AQ,2019,North Texas,0,3,3,0.0
vs. BCS non-AQ,2019,North Texas,3,5,8,0.375
vs. FBS Power 5,2019,North Texas,0,1,1,0.0
vs. FBS non-Power 5,2019,North Texas,3,7,10,0.3
in August/September,2019,North Texas,2,3,5,0.4
in October,2019,North Texas,1,2,3,0.3333333333333333
in November,2019,North Texas,1,3,4,0.25
in December/January,2019,North Texas,0,0,0,
All Games,2020,North Texas,4,6,10,0.4
at Home,2020,North Texas,2,4,6,0.3333333333333333
on Road/Neutral Site,2020,North Texas,2,2,4,0.5
vs. Conference,2020,North Texas,3,4,7,0.42857142857142855
vs. Non-Conference,2020,North Texas,1,2,3,0.3333333333333333
vs. Ranked (AP),2020,North Texas,0,0,0,
vs. Unranked (AP),2020,North Texas,4,6,10,0.4
vs. FBS (I-A),2020,North Texas,3,6,9,0.3333333333333333
vs. FCS (I-AA),2020,North Texas,1,0,1,1.0
vs. FBS Winning,2020,North Texas,0,3,3,0.0
vs. FBS Non-Winning,2020,North Texas,3,3,6,0.5
vs. BCS AQ,2020,North Texas,0,1,1,0.0
vs. BCS non-AQ,2020,North Texas,3,5,8,0.375
vs. FBS Power 5,2020,North Texas,0,0,0,
vs. FBS non-Power 5,2020,North Texas,3,6,9,0.3333333333333333
in August/September,2020,North Texas,1,1,2,0.5
in October,2020,North Texas,1,2,3,0.3333333333333333
in November,2020,North Texas,1,1,2,0.5
in December/January,2020,North Texas,1,2,3,0.3333333333333333
All Games,2021,North Texas,6,7,13,0.46153846153846156
at Home,2021,North Texas,3,3,6,0.5
on Road/Neutral Site,2021,North Texas,3,4,7,0.42857142857142855
vs. Conference,2021,North Texas,5,3,8,0.625
vs. Non-Conference,2021,North Texas,1,4,5,0.2
vs. Ranked (AP),2021,North Texas,0,0,0,
vs. Unranked (AP),2021,North Texas,6,7,13,0.46153846153846156
vs. FBS (I-A),2021,North Texas,5,7,12,0.4166666666666667
vs. FCS (I-AA),2021,North Texas,1,0,1,1.0
vs. FBS Winning,2021,North Texas,2,5,7,0.2857142857142857
vs. FBS Non-Winning,2021,North Texas,3,2,5,0.6
vs. BCS AQ,2021,North Texas,0,2,2,0.0
vs. BCS non-AQ,2021,North Texas,5,5,10,0.5
vs. FBS Power 5,2021,North Texas,0,1,1,0.0
vs. FBS non-Power 5,2021,North Texas,5,6,11,0.45454545454545453
in August/September,2021,North Texas,1,3,4,0.25
in October,2021,North Texas,1,3,4,0.25
in November,2021,North Texas,4,0,4,1.0
in December/January,2021,North Texas,0,1,1,0.0
All Games,2022,North Texas,7,7,14,0.5
at Home,2022,North Texas,5,1,6,0.8333333333333334
on Road/Neutral Site,2022,North Texas,2,6,8,0.25
vs. Conference,2022,North Texas,6,3,9,0.6666666666666666
vs. Non-Conference,2022,North Texas,1,4,5,0.2
vs. Ranked (AP),2022,North Texas,0,0,0,
vs. Unranked (AP),2022,North Texas,7,7,14,0.5
vs. FBS (I-A),2022,North Texas,6,7,13,0.46153846153846156
vs. FCS (I-AA),2022,North Texas,1,0,1,1.0
vs. FBS Winning,2022,North Texas,1,6,7,0.14285714285714285
vs. FBS Non-Winning,2022,North Texas,5,1,6,0.8333333333333334
vs. BCS AQ,2022,North Texas,0,2,2,0.0
vs. BCS non-AQ,2022,North Texas,6,5,11,0.5454545454545454
vs. FBS Power 5,2022,North Texas,0,0,0,
vs. FBS non-Power 5,2022,North Texas,6,7,13,0.46153846153846156
in August/September,2022,North Texas,2,3,5,0.4
in October,2022,North Texas,3,1,4,0.75
in November,2022,North Texas,2,1,3,0.6666666666666666
in December/January,2022,North Texas,0,2,2,0.0
All Games,2009,Northern Illinois,7,6,13,0.5384615384615384
at Home,2009,Northern Illinois,5,1,6,0.8333333333333334
on Road/Neutral Site,2009,Northern Illinois,2,5,7,0.2857142857142857
vs. Conference,2009,Northern Illinois,5,3,8,0.625
vs. Non-Conference,2009,Northern Illinois,2,3,5,0.4
vs. Ranked (AP),2009,Northern Illinois,0,2,2,0.0
vs. Unranked (AP),2009,Northern Illinois,7,4,11,0.6363636363636364
vs. FBS (I-A),2009,Northern Illinois,6,6,12,0.5
vs. FCS (I-AA),2009,Northern Illinois,1,0,1,1.0
vs. FBS Winning,2009,Northern Illinois,0,5,5,0.0
vs. FBS Non-Winning,2009,Northern Illinois,6,1,7,0.8571428571428571
vs. BCS AQ,2009,Northern Illinois,1,2,3,0.3333333333333333
vs. BCS non-AQ,2009,Northern Illinois,5,4,9,0.5555555555555556
vs. FBS Power 5,2009,Northern Illinois,1,1,2,0.5
vs. FBS non-Power 5,2009,Northern Illinois,5,5,10,0.5
in August/September,2009,Northern Illinois,2,2,4,0.5
in October,2009,Northern Illinois,3,1,4,0.75
in November,2009,Northern Illinois,2,2,4,0.5
in December/January,2009,Northern Illinois,0,1,1,0.0
All Games,2010,Northern Illinois,11,3,14,0.7857142857142857
at Home,2010,Northern Illinois,5,0,5,1.0
on Road/Neutral Site,2010,Northern Illinois,6,3,9,0.6666666666666666
vs. Conference,2010,Northern Illinois,8,1,9,0.8888888888888888
vs. Non-Conference,2010,Northern Illinois,3,2,5,0.6
vs. Ranked (AP),2010,Northern Illinois,0,0,0,
vs. Unranked (AP),2010,Northern Illinois,11,3,14,0.7857142857142857
vs. FBS (I-A),2010,Northern Illinois,10,3,13,0.7692307692307693
vs. FCS (I-AA),2010,Northern Illinois,1,0,1,1.0
vs. FBS Winning,2010,Northern Illinois,3,2,5,0.6
vs. FBS Non-Winning,2010,Northern Illinois,7,1,8,0.875
vs. BCS AQ,2010,Northern Illinois,1,2,3,0.3333333333333333
vs. BCS non-AQ,2010,Northern Illinois,9,1,10,0.9
vs. FBS Power 5,2010,Northern Illinois,1,2,3,0.3333333333333333
vs. FBS non-Power 5,2010,Northern Illinois,9,1,10,0.9
in August/September,2010,Northern Illinois,2,2,4,0.5
in October,2010,Northern Illinois,5,0,5,1.0
in November,2010,Northern Illinois,3,0,3,1.0
in December/January,2010,Northern Illinois,1,1,2,0.5
All Games,2011,Northern Illinois,11,3,14,0.7857142857142857
at Home,2011,Northern Illinois,6,0,6,1.0
on Road/Neutral Site,2011,Northern Illinois,5,3,8,0.625
vs. Conference,2011,Northern Illinois,8,1,9,0.8888888888888888
vs. Non-Conference,2011,Northern Illinois,3,2,5,0.6
vs. Ranked (AP),2011,Northern Illinois,0,1,1,0.0
vs. Unranked (AP),2011,Northern Illinois,11,2,13,0.8461538461538461
vs. FBS (I-A),2011,Northern Illinois,10,3,13,0.7692307692307693
vs. FCS (I-AA),2011,Northern Illinois,1,0,1,1.0
vs. FBS Winning,2011,Northern Illinois,4,1,5,0.8
vs. FBS Non-Winning,2011,Northern Illinois,6,2,8,0.75
vs. BCS AQ,2011,Northern Illinois,0,2,2,0.0
vs. BCS non-AQ,2011,Northern Illinois,10,1,11,0.9090909090909091
vs. FBS Power 5,2011,Northern Illinois,0,2,2,0.0
vs. FBS non-Power 5,2011,Northern Illinois,10,1,11,0.9090909090909091
in August/September,2011,Northern Illinois,2,2,4,0.5
in October,2011,Northern Illinois,3,1,4,0.75
in November,2011,Northern Illinois,4,0,4,1.0
in December/January,2011,Northern Illinois,2,0,2,1.0
All Games,2012,Northern Illinois,12,2,14,0.8571428571428571
at Home,2012,Northern Illinois,6,0,6,1.0
on Road/Neutral Site,2012,Northern Illinois,6,2,8,0.75
vs. Conference,2012,Northern Illinois,9,0,9,1.0
vs. Non-Conference,2012,Northern Illinois,3,2,5,0.6
vs. Ranked (AP),2012,Northern Illinois,0,1,1,0.0
vs. Unranked (AP),2012,Northern Illinois,12,1,13,0.9230769230769231
vs. FBS (I-A),2012,Northern Illinois,11,2,13,0.8461538461538461
vs. FCS (I-AA),2012,Northern Illinois,1,0,1,1.0
vs. FBS Winning,2012,Northern Illinois,4,1,5,0.8
vs. FBS Non-Winning,2012,Northern Illinois,7,1,8,0.875
vs. BCS AQ,2012,Northern Illinois,1,2,3,0.3333333333333333
vs. BCS non-AQ,2012,Northern Illinois,10,0,10,1.0
vs. FBS Power 5,2012,Northern Illinois,1,2,3,0.3333333333333333
vs. FBS non-Power 5,2012,Northern Illinois,10,0,10,1.0
in August/September,2012,Northern Illinois,4,1,5,0.8
in October,2012,Northern Illinois,4,0,4,1.0
in November,2012,Northern Illinois,4,0,4,1.0
in December/January,2012,Northern Illinois,0,1,1,0.0
All Games,2013,Northern Illinois,12,2,14,0.8571428571428571
at Home,2013,Northern Illinois,5,0,5,1.0
on Road/Neutral Site,2013,Northern Illinois,7,2,9,0.7777777777777778
vs. Conference,2013,Northern Illinois,8,1,9,0.8888888888888888
vs. Non-Conference,2013,Northern Illinois,4,1,5,0.8
vs. Ranked (AP),2013,Northern Illinois,0,0,0,
vs. Unranked (AP),2013,Northern Illinois,12,2,14,0.8571428571428571
vs. FBS (I-A),2013,Northern Illinois,11,2,13,0.8461538461538461
vs. FCS (I-AA),2013,Northern Illinois,1,0,1,1.0
vs. FBS Winning,2013,Northern Illinois,3,2,5,0.6
vs. FBS Non-Winning,2013,Northern Illinois,8,0,8,1.0
vs. BCS AQ,2013,Northern Illinois,2,0,2,1.0
vs. BCS non-AQ,2013,Northern Illinois,9,2,11,0.8181818181818182
vs. FBS Power 5,2013,Northern Illinois,2,0,2,1.0
vs. FBS non-Power 5,2013,Northern Illinois,9,2,11,0.8181818181818182
in August/September,2013,Northern Illinois,4,0,4,1.0
in October,2013,Northern Illinois,4,0,4,1.0
in November,2013,Northern Illinois,4,0,4,1.0
in December/January,2013,Northern Illinois,0,2,2,0.0
All Games,2014,Northern Illinois,11,3,14,0.7857142857142857
at Home,2014,Northern Illinois,4,1,5,0.8
on Road/Neutral Site,2014,Northern Illinois,7,2,9,0.7777777777777778
vs. Conference,2014,Northern Illinois,8,1,9,0.8888888888888888
vs. Non-Conference,2014,Northern Illinois,3,2,5,0.6
vs. Ranked (AP),2014,Northern Illinois,0,1,1,0.0
vs. Unranked (AP),2014,Northern Illinois,11,2,13,0.8461538461538461
vs. FBS (I-A),2014,Northern Illinois,10,3,13,0.7692307692307693
vs. FCS (I-AA),2014,Northern Illinois,1,0,1,1.0
vs. FBS Winning,2014,Northern Illinois,3,3,6,0.5
vs. FBS Non-Winning,2014,Northern Illinois,7,0,7,1.0
vs. BCS AQ,2014,Northern Illinois,1,1,2,0.5
vs. BCS non-AQ,2014,Northern Illinois,9,2,11,0.8181818181818182
vs. FBS Power 5,2014,Northern Illinois,1,1,2,0.5
vs. FBS non-Power 5,2014,Northern Illinois,9,2,11,0.8181818181818182
in August/September,2014,Northern Illinois,3,1,4,0.75
in October,2014,Northern Illinois,3,1,4,0.75
in November,2014,Northern Illinois,4,0,4,1.0
in December/January,2014,Northern Illinois,1,1,2,0.5
All Games,2015,Northern Illinois,8,6,14,0.5714285714285714
at Home,2015,Northern Illinois,5,1,6,0.8333333333333334
on Road/Neutral Site,2015,Northern Illinois,3,5,8,0.375
vs. Conference,2015,Northern Illinois,6,3,9,0.6666666666666666
vs. Non-Conference,2015,Northern Illinois,2,3,5,0.4
vs. Ranked (AP),2015,Northern Illinois,0,1,1,0.0
vs. Unranked (AP),2015,Northern Illinois,8,5,13,0.6153846153846154
vs. FBS (I-A),2015,Northern Illinois,7,6,13,0.5384615384615384
vs. FCS (I-AA),2015,Northern Illinois,1,0,1,1.0
vs. FBS Winning,2015,Northern Illinois,2,5,7,0.2857142857142857
vs. FBS Non-Winning,2015,Northern Illinois,5,1,6,0.8333333333333334
vs. BCS AQ,2015,Northern Illinois,0,2,2,0.0
vs. BCS non-AQ,2015,Northern Illinois,7,4,11,0.6363636363636364
vs. FBS Power 5,2015,Northern Illinois,0,2,2,0.0
vs. FBS non-Power 5,2015,Northern Illinois,7,4,11,0.6363636363636364
in August/September,2015,Northern Illinois,2,2,4,0.5
in October,2015,Northern Illinois,3,1,4,0.75
in November,2015,Northern Illinois,3,1,4,0.75
in December/January,2015,Northern Illinois,0,2,2,0.0
All Games,2016,Northern Illinois,5,7,12,0.4166666666666667
at Home,2016,Northern Illinois,2,3,5,0.4
on Road/Neutral Site,2016,Northern Illinois,3,4,7,0.42857142857142855
vs. Conference,2016,Northern Illinois,5,3,8,0.625
vs. Non-Conference,2016,Northern Illinois,0,4,4,0.0
vs. Ranked (AP),2016,Northern Illinois,0,2,2,0.0
vs. Unranked (AP),2016,Northern Illinois,5,5,10,0.5
vs. FBS (I-A),2016,Northern Illinois,5,6,11,0.45454545454545453
vs. FCS (I-AA),2016,Northern Illinois,0,1,1,0.0
vs. FBS Winning,2016,Northern Illinois,1,5,6,0.16666666666666666
vs. FBS Non-Winning,2016,Northern Illinois,4,1,5,0.8
vs. BCS AQ,2016,Northern Illinois,0,1,1,0.0
vs. BCS non-AQ,2016,Northern Illinois,5,5,10,0.5
vs. FBS Power 5,2016,Northern Illinois,0,0,0,
vs. FBS non-Power 5,2016,Northern Illinois,5,6,11,0.45454545454545453
in August/September,2016,Northern Illinois,0,4,4,0.0
in October,2016,Northern Illinois,2,2,4,0.5
in November,2016,Northern Illinois,3,1,4,0.75
in December/January,2016,Northern Illinois,0,0,0,
All Games,2017,Northern Illinois,8,5,13,0.6153846153846154
at Home,2017,Northern Illinois,5,1,6,0.8333333333333334
on Road/Neutral Site,2017,Northern Illinois,3,4,7,0.42857142857142855
vs. Conference,2017,Northern Illinois,6,2,8,0.75
vs. Non-Conference,2017,Northern Illinois,2,3,5,0.4
vs. Ranked (AP),2017,Northern Illinois,0,0,0,
vs. Unranked (AP),2017,Northern Illinois,8,5,13,0.6153846153846154
vs. FBS (I-A),2017,Northern Illinois,7,5,12,0.5833333333333334
vs. FCS (I-AA),2017,Northern Illinois,1,0,1,1.0
vs. FBS Winning,2017,Northern Illinois,0,5,5,0.0
vs. FBS Non-Winning,2017,Northern Illinois,7,0,7,1.0
vs. BCS AQ,2017,Northern Illinois,1,2,3,0.3333333333333333
vs. BCS non-AQ,2017,Northern Illinois,6,3,9,0.6666666666666666
vs. FBS Power 5,2017,Northern Illinois,1,2,3,0.3333333333333333
vs. FBS non-Power 5,2017,Northern Illinois,6,3,9,0.6666666666666666
in August/September,2017,Northern Illinois,2,2,4,0.5
in October,2017,Northern Illinois,4,0,4,1.0
in November,2017,Northern Illinois,2,2,4,0.5
in December/January,2017,Northern Illinois,0,1,1,0.0
All Games,2018,Northern Illinois,8,6,14,0.5714285714285714
at Home,2018,Northern Illinois,3,2,5,0.6
on Road/Neutral Site,2018,Northern Illinois,5,4,9,0.5555555555555556
vs. Conference,2018,Northern Illinois,7,2,9,0.7777777777777778
vs. Non-Conference,2018,Northern Illinois,1,4,5,0.2
vs. Ranked (AP),2018,Northern Illinois,0,1,1,0.0
vs. Unranked (AP),2018,Northern Illinois,8,5,13,0.6153846153846154
vs. FBS (I-A),2018,Northern Illinois,8,6,14,0.5714285714285714
vs. FCS (I-AA),2018,Northern Illinois,0,0,0,
vs. FBS Winning,2018,Northern Illinois,5,4,9,0.5555555555555556
vs. FBS Non-Winning,2018,Northern Illinois,3,2,5,0.6
vs. BCS AQ,2018,Northern Illinois,0,3,3,0.0
vs. BCS non-AQ,2018,Northern Illinois,8,3,11,0.7272727272727273
vs. FBS Power 5,2018,Northern Illinois,0,3,3,0.0
vs. FBS non-Power 5,2018,Northern Illinois,8,3,11,0.7272727272727273
in August/September,2018,Northern Illinois,2,3,5,0.4
in October,2018,Northern Illinois,3,0,3,1.0
in November,2018,Northern Illinois,3,2,5,0.6
in December/January,2018,Northern Illinois,0,1,1,0.0
All Games,2019,Northern Illinois,5,7,12,0.4166666666666667
at Home,2019,Northern Illinois,3,2,5,0.6
on Road/Neutral Site,2019,Northern Illinois,2,5,7,0.2857142857142857
vs. Conference,2019,Northern Illinois,4,4,8,0.5
vs. Non-Conference,2019,Northern Illinois,1,3,4,0.25
vs. Ranked (AP),2019,Northern Illinois,0,1,1,0.0
vs. Unranked (AP),2019,Northern Illinois,5,6,11,0.45454545454545453
vs. FBS (I-A),2019,Northern Illinois,4,7,11,0.36363636363636365
vs. FCS (I-AA),2019,Northern Illinois,1,0,1,1.0
vs. FBS Winning,2019,Northern Illinois,2,3,5,0.4
vs. FBS Non-Winning,2019,Northern Illinois,2,4,6,0.3333333333333333
vs. BCS AQ,2019,Northern Illinois,0,3,3,0.0
vs. BCS non-AQ,2019,Northern Illinois,4,4,8,0.5
vs. FBS Power 5,2019,Northern Illinois,0,3,3,0.0
vs. FBS non-Power 5,2019,Northern Illinois,4,4,8,0.5
in August/September,2019,Northern Illinois,1,3,4,0.25
in October,2019,Northern Illinois,2,2,4,0.5
in November,2019,Northern Illinois,2,2,4,0.5
in December/January,2019,Northern Illinois,0,0,0,
All Games,2020,Northern Illinois,0,6,6,0.0
at Home,2020,Northern Illinois,0,3,3,0.0
on Road/Neutral Site,2020,Northern Illinois,0,3,3,0.0
vs. Conference,2020,Northern Illinois,0,6,6,0.0
vs. Non-Conference,2020,Northern Illinois,0,0,0,
vs. Ranked (AP),2020,Northern Illinois,0,0,0,
vs. Unranked (AP),2020,Northern Illinois,0,6,6,0.0
vs. FBS (I-A),2020,Northern Illinois,0,6,6,0.0
vs. FCS (I-AA),2020,Northern Illinois,0,0,0,
vs. FBS Winning,2020,Northern Illinois,0,4,4,0.0
vs. FBS Non-Winning,2020,Northern Illinois,0,2,2,0.0
vs. BCS AQ,2020,Northern Illinois,0,0,0,
vs. BCS non-AQ,2020,Northern Illinois,0,6,6,0.0
vs. FBS Power 5,2020,Northern Illinois,0,0,0,
vs. FBS non-Power 5,2020,Northern Illinois,0,6,6,0.0
in August/September,2020,Northern Illinois,0,0,0,
in October,2020,Northern Illinois,0,0,0,
in November,2020,Northern Illinois,0,4,4,0.0
in December/January,2020,Northern Illinois,0,2,2,0.0
All Games,2021,Northern Illinois,9,5,14,0.6428571428571429
at Home,2021,Northern Illinois,4,2,6,0.6666666666666666
on Road/Neutral Site,2021,Northern Illinois,5,3,8,0.625
vs. Conference,2021,Northern Illinois,7,2,9,0.7777777777777778
vs. Non-Conference,2021,Northern Illinois,2,3,5,0.4
vs. Ranked (AP),2021,Northern Illinois,0,1,1,0.0
vs. Unranked (AP),2021,Northern Illinois,9,4,13,0.6923076923076923
vs. FBS (I-A),2021,Northern Illinois,8,5,13,0.6153846153846154
vs. FCS (I-AA),2021,Northern Illinois,1,0,1,1.0
vs. FBS Winning,2021,Northern Illinois,3,4,7,0.42857142857142855
vs. FBS Non-Winning,2021,Northern Illinois,5,1,6,0.8333333333333334
vs. BCS AQ,2021,Northern Illinois,1,1,2,0.5
vs. BCS non-AQ,2021,Northern Illinois,7,4,11,0.6363636363636364
vs. FBS Power 5,2021,Northern Illinois,1,1,2,0.5
vs. FBS non-Power 5,2021,Northern Illinois,7,4,11,0.6363636363636364
in August/September,2021,Northern Illinois,2,2,4,0.5
in October,2021,Northern Illinois,4,0,4,1.0
in November,2021,Northern Illinois,2,2,4,0.5
in December/January,2021,Northern Illinois,1,1,2,0.5
All Games,2022,Northern Illinois,3,9,12,0.25
at Home,2022,Northern Illinois,1,5,6,0.16666666666666666
on Road/Neutral Site,2022,Northern Illinois,2,4,6,0.3333333333333333
vs. Conference,2022,Northern Illinois,2,6,8,0.25
vs. Non-Conference,2022,Northern Illinois,1,3,4,0.25
vs. Ranked (AP),2022,Northern Illinois,0,0,0,
vs. Unranked (AP),2022,Northern Illinois,3,9,12,0.25
vs. FBS (I-A),2022,Northern Illinois,2,9,11,0.18181818181818182
vs. FCS (I-AA),2022,Northern Illinois,1,0,1,1.0
vs. FBS Winning,2022,Northern Illinois,1,3,4,0.25
vs. FBS Non-Winning,2022,Northern Illinois,1,6,7,0.14285714285714285
vs. BCS AQ,2022,Northern Illinois,0,3,3,0.0
vs. BCS non-AQ,2022,Northern Illinois,2,6,8,0.25
vs. FBS Power 5,2022,Northern Illinois,0,2,2,0.0
vs. FBS non-Power 5,2022,Northern Illinois,2,7,9,0.2222222222222222
in August/September,2022,Northern Illinois,1,3,4,0.25
in October,2022,Northern Illinois,1,3,4,0.25
in November,2022,Northern Illinois,1,3,4,0.25
in December/January,2022,Northern Illinois,0,0,0,
All Games,2009,Northwestern,8,5,13,0.6153846153846154
at Home,2009,Northwestern,5,2,7,0.7142857142857143
on Road/Neutral Site,2009,Northwestern,3,3,6,0.5
vs. Conference,2009,Northwestern,5,3,8,0.625
vs. Non-Conference,2009,Northwestern,3,2,5,0.6
vs. Ranked (AP),2009,Northwestern,2,1,3,0.6666666666666666
vs. Unranked (AP),2009,Northwestern,6,4,10,0.6
vs. FBS (I-A),2009,Northwestern,7,5,12,0.5833333333333334
vs. FCS (I-AA),2009,Northwestern,1,0,1,1.0
vs. FBS Winning,2009,Northwestern,2,2,4,0.5
vs. FBS Non-Winning,2009,Northwestern,5,3,8,0.625
vs. BCS AQ,2009,Northwestern,5,5,10,0.5
vs. BCS non-AQ,2009,Northwestern,2,0,2,1.0
vs. FBS Power 5,2009,Northwestern,5,4,9,0.5555555555555556
vs. FBS non-Power 5,2009,Northwestern,2,1,3,0.6666666666666666
in August/September,2009,Northwestern,2,2,4,0.5
in October,2009,Northwestern,3,2,5,0.6
in November,2009,Northwestern,3,0,3,1.0
in December/January,2009,Northwestern,0,1,1,0.0
All Games,2010,Northwestern,7,6,13,0.5384615384615384
at Home,2010,Northwestern,3,2,5,0.6
on Road/Neutral Site,2010,Northwestern,4,4,8,0.5
vs. Conference,2010,Northwestern,3,5,8,0.375
vs. Non-Conference,2010,Northwestern,4,1,5,0.8
vs. Ranked (AP),2010,Northwestern,0,2,2,0.0
vs. Unranked (AP),2010,Northwestern,7,4,11,0.6363636363636364
vs. FBS (I-A),2010,Northwestern,6,6,12,0.5
vs. FCS (I-AA),2010,Northwestern,1,0,1,1.0
vs. FBS Winning,2010,Northwestern,1,5,6,0.16666666666666666
vs. FBS Non-Winning,2010,Northwestern,5,1,6,0.8333333333333334
vs. BCS AQ,2010,Northwestern,4,6,10,0.4
vs. BCS non-AQ,2010,Northwestern,2,0,2,1.0
vs. FBS Power 5,2010,Northwestern,4,6,10,0.4
vs. FBS non-Power 5,2010,Northwestern,2,0,2,1.0
in August/September,2010,Northwestern,4,0,4,1.0
in October,2010,Northwestern,2,2,4,0.5
in November,2010,Northwestern,1,3,4,0.25
in December/January,2010,Northwestern,0,1,1,0.0
All Games,2011,Northwestern,6,7,13,0.46153846153846156
at Home,2011,Northwestern,3,3,6,0.5
on Road/Neutral Site,2011,Northwestern,3,4,7,0.42857142857142855
vs. Conference,2011,Northwestern,3,5,8,0.375
vs. Non-Conference,2011,Northwestern,3,2,5,0.6
vs. Ranked (AP),2011,Northwestern,1,2,3,0.3333333333333333
vs. Unranked (AP),2011,Northwestern,5,5,10,0.5
vs. FBS (I-A),2011,Northwestern,5,7,12,0.4166666666666667
vs. FCS (I-AA),2011,Northwestern,1,0,1,1.0
vs. FBS Winning,2011,Northwestern,1,6,7,0.14285714285714285
vs. FBS Non-Winning,2011,Northwestern,4,1,5,0.8
vs. BCS AQ,2011,Northwestern,4,6,10,0.4
vs. BCS non-AQ,2011,Northwestern,1,1,2,0.5
vs. FBS Power 5,2011,Northwestern,4,6,10,0.4
vs. FBS non-Power 5,2011,Northwestern,1,1,2,0.5
in August/September,2011,Northwestern,2,1,3,0.6666666666666666
in October,2011,Northwestern,1,4,5,0.2
in November,2011,Northwestern,3,1,4,0.75
in December/January,2011,Northwestern,0,1,1,0.0
All Games,2012,Northwestern,10,3,13,0.7692307692307693
at Home,2012,Northwestern,6,1,7,0.8571428571428571
on Road/Neutral Site,2012,Northwestern,4,2,6,0.6666666666666666
vs. Conference,2012,Northwestern,5,3,8,0.625
vs. Non-Conference,2012,Northwestern,5,0,5,1.0
vs. Ranked (AP),2012,Northwestern,1,2,3,0.3333333333333333
vs. Unranked (AP),2012,Northwestern,9,1,10,0.9
vs. FBS (I-A),2012,Northwestern,9,3,12,0.75
vs. FCS (I-AA),2012,Northwestern,1,0,1,1.0
vs. FBS Winning,2012,Northwestern,4,3,7,0.5714285714285714
vs. FBS Non-Winning,2012,Northwestern,5,0,5,1.0
vs. BCS AQ,2012,Northwestern,9,3,12,0.75
vs. BCS non-AQ,2012,Northwestern,0,0,0,
vs. FBS Power 5,2012,Northwestern,8,3,11,0.7272727272727273
vs. FBS non-Power 5,2012,Northwestern,1,0,1,1.0
in August/September,2012,Northwestern,5,0,5,1.0
in October,2012,Northwestern,2,2,4,0.5
in November,2012,Northwestern,2,1,3,0.6666666666666666
in December/January,2012,Northwestern,1,0,1,1.0
All Games,2013,Northwestern,5,7,12,0.4166666666666667
at Home,2013,Northwestern,3,4,7,0.42857142857142855
on Road/Neutral Site,2013,Northwestern,2,3,5,0.4
vs. Conference,2013,Northwestern,1,7,8,0.125
vs. Non-Conference,2013,Northwestern,4,0,4,1.0
vs. Ranked (AP),2013,Northwestern,0,3,3,0.0
vs. Unranked (AP),2013,Northwestern,5,4,9,0.5555555555555556
vs. FBS (I-A),2013,Northwestern,4,7,11,0.36363636363636365
vs. FCS (I-AA),2013,Northwestern,1,0,1,1.0
vs. FBS Winning,2013,Northwestern,1,7,8,0.125
vs. FBS Non-Winning,2013,Northwestern,3,0,3,1.0
vs. BCS AQ,2013,Northwestern,3,7,10,0.3
vs. BCS non-AQ,2013,Northwestern,1,0,1,1.0
vs. FBS Power 5,2013,Northwestern,3,7,10,0.3
vs. FBS non-Power 5,2013,Northwestern,1,0,1,1.0
in August/September,2013,Northwestern,4,0,4,1.0
in October,2013,Northwestern,0,4,4,0.0
in November,2013,Northwestern,1,3,4,0.25
in December/January,2013,Northwestern,0,0,0,
All Games,2014,Northwestern,5,7,12,0.4166666666666667
at Home,2014,Northwestern,2,5,7,0.2857142857142857
on Road/Neutral Site,2014,Northwestern,3,2,5,0.6
vs. Conference,2014,Northwestern,3,5,8,0.375
vs. Non-Conference,2014,Northwestern,2,2,4,0.5
vs. Ranked (AP),2014,Northwestern,1,0,1,1.0
vs. Unranked (AP),2014,Northwestern,4,7,11,0.36363636363636365
vs. FBS (I-A),2014,Northwestern,4,7,11,0.36363636363636365
vs. FCS (I-AA),2014,Northwestern,1,0,1,1.0
vs. FBS Winning,2014,Northwestern,3,4,7,0.42857142857142855
vs. FBS Non-Winning,2014,Northwestern,1,3,4,0.25
vs. BCS AQ,2014,Northwestern,4,6,10,0.4
vs. BCS non-AQ,2014,Northwestern,0,1,1,0.0
vs. FBS Power 5,2014,Northwestern,3,6,9,0.3333333333333333
vs. FBS non-Power 5,2014,Northwestern,1,1,2,0.5
in August/September,2014,Northwestern,2,2,4,0.5
in October,2014,Northwestern,1,2,3,0.3333333333333333
in November,2014,Northwestern,2,3,5,0.4
in December/January,2014,Northwestern,0,0,0,
All Games,2015,Northwestern,10,3,13,0.7692307692307693
at Home,2015,Northwestern,6,1,7,0.8571428571428571
on Road/Neutral Site,2015,Northwestern,4,2,6,0.6666666666666666
vs. Conference,2015,Northwestern,6,2,8,0.75
vs. Non-Conference,2015,Northwestern,4,1,5,0.8
vs. Ranked (AP),2015,Northwestern,2,3,5,0.4
vs. Unranked (AP),2015,Northwestern,8,0,8,1.0
vs. FBS (I-A),2015,Northwestern,9,3,12,0.75
vs. FCS (I-AA),2015,Northwestern,1,0,1,1.0
vs. FBS Winning,2015,Northwestern,4,3,7,0.5714285714285714
vs. FBS Non-Winning,2015,Northwestern,5,0,5,1.0
vs. BCS AQ,2015,Northwestern,8,3,11,0.7272727272727273
vs. BCS non-AQ,2015,Northwestern,1,0,1,1.0
vs. FBS Power 5,2015,Northwestern,8,3,11,0.7272727272727273
vs. FBS non-Power 5,2015,Northwestern,1,0,1,1.0
in August/September,2015,Northwestern,4,0,4,1.0
in October,2015,Northwestern,2,2,4,0.5
in November,2015,Northwestern,4,0,4,1.0
in December/January,2015,Northwestern,0,1,1,0.0
All Games,2016,Northwestern,7,6,13,0.5384615384615384
at Home,2016,Northwestern,3,4,7,0.42857142857142855
on Road/Neutral Site,2016,Northwestern,4,2,6,0.6666666666666666
vs. Conference,2016,Northwestern,5,4,9,0.5555555555555556
vs. Non-Conference,2016,Northwestern,2,2,4,0.5
vs. Ranked (AP),2016,Northwestern,2,4,6,0.3333333333333333
vs. Unranked (AP),2016,Northwestern,5,2,7,0.7142857142857143
vs. FBS (I-A),2016,Northwestern,7,5,12,0.5833333333333334
vs. FCS (I-AA),2016,Northwestern,0,1,1,0.0
vs. FBS Winning,2016,Northwestern,2,5,7,0.2857142857142857
vs. FBS Non-Winning,2016,Northwestern,5,0,5,1.0
vs. BCS AQ,2016,Northwestern,7,4,11,0.6363636363636364
vs. BCS non-AQ,2016,Northwestern,0,1,1,0.0
vs. FBS Power 5,2016,Northwestern,7,4,11,0.6363636363636364
vs. FBS non-Power 5,2016,Northwestern,0,1,1,0.0
in August/September,2016,Northwestern,1,3,4,0.25
in October,2016,Northwestern,3,1,4,0.75
in November,2016,Northwestern,2,2,4,0.5
in December/January,2016,Northwestern,1,0,1,1.0
All Games,2017,Northwestern,10,3,13,0.7692307692307693
at Home,2017,Northwestern,6,1,7,0.8571428571428571
on Road/Neutral Site,2017,Northwestern,4,2,6,0.6666666666666666
vs. Conference,2017,Northwestern,7,2,9,0.7777777777777778
vs. Non-Conference,2017,Northwestern,3,1,4,0.75
vs. Ranked (AP),2017,Northwestern,1,2,3,0.3333333333333333
vs. Unranked (AP),2017,Northwestern,9,1,10,0.9
vs. FBS (I-A),2017,Northwestern,10,3,13,0.7692307692307693
vs. FCS (I-AA),2017,Northwestern,0,0,0,
vs. FBS Winning,2017,Northwestern,4,3,7,0.5714285714285714
vs. FBS Non-Winning,2017,Northwestern,6,0,6,1.0
vs. BCS AQ,2017,Northwestern,8,3,11,0.7272727272727273
vs. BCS non-AQ,2017,Northwestern,2,0,2,1.0
vs. FBS Power 5,2017,Northwestern,8,3,11,0.7272727272727273
vs. FBS non-Power 5,2017,Northwestern,2,0,2,1.0
in August/September,2017,Northwestern,2,2,4,0.5
in October,2017,Northwestern,3,1,4,0.75
in November,2017,Northwestern,4,0,4,1.0
in December/January,2017,Northwestern,1,0,1,1.0
All Games,2018,Northwestern,9,5,14,0.6428571428571429
at Home,2018,Northwestern,3,4,7,0.42857142857142855
on Road/Neutral Site,2018,Northwestern,6,1,7,0.8571428571428571
vs. Conference,2018,Northwestern,8,2,10,0.8
vs. Non-Conference,2018,Northwestern,1,3,4,0.25
vs. Ranked (AP),2018,Northwestern,1,3,4,0.25
vs. Unranked (AP),2018,Northwestern,8,2,10,0.8
vs. FBS (I-A),2018,Northwestern,9,5,14,0.6428571428571429
vs. FCS (I-AA),2018,Northwestern,0,0,0,
vs. FBS Winning,2018,Northwestern,5,4,9,0.5555555555555556
vs. FBS Non-Winning,2018,Northwestern,4,1,5,0.8
vs. BCS AQ,2018,Northwestern,9,4,13,0.6923076923076923
vs. BCS non-AQ,2018,Northwestern,0,1,1,0.0
vs. FBS Power 5,2018,Northwestern,9,3,12,0.75
vs. FBS non-Power 5,2018,Northwestern,0,2,2,0.0
in August/September,2018,Northwestern,1,3,4,0.25
in October,2018,Northwestern,4,0,4,1.0
in November,2018,Northwestern,3,1,4,0.75
in December/January,2018,Northwestern,1,1,2,0.5
All Games,2019,Northwestern,3,9,12,0.25
at Home,2019,Northwestern,2,5,7,0.2857142857142857
on Road/Neutral Site,2019,Northwestern,1,4,5,0.2
vs. Conference,2019,Northwestern,1,8,9,0.1111111111111111
vs. Non-Conference,2019,Northwestern,2,1,3,0.6666666666666666
vs. Ranked (AP),2019,Northwestern,0,4,4,0.0
vs. Unranked (AP),2019,Northwestern,3,5,8,0.375
vs. FBS (I-A),2019,Northwestern,3,9,12,0.25
vs. FCS (I-AA),2019,Northwestern,0,0,0,
vs. FBS Winning,2019,Northwestern,0,6,6,0.0
vs. FBS Non-Winning,2019,Northwestern,3,3,6,0.5
vs. BCS AQ,2019,Northwestern,1,9,10,0.1
vs. BCS non-AQ,2019,Northwestern,2,0,2,1.0
vs. FBS Power 5,2019,Northwestern,1,9,10,0.1
vs. FBS non-Power 5,2019,Northwestern,2,0,2,1.0
in August/September,2019,Northwestern,1,3,4,0.25
in October,2019,Northwestern,0,3,3,0.0
in November,2019,Northwestern,2,3,5,0.4
in December/January,2019,Northwestern,0,0,0,
All Games,2020,Northwestern,7,2,9,0.7777777777777778
at Home,2020,Northwestern,4,0,4,1.0
on Road/Neutral Site,2020,Northwestern,3,2,5,0.6
vs. Conference,2020,Northwestern,6,2,8,0.75
vs. Non-Conference,2020,Northwestern,1,0,1,1.0
vs. Ranked (AP),2020,Northwestern,1,1,2,0.5
vs. Unranked (AP),2020,Northwestern,6,1,7,0.8571428571428571
vs. FBS (I-A),2020,Northwestern,7,2,9,0.7777777777777778
vs. FCS (I-AA),2020,Northwestern,0,0,0,
vs. FBS Winning,2020,Northwestern,3,1,4,0.75
vs. FBS Non-Winning,2020,Northwestern,4,1,5,0.8
vs. BCS AQ,2020,Northwestern,7,2,9,0.7777777777777778
vs. BCS non-AQ,2020,Northwestern,0,0,0,
vs. FBS Power 5,2020,Northwestern,7,2,9,0.7777777777777778
vs. FBS non-Power 5,2020,Northwestern,0,0,0,
in August/September,2020,Northwestern,0,0,0,
in October,2020,Northwestern,2,0,2,1.0
in November,2020,Northwestern,3,1,4,0.75
in December/January,2020,Northwestern,2,1,3,0.6666666666666666
All Games,2021,Northwestern,3,9,12,0.25
at Home,2021,Northwestern,3,3,6,0.5
on Road/Neutral Site,2021,Northwestern,0,6,6,0.0
vs. Conference,2021,Northwestern,1,8,9,0.1111111111111111
vs. Non-Conference,2021,Northwestern,2,1,3,0.6666666666666666
vs. Ranked (AP),2021,Northwestern,0,3,3,0.0
vs. Unranked (AP),2021,Northwestern,3,6,9,0.3333333333333333
vs. FBS (I-A),2021,Northwestern,2,9,11,0.18181818181818182
vs. FCS (I-AA),2021,Northwestern,1,0,1,1.0
vs. FBS Winning,2021,Northwestern,0,6,6,0.0
vs. FBS Non-Winning,2021,Northwestern,2,3,5,0.4
vs. BCS AQ,2021,Northwestern,1,9,10,0.1
vs. BCS non-AQ,2021,Northwestern,1,0,1,1.0
vs. FBS Power 5,2021,Northwestern,1,9,10,0.1
vs. FBS non-Power 5,2021,Northwestern,1,0,1,1.0
in August/September,2021,Northwestern,2,2,4,0.5
in October,2021,Northwestern,1,3,4,0.25
in November,2021,Northwestern,0,4,4,0.0
in December/January,2021,Northwestern,0,0,0,
All Games,2022,Northwestern,1,11,12,0.08333333333333333
at Home,2022,Northwestern,0,6,6,0.0
on Road/Neutral Site,2022,Northwestern,1,5,6,0.16666666666666666
vs. Conference,2022,Northwestern,1,8,9,0.1111111111111111
vs. Non-Conference,2022,Northwestern,0,3,3,0.0
vs. Ranked (AP),2022,Northwestern,0,2,2,0.0
vs. Unranked (AP),2022,Northwestern,1,9,10,0.1
vs. FBS (I-A),2022,Northwestern,1,10,11,0.09090909090909091
vs. FCS (I-AA),2022,Northwestern,0,1,1,0.0
vs. FBS Winning,2022,Northwestern,0,9,9,0.0
vs. FBS Non-Winning,2022,Northwestern,1,1,2,0.5
vs. BCS AQ,2022,Northwestern,1,9,10,0.1
vs. BCS non-AQ,2022,Northwestern,0,1,1,0.0
vs. FBS Power 5,2022,Northwestern,1,9,10,0.1
vs. FBS non-Power 5,2022,Northwestern,0,1,1,0.0
in August/September,2022,Northwestern,1,3,4,0.25
in October,2022,Northwestern,0,4,4,0.0
in November,2022,Northwestern,0,4,4,0.0
in December/January,2022,Northwestern,0,0,0,
All Games,2009,Notre Dame,6,6,12,0.5
at Home,2009,Notre Dame,4,3,7,0.5714285714285714
on Road/Neutral Site,2009,Notre Dame,2,3,5,0.4
vs. Conference,2009,Notre Dame,0,1,1,0.0
vs. Non-Conference,2009,Notre Dame,6,5,11,0.5454545454545454
vs. Ranked (AP),2009,Notre Dame,0,2,2,0.0
vs. Unranked (AP),2009,Notre Dame,6,4,10,0.6
vs. FBS (I-A),2009,Notre Dame,6,6,12,0.5
vs. FCS (I-AA),2009,Notre Dame,0,0,0,
vs. FBS Winning,2009,Notre Dame,2,5,7,0.2857142857142857
vs. FBS Non-Winning,2009,Notre Dame,4,1,5,0.8
vs. BCS AQ,2009,Notre Dame,5,5,10,0.5
vs. BCS non-AQ,2009,Notre Dame,1,1,2,0.5
vs. FBS Power 5,2009,Notre Dame,5,3,8,0.625
vs. FBS non-Power 5,2009,Notre Dame,1,3,4,0.25
in August/September,2009,Notre Dame,3,1,4,0.75
in October,2009,Notre Dame,3,1,4,0.75
in November,2009,Notre Dame,0,4,4,0.0
in December/January,2009,Notre Dame,0,0,0,
All Games,2010,Notre Dame,8,5,13,0.6153846153846154
at Home,2010,Notre Dame,4,3,7,0.5714285714285714
on Road/Neutral Site,2010,Notre Dame,4,2,6,0.6666666666666666
vs. Conference,2010,Notre Dame,1,1,2,0.5
vs. Non-Conference,2010,Notre Dame,7,4,11,0.6363636363636364
vs. Ranked (AP),2010,Notre Dame,0,3,3,0.0
vs. Unranked (AP),2010,Notre Dame,8,2,10,0.8
vs. FBS (I-A),2010,Notre Dame,8,5,13,0.6153846153846154
vs. FCS (I-AA),2010,Notre Dame,0,0,0,
vs. FBS Winning,2010,Notre Dame,6,5,11,0.5454545454545454
vs. FBS Non-Winning,2010,Notre Dame,2,0,2,1.0
vs. BCS AQ,2010,Notre Dame,5,3,8,0.625
vs. BCS non-AQ,2010,Notre Dame,3,2,5,0.6
vs. FBS Power 5,2010,Notre Dame,4,3,7,0.5714285714285714
vs. FBS non-Power 5,2010,Notre Dame,4,2,6,0.6666666666666666
in August/September,2010,Notre Dame,1,3,4,0.25
in October,2010,Notre Dame,3,2,5,0.6
in November,2010,Notre Dame,3,0,3,1.0
in December/January,2010,Notre Dame,1,0,1,1.0
All Games,2011,Notre Dame,8,5,13,0.6153846153846154
at Home,2011,Notre Dame,4,2,6,0.6666666666666666
on Road/Neutral Site,2011,Notre Dame,4,3,7,0.5714285714285714
vs. Conference,2011,Notre Dame,1,0,1,1.0
vs. Non-Conference,2011,Notre Dame,7,5,12,0.5833333333333334
vs. Ranked (AP),2011,Notre Dame,1,4,5,0.2
vs. Unranked (AP),2011,Notre Dame,7,1,8,0.875
vs. FBS (I-A),2011,Notre Dame,8,5,13,0.6153846153846154
vs. FCS (I-AA),2011,Notre Dame,0,0,0,
vs. FBS Winning,2011,Notre Dame,3,4,7,0.42857142857142855
vs. FBS Non-Winning,2011,Notre Dame,5,1,6,0.8333333333333334
vs. BCS AQ,2011,Notre Dame,6,5,11,0.5454545454545454
vs. BCS non-AQ,2011,Notre Dame,2,0,2,1.0
vs. FBS Power 5,2011,Notre Dame,5,4,9,0.5555555555555556
vs. FBS non-Power 5,2011,Notre Dame,3,1,4,0.75
in August/September,2011,Notre Dame,2,2,4,0.5
in October,2011,Notre Dame,3,1,4,0.75
in November,2011,Notre Dame,3,1,4,0.75
in December/January,2011,Notre Dame,0,1,1,0.0
All Games,2012,Notre Dame,12,1,13,0.9230769230769231
at Home,2012,Notre Dame,6,0,6,1.0
on Road/Neutral Site,2012,Notre Dame,6,1,7,0.8571428571428571
vs. Conference,2012,Notre Dame,2,0,2,1.0
vs. Non-Conference,2012,Notre Dame,10,1,11,0.9090909090909091
vs. Ranked (AP),2012,Notre Dame,3,1,4,0.75
vs. Unranked (AP),2012,Notre Dame,9,0,9,1.0
vs. FBS (I-A),2012,Notre Dame,12,1,13,0.9230769230769231
vs. FCS (I-AA),2012,Notre Dame,0,0,0,
vs. FBS Winning,2012,Notre Dame,8,1,9,0.8888888888888888
vs. FBS Non-Winning,2012,Notre Dame,4,0,4,1.0
vs. BCS AQ,2012,Notre Dame,10,1,11,0.9090909090909091
vs. BCS non-AQ,2012,Notre Dame,2,0,2,1.0
vs. FBS Power 5,2012,Notre Dame,9,1,10,0.9
vs. FBS non-Power 5,2012,Notre Dame,3,0,3,1.0
in August/September,2012,Notre Dame,4,0,4,1.0
in October,2012,Notre Dame,4,0,4,1.0
in November,2012,Notre Dame,4,0,4,1.0
in December/January,2012,Notre Dame,0,1,1,0.0
All Games,2013,Notre Dame,9,4,13,0.6923076923076923
at Home,2013,Notre Dame,5,1,6,0.8333333333333334
on Road/Neutral Site,2013,Notre Dame,4,3,7,0.5714285714285714
vs. Conference,2013,Notre Dame,2,0,2,1.0
vs. Non-Conference,2013,Notre Dame,7,4,11,0.6363636363636364
vs. Ranked (AP),2013,Notre Dame,3,2,5,0.6
vs. Unranked (AP),2013,Notre Dame,6,2,8,0.75
vs. FBS (I-A),2013,Notre Dame,9,4,13,0.6923076923076923
vs. FCS (I-AA),2013,Notre Dame,0,0,0,
vs. FBS Winning,2013,Notre Dame,5,4,9,0.5555555555555556
vs. FBS Non-Winning,2013,Notre Dame,4,0,4,1.0
vs. BCS AQ,2013,Notre Dame,6,4,10,0.6
vs. BCS non-AQ,2013,Notre Dame,3,0,3,1.0
vs. FBS Power 5,2013,Notre Dame,4,4,8,0.5
vs. FBS non-Power 5,2013,Notre Dame,5,0,5,1.0
in August/September,2013,Notre Dame,3,2,5,0.6
in October,2013,Notre Dame,3,0,3,1.0
in November,2013,Notre Dame,2,2,4,0.5
in December/January,2013,Notre Dame,1,0,1,1.0
All Games,2014,Notre Dame,8,5,13,0.6153846153846154
at Home,2014,Notre Dame,4,2,6,0.6666666666666666
on Road/Neutral Site,2014,Notre Dame,4,3,7,0.5714285714285714
vs. Conference,2014,Notre Dame,1,0,1,1.0
vs. Non-Conference,2014,Notre Dame,7,5,12,0.5833333333333334
vs. Ranked (AP),2014,Notre Dame,0,4,4,0.0
vs. Unranked (AP),2014,Notre Dame,8,1,9,0.8888888888888888
vs. FBS (I-A),2014,Notre Dame,8,5,13,0.6153846153846154
vs. FCS (I-AA),2014,Notre Dame,0,0,0,
vs. FBS Winning,2014,Notre Dame,4,4,8,0.5
vs. FBS Non-Winning,2014,Notre Dame,4,1,5,0.8
vs. BCS AQ,2014,Notre Dame,6,5,11,0.5454545454545454
vs. BCS non-AQ,2014,Notre Dame,2,0,2,1.0
vs. FBS Power 5,2014,Notre Dame,6,5,11,0.5454545454545454
vs. FBS non-Power 5,2014,Notre Dame,2,0,2,1.0
in August/September,2014,Notre Dame,4,0,4,1.0
in October,2014,Notre Dame,2,1,3,0.6666666666666666
in November,2014,Notre Dame,1,4,5,0.2
in December/January,2014,Notre Dame,1,0,1,1.0
All Games,2015,Notre Dame,10,3,13,0.7692307692307693
at Home,2015,Notre Dame,6,0,6,1.0
on Road/Neutral Site,2015,Notre Dame,4,3,7,0.5714285714285714
vs. Conference,2015,Notre Dame,0,0,0,
vs. Non-Conference,2015,Notre Dame,10,3,13,0.7692307692307693
vs. Ranked (AP),2015,Notre Dame,1,3,4,0.25
vs. Unranked (AP),2015,Notre Dame,9,0,9,1.0
vs. FBS (I-A),2015,Notre Dame,10,3,13,0.7692307692307693
vs. FCS (I-AA),2015,Notre Dame,0,0,0,
vs. FBS Winning,2015,Notre Dame,4,3,7,0.5714285714285714
vs. FBS Non-Winning,2015,Notre Dame,6,0,6,1.0
vs. BCS AQ,2015,Notre Dame,9,3,12,0.75
vs. BCS non-AQ,2015,Notre Dame,1,0,1,1.0
vs. FBS Power 5,2015,Notre Dame,7,3,10,0.7
vs. FBS non-Power 5,2015,Notre Dame,3,0,3,1.0
in August/September,2015,Notre Dame,4,0,4,1.0
in October,2015,Notre Dame,3,1,4,0.75
in November,2015,Notre Dame,3,1,4,0.75
in December/January,2015,Notre Dame,0,1,1,0.0
All Games,2016,Notre Dame,4,8,12,0.3333333333333333
at Home,2016,Notre Dame,2,4,6,0.3333333333333333
on Road/Neutral Site,2016,Notre Dame,2,4,6,0.3333333333333333
vs. Conference,2016,Notre Dame,1,0,1,1.0
vs. Non-Conference,2016,Notre Dame,3,8,11,0.2727272727272727
vs. Ranked (AP),2016,Notre Dame,0,3,3,0.0
vs. Unranked (AP),2016,Notre Dame,4,5,9,0.4444444444444444
vs. FBS (I-A),2016,Notre Dame,4,8,12,0.3333333333333333
vs. FCS (I-AA),2016,Notre Dame,0,0,0,
vs. FBS Winning,2016,Notre Dame,2,5,7,0.2857142857142857
vs. FBS Non-Winning,2016,Notre Dame,2,3,5,0.4
vs. BCS AQ,2016,Notre Dame,2,8,10,0.2
vs. BCS non-AQ,2016,Notre Dame,2,0,2,1.0
vs. FBS Power 5,2016,Notre Dame,2,7,9,0.2222222222222222
vs. FBS non-Power 5,2016,Notre Dame,2,1,3,0.6666666666666666
in August/September,2016,Notre Dame,1,3,4,0.25
in October,2016,Notre Dame,2,2,4,0.5
in November,2016,Notre Dame,1,3,4,0.25
in December/January,2016,Notre Dame,0,0,0,
All Games,2017,Notre Dame,10,3,13,0.7692307692307693
at Home,2017,Notre Dame,6,1,7,0.8571428571428571
on Road/Neutral Site,2017,Notre Dame,4,2,6,0.6666666666666666
vs. Conference,2017,Notre Dame,0,0,0,
vs. Non-Conference,2017,Notre Dame,10,3,13,0.7692307692307693
vs. Ranked (AP),2017,Notre Dame,4,3,7,0.5714285714285714
vs. Unranked (AP),2017,Notre Dame,6,0,6,1.0
vs. FBS (I-A),2017,Notre Dame,10,3,13,0.7692307692307693
vs. FCS (I-AA),2017,Notre Dame,0,0,0,
vs. FBS Winning,2017,Notre Dame,8,3,11,0.7272727272727273
vs. FBS Non-Winning,2017,Notre Dame,2,0,2,1.0
vs. BCS AQ,2017,Notre Dame,9,3,12,0.75
vs. BCS non-AQ,2017,Notre Dame,1,0,1,1.0
vs. FBS Power 5,2017,Notre Dame,7,3,10,0.7
vs. FBS non-Power 5,2017,Notre Dame,3,0,3,1.0
in August/September,2017,Notre Dame,4,1,5,0.8
in October,2017,Notre Dame,3,0,3,1.0
in November,2017,Notre Dame,2,2,4,0.5
in December/January,2017,Notre Dame,1,0,1,1.0
All Games,2018,Notre Dame,12,1,13,0.9230769230769231
at Home,2018,Notre Dame,6,0,6,1.0
on Road/Neutral Site,2018,Notre Dame,6,1,7,0.8571428571428571
vs. Conference,2018,Notre Dame,0,0,0,
vs. Non-Conference,2018,Notre Dame,12,1,13,0.9230769230769231
vs. Ranked (AP),2018,Notre Dame,3,1,4,0.75
vs. Unranked (AP),2018,Notre Dame,9,0,9,1.0
vs. FBS (I-A),2018,Notre Dame,12,1,13,0.9230769230769231
vs. FCS (I-AA),2018,Notre Dame,0,0,0,
vs. FBS Winning,2018,Notre Dame,5,1,6,0.8333333333333334
vs. FBS Non-Winning,2018,Notre Dame,7,0,7,1.0
vs. BCS AQ,2018,Notre Dame,11,1,12,0.9166666666666666
vs. BCS non-AQ,2018,Notre Dame,1,0,1,1.0
vs. FBS Power 5,2018,Notre Dame,10,1,11,0.9090909090909091
vs. FBS non-Power 5,2018,Notre Dame,2,0,2,1.0
in August/September,2018,Notre Dame,5,0,5,1.0
in October,2018,Notre Dame,3,0,3,1.0
in November,2018,Notre Dame,4,0,4,1.0
in December/January,2018,Notre Dame,0,1,1,0.0
All Games,2019,Notre Dame,11,2,13,0.8461538461538461
at Home,2019,Notre Dame,7,0,7,1.0
on Road/Neutral Site,2019,Notre Dame,4,2,6,0.6666666666666666
vs. Conference,2019,Notre Dame,0,0,0,
vs. Non-Conference,2019,Notre Dame,11,2,13,0.8461538461538461
vs. Ranked (AP),2019,Notre Dame,1,2,3,0.3333333333333333
vs. Unranked (AP),2019,Notre Dame,10,0,10,1.0
vs. FBS (I-A),2019,Notre Dame,11,2,13,0.8461538461538461
vs. FCS (I-AA),2019,Notre Dame,0,0,0,
vs. FBS Winning,2019,Notre Dame,6,2,8,0.75
vs. FBS Non-Winning,2019,Notre Dame,5,0,5,1.0
vs. BCS AQ,2019,Notre Dame,9,2,11,0.8181818181818182
vs. BCS non-AQ,2019,Notre Dame,2,0,2,1.0
vs. FBS Power 5,2019,Notre Dame,8,2,10,0.8
vs. FBS non-Power 5,2019,Notre Dame,3,0,3,1.0
in August/September,2019,Notre Dame,3,1,4,0.75
in October,2019,Notre Dame,2,1,3,0.6666666666666666
in November,2019,Notre Dame,5,0,5,1.0
in December/January,2019,Notre Dame,1,0,1,1.0
All Games,2020,Notre Dame,10,2,12,0.8333333333333334
at Home,2020,Notre Dame,6,0,6,1.0
on Road/Neutral Site,2020,Notre Dame,4,2,6,0.6666666666666666
vs. Conference,2020,Notre Dame,9,1,10,0.9
vs. Non-Conference,2020,Notre Dame,1,1,2,0.5
vs. Ranked (AP),2020,Notre Dame,2,2,4,0.5
vs. Unranked (AP),2020,Notre Dame,8,0,8,1.0
vs. FBS (I-A),2020,Notre Dame,10,2,12,0.8333333333333334
vs. FCS (I-AA),2020,Notre Dame,0,0,0,
vs. FBS Winning,2020,Notre Dame,4,2,6,0.6666666666666666
vs. FBS Non-Winning,2020,Notre Dame,6,0,6,1.0
vs. BCS AQ,2020,Notre Dame,10,2,12,0.8333333333333334
vs. BCS non-AQ,2020,Notre Dame,0,0,0,
vs. FBS Power 5,2020,Notre Dame,9,2,11,0.8181818181818182
vs. FBS non-Power 5,2020,Notre Dame,1,0,1,1.0
in August/September,2020,Notre Dame,2,0,2,1.0
in October,2020,Notre Dame,4,0,4,1.0
in November,2020,Notre Dame,3,0,3,1.0
in December/January,2020,Notre Dame,1,2,3,0.3333333333333333
All Games,2021,Notre Dame,11,2,13,0.8461538461538461
at Home,2021,Notre Dame,6,1,7,0.8571428571428571
on Road/Neutral Site,2021,Notre Dame,5,1,6,0.8333333333333334
vs. Conference,2021,Notre Dame,0,0,0,
vs. Non-Conference,2021,Notre Dame,11,2,13,0.8461538461538461
vs. Ranked (AP),2021,Notre Dame,0,2,2,0.0
vs. Unranked (AP),2021,Notre Dame,11,0,11,1.0
vs. FBS (I-A),2021,Notre Dame,11,2,13,0.8461538461538461
vs. FCS (I-AA),2021,Notre Dame,0,0,0,
vs. FBS Winning,2021,Notre Dame,3,2,5,0.6
vs. FBS Non-Winning,2021,Notre Dame,8,0,8,1.0
vs. BCS AQ,2021,Notre Dame,10,2,12,0.8333333333333334
vs. BCS non-AQ,2021,Notre Dame,1,0,1,1.0
vs. FBS Power 5,2021,Notre Dame,9,1,10,0.9
vs. FBS non-Power 5,2021,Notre Dame,2,1,3,0.6666666666666666
in August/September,2021,Notre Dame,4,0,4,1.0
in October,2021,Notre Dame,3,1,4,0.75
in November,2021,Notre Dame,4,0,4,1.0
in December/January,2021,Notre Dame,0,1,1,0.0
All Games,2022,Notre Dame,9,4,13,0.6923076923076923
at Home,2022,Notre Dame,4,2,6,0.6666666666666666
on Road/Neutral Site,2022,Notre Dame,5,2,7,0.7142857142857143
vs. Conference,2022,Notre Dame,1,0,1,1.0
vs. Non-Conference,2022,Notre Dame,8,4,12,0.6666666666666666
vs. Ranked (AP),2022,Notre Dame,2,2,4,0.5
vs. Unranked (AP),2022,Notre Dame,7,2,9,0.7777777777777778
vs. FBS (I-A),2022,Notre Dame,9,4,13,0.6923076923076923
vs. FCS (I-AA),2022,Notre Dame,0,0,0,
vs. FBS Winning,2022,Notre Dame,5,3,8,0.625
vs. FBS Non-Winning,2022,Notre Dame,4,1,5,0.8
vs. BCS AQ,2022,Notre Dame,7,3,10,0.7
vs. BCS non-AQ,2022,Notre Dame,2,1,3,0.6666666666666666
vs. FBS Power 5,2022,Notre Dame,6,3,9,0.6666666666666666
vs. FBS non-Power 5,2022,Notre Dame,3,1,4,0.75
in August/September,2022,Notre Dame,2,2,4,0.5
in October,2022,Notre Dame,3,1,4,0.75
in November,2022,Notre Dame,3,1,4,0.75
in December/January,2022,Notre Dame,1,0,1,1.0
All Games,2009,Ohio,9,5,14,0.6428571428571429
at Home,2009,Ohio,4,2,6,0.6666666666666666
on Road/Neutral Site,2009,Ohio,5,3,8,0.625
vs. Conference,2009,Ohio,7,2,9,0.7777777777777778
vs. Non-Conference,2009,Ohio,2,3,5,0.4
vs. Ranked (AP),2009,Ohio,0,1,1,0.0
vs. Unranked (AP),2009,Ohio,9,4,13,0.6923076923076923
vs. FBS (I-A),2009,Ohio,8,5,13,0.6153846153846154
vs. FCS (I-AA),2009,Ohio,1,0,1,1.0
vs. FBS Winning,2009,Ohio,3,4,7,0.42857142857142855
vs. FBS Non-Winning,2009,Ohio,5,1,6,0.8333333333333334
vs. BCS AQ,2009,Ohio,0,2,2,0.0
vs. BCS non-AQ,2009,Ohio,8,3,11,0.7272727272727273
vs. FBS Power 5,2009,Ohio,0,1,1,0.0
vs. FBS non-Power 5,2009,Ohio,8,4,12,0.6666666666666666
in August/September,2009,Ohio,2,2,4,0.5
in October,2009,Ohio,4,1,5,0.8
in November,2009,Ohio,3,0,3,1.0
in December/January,2009,Ohio,0,2,2,0.0
All Games,2010,Ohio,8,5,13,0.6153846153846154
at Home,2010,Ohio,5,1,6,0.8333333333333334
on Road/Neutral Site,2010,Ohio,3,4,7,0.42857142857142855
vs. Conference,2010,Ohio,6,2,8,0.75
vs. Non-Conference,2010,Ohio,2,3,5,0.4
vs. Ranked (AP),2010,Ohio,0,1,1,0.0
vs. Unranked (AP),2010,Ohio,8,4,12,0.6666666666666666
vs. FBS (I-A),2010,Ohio,7,5,12,0.5833333333333334
vs. FCS (I-AA),2010,Ohio,1,0,1,1.0
vs. FBS Winning,2010,Ohio,2,3,5,0.4
vs. FBS Non-Winning,2010,Ohio,5,2,7,0.7142857142857143
vs. BCS AQ,2010,Ohio,0,1,1,0.0
vs. BCS non-AQ,2010,Ohio,7,4,11,0.6363636363636364
vs. FBS Power 5,2010,Ohio,0,1,1,0.0
vs. FBS non-Power 5,2010,Ohio,7,4,11,0.6363636363636364
in August/September,2010,Ohio,1,3,4,0.25
in October,2010,Ohio,5,0,5,1.0
in November,2010,Ohio,2,1,3,0.6666666666666666
in December/January,2010,Ohio,0,1,1,0.0
All Games,2011,Ohio,10,4,14,0.7142857142857143
at Home,2011,Ohio,5,1,6,0.8333333333333334
on Road/Neutral Site,2011,Ohio,5,3,8,0.625
vs. Conference,2011,Ohio,6,3,9,0.6666666666666666
vs. Non-Conference,2011,Ohio,4,1,5,0.8
vs. Ranked (AP),2011,Ohio,0,0,0,
vs. Unranked (AP),2011,Ohio,10,4,14,0.7142857142857143
vs. FBS (I-A),2011,Ohio,9,4,13,0.6923076923076923
vs. FCS (I-AA),2011,Ohio,1,0,1,1.0
vs. FBS Winning,2011,Ohio,3,2,5,0.6
vs. FBS Non-Winning,2011,Ohio,6,2,8,0.75
vs. BCS AQ,2011,Ohio,0,1,1,0.0
vs. BCS non-AQ,2011,Ohio,9,3,12,0.75
vs. FBS Power 5,2011,Ohio,0,0,0,
vs. FBS non-Power 5,2011,Ohio,9,4,13,0.6923076923076923
in August/September,2011,Ohio,3,1,4,0.75
in October,2011,Ohio,2,2,4,0.5
in November,2011,Ohio,4,0,4,1.0
in December/January,2011,Ohio,1,1,2,0.5
All Games,2012,Ohio,9,4,13,0.6923076923076923
at Home,2012,Ohio,5,1,6,0.8333333333333334
on Road/Neutral Site,2012,Ohio,4,3,7,0.5714285714285714
vs. Conference,2012,Ohio,4,4,8,0.5
vs. Non-Conference,2012,Ohio,5,0,5,1.0
vs. Ranked (AP),2012,Ohio,0,0,0,
vs. Unranked (AP),2012,Ohio,9,4,13,0.6923076923076923
vs. FBS (I-A),2012,Ohio,8,4,12,0.6666666666666666
vs. FCS (I-AA),2012,Ohio,1,0,1,1.0
vs. FBS Winning,2012,Ohio,2,3,5,0.4
vs. FBS Non-Winning,2012,Ohio,6,1,7,0.8571428571428571
vs. BCS AQ,2012,Ohio,1,0,1,1.0
vs. BCS non-AQ,2012,Ohio,7,4,11,0.6363636363636364
vs. FBS Power 5,2012,Ohio,1,0,1,1.0
vs. FBS non-Power 5,2012,Ohio,7,4,11,0.6363636363636364
in August/September,2012,Ohio,5,0,5,1.0
in October,2012,Ohio,2,1,3,0.6666666666666666
in November,2012,Ohio,1,3,4,0.25
in December/January,2012,Ohio,1,0,1,1.0
All Games,2013,Ohio,7,6,13,0.5384615384615384
at Home,2013,Ohio,5,2,7,0.7142857142857143
on Road/Neutral Site,2013,Ohio,2,4,6,0.3333333333333333
vs. Conference,2013,Ohio,4,4,8,0.5
vs. Non-Conference,2013,Ohio,3,2,5,0.6
vs. Ranked (AP),2013,Ohio,0,1,1,0.0
vs. Unranked (AP),2013,Ohio,7,5,12,0.5833333333333334
vs. FBS (I-A),2013,Ohio,6,6,12,0.5
vs. FCS (I-AA),2013,Ohio,1,0,1,1.0
vs. FBS Winning,2013,Ohio,2,4,6,0.3333333333333333
vs. FBS Non-Winning,2013,Ohio,4,2,6,0.6666666666666666
vs. BCS AQ,2013,Ohio,0,1,1,0.0
vs. BCS non-AQ,2013,Ohio,6,5,11,0.5454545454545454
vs. FBS Power 5,2013,Ohio,0,0,0,
vs. FBS non-Power 5,2013,Ohio,6,6,12,0.5
in August/September,2013,Ohio,3,1,4,0.75
in October,2013,Ohio,3,1,4,0.75
in November,2013,Ohio,1,3,4,0.25
in December/January,2013,Ohio,0,1,1,0.0
All Games,2014,Ohio,6,6,12,0.5
at Home,2014,Ohio,4,2,6,0.6666666666666666
on Road/Neutral Site,2014,Ohio,2,4,6,0.3333333333333333
vs. Conference,2014,Ohio,4,4,8,0.5
vs. Non-Conference,2014,Ohio,2,2,4,0.5
vs. Ranked (AP),2014,Ohio,0,1,1,0.0
vs. Unranked (AP),2014,Ohio,6,5,11,0.5454545454545454
vs. FBS (I-A),2014,Ohio,5,6,11,0.45454545454545453
vs. FCS (I-AA),2014,Ohio,1,0,1,1.0
vs. FBS Winning,2014,Ohio,0,5,5,0.0
vs. FBS Non-Winning,2014,Ohio,5,1,6,0.8333333333333334
vs. BCS AQ,2014,Ohio,0,1,1,0.0
vs. BCS non-AQ,2014,Ohio,5,5,10,0.5
vs. FBS Power 5,2014,Ohio,0,1,1,0.0
vs. FBS non-Power 5,2014,Ohio,5,5,10,0.5
in August/September,2014,Ohio,3,2,5,0.6
in October,2014,Ohio,1,3,4,0.25
in November,2014,Ohio,2,1,3,0.6666666666666666
in December/January,2014,Ohio,0,0,0,
All Games,2015,Ohio,8,5,13,0.6153846153846154
at Home,2015,Ohio,5,1,6,0.8333333333333334
on Road/Neutral Site,2015,Ohio,3,4,7,0.42857142857142855
vs. Conference,2015,Ohio,5,3,8,0.625
vs. Non-Conference,2015,Ohio,3,2,5,0.6
vs. Ranked (AP),2015,Ohio,0,0,0,
vs. Unranked (AP),2015,Ohio,8,5,13,0.6153846153846154
vs. FBS (I-A),2015,Ohio,7,5,12,0.5833333333333334
vs. FCS (I-AA),2015,Ohio,1,0,1,1.0
vs. FBS Winning,2015,Ohio,3,3,6,0.5
vs. FBS Non-Winning,2015,Ohio,4,2,6,0.6666666666666666
vs. BCS AQ,2015,Ohio,0,1,1,0.0
vs. BCS non-AQ,2015,Ohio,7,4,11,0.6363636363636364
vs. FBS Power 5,2015,Ohio,0,1,1,0.0
vs. FBS non-Power 5,2015,Ohio,7,4,11,0.6363636363636364
in August/September,2015,Ohio,3,1,4,0.75
in October,2015,Ohio,2,2,4,0.5
in November,2015,Ohio,3,1,4,0.75
in December/January,2015,Ohio,0,1,1,0.0
All Games,2016,Ohio,8,6,14,0.5714285714285714
at Home,2016,Ohio,4,2,6,0.6666666666666666
on Road/Neutral Site,2016,Ohio,4,4,8,0.5
vs. Conference,2016,Ohio,6,3,9,0.6666666666666666
vs. Non-Conference,2016,Ohio,2,3,5,0.4
vs. Ranked (AP),2016,Ohio,0,1,1,0.0
vs. Unranked (AP),2016,Ohio,8,5,13,0.6153846153846154
vs. FBS (I-A),2016,Ohio,7,6,13,0.5384615384615384
vs. FCS (I-AA),2016,Ohio,1,0,1,1.0
vs. FBS Winning,2016,Ohio,1,4,5,0.2
vs. FBS Non-Winning,2016,Ohio,6,2,8,0.75
vs. BCS AQ,2016,Ohio,1,1,2,0.5
vs. BCS non-AQ,2016,Ohio,6,5,11,0.5454545454545454
vs. FBS Power 5,2016,Ohio,1,1,2,0.5
vs. FBS non-Power 5,2016,Ohio,6,5,11,0.5454545454545454
in August/September,2016,Ohio,2,2,4,0.5
in October,2016,Ohio,4,1,5,0.8
in November,2016,Ohio,2,1,3,0.6666666666666666
in December/January,2016,Ohio,0,2,2,0.0
All Games,2017,Ohio,9,4,13,0.6923076923076923
at Home,2017,Ohio,5,1,6,0.8333333333333334
on Road/Neutral Site,2017,Ohio,4,3,7,0.5714285714285714
vs. Conference,2017,Ohio,5,3,8,0.625
vs. Non-Conference,2017,Ohio,4,1,5,0.8
vs. Ranked (AP),2017,Ohio,0,0,0,
vs. Unranked (AP),2017,Ohio,9,4,13,0.6923076923076923
vs. FBS (I-A),2017,Ohio,8,4,12,0.6666666666666666
vs. FCS (I-AA),2017,Ohio,1,0,1,1.0
vs. FBS Winning,2017,Ohio,2,2,4,0.5
vs. FBS Non-Winning,2017,Ohio,6,2,8,0.75
vs. BCS AQ,2017,Ohio,1,1,2,0.5
vs. BCS non-AQ,2017,Ohio,7,3,10,0.7
vs. FBS Power 5,2017,Ohio,1,1,2,0.5
vs. FBS non-Power 5,2017,Ohio,7,3,10,0.7
in August/September,2017,Ohio,4,1,5,0.8
in October,2017,Ohio,3,1,4,0.75
in November,2017,Ohio,1,2,3,0.3333333333333333
in December/January,2017,Ohio,1,0,1,1.0
All Games,2018,Ohio,9,4,13,0.6923076923076923
at Home,2018,Ohio,6,0,6,1.0
on Road/Neutral Site,2018,Ohio,3,4,7,0.42857142857142855
vs. Conference,2018,Ohio,6,2,8,0.75
vs. Non-Conference,2018,Ohio,3,2,5,0.6
vs. Ranked (AP),2018,Ohio,0,1,1,0.0
vs. Unranked (AP),2018,Ohio,9,3,12,0.75
vs. FBS (I-A),2018,Ohio,8,4,12,0.6666666666666666
vs. FCS (I-AA),2018,Ohio,1,0,1,1.0
vs. FBS Winning,2018,Ohio,3,3,6,0.5
vs. FBS Non-Winning,2018,Ohio,5,1,6,0.8333333333333334
vs. BCS AQ,2018,Ohio,0,2,2,0.0
vs. BCS non-AQ,2018,Ohio,8,2,10,0.8
vs. FBS Power 5,2018,Ohio,0,1,1,0.0
vs. FBS non-Power 5,2018,Ohio,8,3,11,0.7272727272727273
in August/September,2018,Ohio,2,2,4,0.5
in October,2018,Ohio,3,1,4,0.75
in November,2018,Ohio,3,1,4,0.75
in December/January,2018,Ohio,1,0,1,1.0
All Games,2019,Ohio,7,6,13,0.5384615384615384
at Home,2019,Ohio,2,4,6,0.3333333333333333
on Road/Neutral Site,2019,Ohio,5,2,7,0.7142857142857143
vs. Conference,2019,Ohio,5,3,8,0.625
vs. Non-Conference,2019,Ohio,2,3,5,0.4
vs. Ranked (AP),2019,Ohio,0,0,0,
vs. Unranked (AP),2019,Ohio,7,6,13,0.5384615384615384
vs. FBS (I-A),2019,Ohio,6,6,12,0.5
vs. FCS (I-AA),2019,Ohio,1,0,1,1.0
vs. FBS Winning,2019,Ohio,3,5,8,0.375
vs. FBS Non-Winning,2019,Ohio,3,1,4,0.75
vs. BCS AQ,2019,Ohio,0,1,1,0.0
vs. BCS non-AQ,2019,Ohio,6,5,11,0.5454545454545454
vs. FBS Power 5,2019,Ohio,0,1,1,0.0
vs. FBS non-Power 5,2019,Ohio,6,5,11,0.5454545454545454
in August/September,2019,Ohio,1,3,4,0.25
in October,2019,Ohio,3,1,4,0.75
in November,2019,Ohio,2,2,4,0.5
in December/January,2019,Ohio,1,0,1,1.0
All Games,2020,Ohio,2,1,3,0.6666666666666666
at Home,2020,Ohio,2,0,2,1.0
on Road/Neutral Site,2020,Ohio,0,1,1,0.0
vs. Conference,2020,Ohio,2,1,3,0.6666666666666666
vs. Non-Conference,2020,Ohio,0,0,0,
vs. Ranked (AP),2020,Ohio,0,0,0,
vs. Unranked (AP),2020,Ohio,2,1,3,0.6666666666666666
vs. FBS (I-A),2020,Ohio,2,1,3,0.6666666666666666
vs. FCS (I-AA),2020,Ohio,0,0,0,
vs. FBS Winning,2020,Ohio,0,0,0,
vs. FBS Non-Winning,2020,Ohio,2,1,3,0.6666666666666666
vs. BCS AQ,2020,Ohio,0,0,0,
vs. BCS non-AQ,2020,Ohio,2,1,3,0.6666666666666666
vs. FBS Power 5,2020,Ohio,0,0,0,
vs. FBS non-Power 5,2020,Ohio,2,1,3,0.6666666666666666
in August/September,2020,Ohio,0,0,0,
in October,2020,Ohio,0,0,0,
in November,2020,Ohio,2,1,3,0.6666666666666666
in December/January,2020,Ohio,0,0,0,
All Games,2021,Ohio,3,9,12,0.25
at Home,2021,Ohio,1,5,6,0.16666666666666666
on Road/Neutral Site,2021,Ohio,2,4,6,0.3333333333333333
vs. Conference,2021,Ohio,3,5,8,0.375
vs. Non-Conference,2021,Ohio,0,4,4,0.0
vs. Ranked (AP),2021,Ohio,0,1,1,0.0
vs. Unranked (AP),2021,Ohio,3,8,11,0.2727272727272727
vs. FBS (I-A),2021,Ohio,3,8,11,0.2727272727272727
vs. FCS (I-AA),2021,Ohio,0,1,1,0.0
vs. FBS Winning,2021,Ohio,2,3,5,0.4
vs. FBS Non-Winning,2021,Ohio,1,5,6,0.16666666666666666
vs. BCS AQ,2021,Ohio,0,2,2,0.0
vs. BCS non-AQ,2021,Ohio,3,6,9,0.3333333333333333
vs. FBS Power 5,2021,Ohio,0,2,2,0.0
vs. FBS non-Power 5,2021,Ohio,3,6,9,0.3333333333333333
in August/September,2021,Ohio,0,4,4,0.0
in October,2021,Ohio,1,3,4,0.25
in November,2021,Ohio,2,2,4,0.5
in December/January,2021,Ohio,0,0,0,
All Games,2022,Ohio,10,4,14,0.7142857142857143
at Home,2022,Ohio,6,0,6,1.0
on Road/Neutral Site,2022,Ohio,4,4,8,0.5
vs. Conference,2022,Ohio,7,2,9,0.7777777777777778
vs. Non-Conference,2022,Ohio,3,2,5,0.6
vs. Ranked (AP),2022,Ohio,0,1,1,0.0
vs. Unranked (AP),2022,Ohio,10,3,13,0.7692307692307693
vs. FBS (I-A),2022,Ohio,9,4,13,0.6923076923076923
vs. FCS (I-AA),2022,Ohio,1,0,1,1.0
vs. FBS Winning,2022,Ohio,2,2,4,0.5
vs. FBS Non-Winning,2022,Ohio,7,2,9,0.7777777777777778
vs. BCS AQ,2022,Ohio,0,2,2,0.0
vs. BCS non-AQ,2022,Ohio,9,2,11,0.8181818181818182
vs. FBS Power 5,2022,Ohio,0,2,2,0.0
vs. FBS non-Power 5,2022,Ohio,9,2,11,0.8181818181818182
in August/September,2022,Ohio,2,2,4,0.5
in October,2022,Ohio,3,1,4,0.75
in November,2022,Ohio,4,0,4,1.0
in December/January,2022,Ohio,1,1,2,0.5
All Games,2009,Ohio State,11,2,13,0.8461538461538461
at Home,2009,Ohio State,6,1,7,0.8571428571428571
on Road/Neutral Site,2009,Ohio State,5,1,6,0.8333333333333334
vs. Conference,2009,Ohio State,7,1,8,0.875
vs. Non-Conference,2009,Ohio State,4,1,5,0.8
vs. Ranked (AP),2009,Ohio State,4,1,5,0.8
vs. Unranked (AP),2009,Ohio State,7,1,8,0.875
vs. FBS (I-A),2009,Ohio State,11,2,13,0.8461538461538461
vs. FCS (I-AA),2009,Ohio State,0,0,0,
vs. FBS Winning,2009,Ohio State,5,1,6,0.8333333333333334
vs. FBS Non-Winning,2009,Ohio State,6,1,7,0.8571428571428571
vs. BCS AQ,2009,Ohio State,8,2,10,0.8
vs. BCS non-AQ,2009,Ohio State,3,0,3,1.0
vs. FBS Power 5,2009,Ohio State,8,2,10,0.8
vs. FBS non-Power 5,2009,Ohio State,3,0,3,1.0
in August/September,2009,Ohio State,3,1,4,0.75
in October,2009,Ohio State,4,1,5,0.8
in November,2009,Ohio State,3,0,3,1.0
in December/January,2009,Ohio State,1,0,1,1.0
All Games,2010,Ohio State,12,1,13,0.9230769230769231
at Home,2010,Ohio State,8,0,8,1.0
on Road/Neutral Site,2010,Ohio State,4,1,5,0.8
vs. Conference,2010,Ohio State,7,1,8,0.875
vs. Non-Conference,2010,Ohio State,5,0,5,1.0
vs. Ranked (AP),2010,Ohio State,1,1,2,0.5
vs. Unranked (AP),2010,Ohio State,11,0,11,1.0
vs. FBS (I-A),2010,Ohio State,12,1,13,0.9230769230769231
vs. FCS (I-AA),2010,Ohio State,0,0,0,
vs. FBS Winning,2010,Ohio State,7,1,8,0.875
vs. FBS Non-Winning,2010,Ohio State,5,0,5,1.0
vs. BCS AQ,2010,Ohio State,9,1,10,0.9
vs. BCS non-AQ,2010,Ohio State,3,0,3,1.0
vs. FBS Power 5,2010,Ohio State,9,1,10,0.9
vs. FBS non-Power 5,2010,Ohio State,3,0,3,1.0
in August/September,2010,Ohio State,4,0,4,1.0
in October,2010,Ohio State,4,1,5,0.8
in November,2010,Ohio State,3,0,3,1.0
in December/January,2010,Ohio State,1,0,1,1.0
All Games,2011,Ohio State,6,7,13,0.46153846153846156
at Home,2011,Ohio State,5,2,7,0.7142857142857143
on Road/Neutral Site,2011,Ohio State,1,5,6,0.16666666666666666
vs. Conference,2011,Ohio State,3,5,8,0.375
vs. Non-Conference,2011,Ohio State,3,2,5,0.6
vs. Ranked (AP),2011,Ohio State,1,3,4,0.25
vs. Unranked (AP),2011,Ohio State,5,4,9,0.5555555555555556
vs. FBS (I-A),2011,Ohio State,6,7,13,0.46153846153846156
vs. FCS (I-AA),2011,Ohio State,0,0,0,
vs. FBS Winning,2011,Ohio State,3,6,9,0.3333333333333333
vs. FBS Non-Winning,2011,Ohio State,3,1,4,0.75
vs. BCS AQ,2011,Ohio State,4,7,11,0.36363636363636365
vs. BCS non-AQ,2011,Ohio State,2,0,2,1.0
vs. FBS Power 5,2011,Ohio State,4,7,11,0.36363636363636365
vs. FBS non-Power 5,2011,Ohio State,2,0,2,1.0
in August/September,2011,Ohio State,3,1,4,0.75
in October,2011,Ohio State,2,2,4,0.5
in November,2011,Ohio State,1,3,4,0.25
in December/January,2011,Ohio State,0,1,1,0.0
All Games,2012,Ohio State,12,0,12,1.0
at Home,2012,Ohio State,8,0,8,1.0
on Road/Neutral Site,2012,Ohio State,4,0,4,1.0
vs. Conference,2012,Ohio State,8,0,8,1.0
vs. Non-Conference,2012,Ohio State,4,0,4,1.0
vs. Ranked (AP),2012,Ohio State,2,0,2,1.0
vs. Unranked (AP),2012,Ohio State,10,0,10,1.0
vs. FBS (I-A),2012,Ohio State,12,0,12,1.0
vs. FCS (I-AA),2012,Ohio State,0,0,0,
vs. FBS Winning,2012,Ohio State,6,0,6,1.0
vs. FBS Non-Winning,2012,Ohio State,6,0,6,1.0
vs. BCS AQ,2012,Ohio State,9,0,9,1.0
vs. BCS non-AQ,2012,Ohio State,3,0,3,1.0
vs. FBS Power 5,2012,Ohio State,9,0,9,1.0
vs. FBS non-Power 5,2012,Ohio State,3,0,3,1.0
in August/September,2012,Ohio State,5,0,5,1.0
in October,2012,Ohio State,4,0,4,1.0
in November,2012,Ohio State,3,0,3,1.0
in December/January,2012,Ohio State,0,0,0,
All Games,2013,Ohio State,12,2,14,0.8571428571428571
at Home,2013,Ohio State,7,0,7,1.0
on Road/Neutral Site,2013,Ohio State,5,2,7,0.7142857142857143
vs. Conference,2013,Ohio State,8,1,9,0.8888888888888888
vs. Non-Conference,2013,Ohio State,4,1,5,0.8
vs. Ranked (AP),2013,Ohio State,1,2,3,0.3333333333333333
vs. Unranked (AP),2013,Ohio State,11,0,11,1.0
vs. FBS (I-A),2013,Ohio State,11,2,13,0.8461538461538461
vs. FCS (I-AA),2013,Ohio State,1,0,1,1.0
vs. FBS Winning,2013,Ohio State,6,2,8,0.75
vs. FBS Non-Winning,2013,Ohio State,5,0,5,1.0
vs. BCS AQ,2013,Ohio State,9,2,11,0.8181818181818182
vs. BCS non-AQ,2013,Ohio State,2,0,2,1.0
vs. FBS Power 5,2013,Ohio State,9,2,11,0.8181818181818182
vs. FBS non-Power 5,2013,Ohio State,2,0,2,1.0
in August/September,2013,Ohio State,5,0,5,1.0
in October,2013,Ohio State,3,0,3,1.0
in November,2013,Ohio State,4,0,4,1.0
in December/January,2013,Ohio State,0,2,2,0.0
All Games,2014,Ohio State,14,1,15,0.9333333333333333
at Home,2014,Ohio State,6,1,7,0.8571428571428571
on Road/Neutral Site,2014,Ohio State,8,0,8,1.0
vs. Conference,2014,Ohio State,9,0,9,1.0
vs. Non-Conference,2014,Ohio State,5,1,6,0.8333333333333334
vs. Ranked (AP),2014,Ohio State,4,0,4,1.0
vs. Unranked (AP),2014,Ohio State,10,1,11,0.9090909090909091
vs. FBS (I-A),2014,Ohio State,14,1,15,0.9333333333333333
vs. FCS (I-AA),2014,Ohio State,0,0,0,
vs. FBS Winning,2014,Ohio State,10,1,11,0.9090909090909091
vs. FBS Non-Winning,2014,Ohio State,4,0,4,1.0
vs. BCS AQ,2014,Ohio State,12,1,13,0.9230769230769231
vs. BCS non-AQ,2014,Ohio State,2,0,2,1.0
vs. FBS Power 5,2014,Ohio State,11,1,12,0.9166666666666666
vs. FBS non-Power 5,2014,Ohio State,3,0,3,1.0
in August/September,2014,Ohio State,3,1,4,0.75
in October,2014,Ohio State,3,0,3,1.0
in November,2014,Ohio State,5,0,5,1.0
in December/January,2014,Ohio State,3,0,3,1.0
All Games,2015,Ohio State,12,1,13,0.9230769230769231
at Home,2015,Ohio State,6,1,7,0.8571428571428571
on Road/Neutral Site,2015,Ohio State,6,0,6,1.0
vs. Conference,2015,Ohio State,7,1,8,0.875
vs. Non-Conference,2015,Ohio State,5,0,5,1.0
vs. Ranked (AP),2015,Ohio State,2,1,3,0.6666666666666666
vs. Unranked (AP),2015,Ohio State,10,0,10,1.0
vs. FBS (I-A),2015,Ohio State,12,1,13,0.9230769230769231
vs. FCS (I-AA),2015,Ohio State,0,0,0,
vs. FBS Winning,2015,Ohio State,6,1,7,0.8571428571428571
vs. FBS Non-Winning,2015,Ohio State,6,0,6,1.0
vs. BCS AQ,2015,Ohio State,9,1,10,0.9
vs. BCS non-AQ,2015,Ohio State,3,0,3,1.0
vs. FBS Power 5,2015,Ohio State,8,1,9,0.8888888888888888
vs. FBS non-Power 5,2015,Ohio State,4,0,4,1.0
in August/September,2015,Ohio State,4,0,4,1.0
in October,2015,Ohio State,4,0,4,1.0
in November,2015,Ohio State,3,1,4,0.75
in December/January,2015,Ohio State,1,0,1,1.0
All Games,2016,Ohio State,11,2,13,0.8461538461538461
at Home,2016,Ohio State,7,0,7,1.0
on Road/Neutral Site,2016,Ohio State,4,2,6,0.6666666666666666
vs. Conference,2016,Ohio State,8,1,9,0.8888888888888888
vs. Non-Conference,2016,Ohio State,3,1,4,0.75
vs. Ranked (AP),2016,Ohio State,4,2,6,0.6666666666666666
vs. Unranked (AP),2016,Ohio State,7,0,7,1.0
vs. FBS (I-A),2016,Ohio State,11,2,13,0.8461538461538461
vs. FCS (I-AA),2016,Ohio State,0,0,0,
vs. FBS Winning,2016,Ohio State,6,2,8,0.75
vs. FBS Non-Winning,2016,Ohio State,5,0,5,1.0
vs. BCS AQ,2016,Ohio State,10,2,12,0.8333333333333334
vs. BCS non-AQ,2016,Ohio State,1,0,1,1.0
vs. FBS Power 5,2016,Ohio State,9,2,11,0.8181818181818182
vs. FBS non-Power 5,2016,Ohio State,2,0,2,1.0
in August/September,2016,Ohio State,3,0,3,1.0
in October,2016,Ohio State,4,1,5,0.8
in November,2016,Ohio State,4,0,4,1.0
in December/January,2016,Ohio State,0,1,1,0.0
All Games,2017,Ohio State,12,2,14,0.8571428571428571
at Home,2017,Ohio State,6,1,7,0.8571428571428571
on Road/Neutral Site,2017,Ohio State,6,1,7,0.8571428571428571
vs. Conference,2017,Ohio State,9,1,10,0.9
vs. Non-Conference,2017,Ohio State,3,1,4,0.75
vs. Ranked (AP),2017,Ohio State,4,1,5,0.8
vs. Unranked (AP),2017,Ohio State,8,1,9,0.8888888888888888
vs. FBS (I-A),2017,Ohio State,12,2,14,0.8571428571428571
vs. FCS (I-AA),2017,Ohio State,0,0,0,
vs. FBS Winning,2017,Ohio State,6,2,8,0.75
vs. FBS Non-Winning,2017,Ohio State,6,0,6,1.0
vs. BCS AQ,2017,Ohio State,10,2,12,0.8333333333333334
vs. BCS non-AQ,2017,Ohio State,2,0,2,1.0
vs. FBS Power 5,2017,Ohio State,10,2,12,0.8333333333333334
vs. FBS non-Power 5,2017,Ohio State,2,0,2,1.0
in August/September,2017,Ohio State,4,1,5,0.8
in October,2017,Ohio State,3,0,3,1.0
in November,2017,Ohio State,3,1,4,0.75
in December/January,2017,Ohio State,2,0,2,1.0
All Games,2018,Ohio State,13,1,14,0.9285714285714286
at Home,2018,Ohio State,7,0,7,1.0
on Road/Neutral Site,2018,Ohio State,6,1,7,0.8571428571428571
vs. Conference,2018,Ohio State,9,1,10,0.9
vs. Non-Conference,2018,Ohio State,4,0,4,1.0
vs. Ranked (AP),2018,Ohio State,4,0,4,1.0
vs. Unranked (AP),2018,Ohio State,9,1,10,0.9
vs. FBS (I-A),2018,Ohio State,13,1,14,0.9285714285714286
vs. FCS (I-AA),2018,Ohio State,0,0,0,
vs. FBS Winning,2018,Ohio State,8,0,8,1.0
vs. FBS Non-Winning,2018,Ohio State,5,1,6,0.8333333333333334
vs. BCS AQ,2018,Ohio State,13,1,14,0.9285714285714286
vs. BCS non-AQ,2018,Ohio State,0,0,0,
vs. FBS Power 5,2018,Ohio State,12,1,13,0.9230769230769231
vs. FBS non-Power 5,2018,Ohio State,1,0,1,1.0
in August/September,2018,Ohio State,5,0,5,1.0
in October,2018,Ohio State,2,1,3,0.6666666666666666
in November,2018,Ohio State,4,0,4,1.0
in December/January,2018,Ohio State,2,0,2,1.0
All Games,2019,Ohio State,13,1,14,0.9285714285714286
at Home,2019,Ohio State,7,0,7,1.0
on Road/Neutral Site,2019,Ohio State,6,1,7,0.8571428571428571
vs. Conference,2019,Ohio State,10,0,10,1.0
vs. Non-Conference,2019,Ohio State,3,1,4,0.75
vs. Ranked (AP),2019,Ohio State,5,1,6,0.8333333333333334
vs. Unranked (AP),2019,Ohio State,8,0,8,1.0
vs. FBS (I-A),2019,Ohio State,13,1,14,0.9285714285714286
vs. FCS (I-AA),2019,Ohio State,0,0,0,
vs. FBS Winning,2019,Ohio State,9,1,10,0.9
vs. FBS Non-Winning,2019,Ohio State,4,0,4,1.0
vs. BCS AQ,2019,Ohio State,11,1,12,0.9166666666666666
vs. BCS non-AQ,2019,Ohio State,2,0,2,1.0
vs. FBS Power 5,2019,Ohio State,10,1,11,0.9090909090909091
vs. FBS non-Power 5,2019,Ohio State,3,0,3,1.0
in August/September,2019,Ohio State,5,0,5,1.0
in October,2019,Ohio State,3,0,3,1.0
in November,2019,Ohio State,4,0,4,1.0
in December/January,2019,Ohio State,1,1,2,0.5
All Games,2020,Ohio State,7,1,8,0.875
at Home,2020,Ohio State,3,0,3,1.0
on Road/Neutral Site,2020,Ohio State,4,1,5,0.8
vs. Conference,2020,Ohio State,6,0,6,1.0
vs. Non-Conference,2020,Ohio State,1,1,2,0.5
vs. Ranked (AP),2020,Ohio State,3,1,4,0.75
vs. Unranked (AP),2020,Ohio State,4,0,4,1.0
vs. FBS (I-A),2020,Ohio State,7,1,8,0.875
vs. FCS (I-AA),2020,Ohio State,0,0,0,
vs. FBS Winning,2020,Ohio State,3,1,4,0.75
vs. FBS Non-Winning,2020,Ohio State,4,0,4,1.0
vs. BCS AQ,2020,Ohio State,7,1,8,0.875
vs. BCS non-AQ,2020,Ohio State,0,0,0,
vs. FBS Power 5,2020,Ohio State,7,1,8,0.875
vs. FBS non-Power 5,2020,Ohio State,0,0,0,
in August/September,2020,Ohio State,0,0,0,
in October,2020,Ohio State,2,0,2,1.0
in November,2020,Ohio State,2,0,2,1.0
in December/January,2020,Ohio State,3,1,4,0.75
All Games,2021,Ohio State,11,2,13,0.8461538461538461
at Home,2021,Ohio State,6,1,7,0.8571428571428571
on Road/Neutral Site,2021,Ohio State,5,1,6,0.8333333333333334
vs. Conference,2021,Ohio State,8,1,9,0.8888888888888888
vs. Non-Conference,2021,Ohio State,3,1,4,0.75
vs. Ranked (AP),2021,Ohio State,2,2,4,0.5
vs. Unranked (AP),2021,Ohio State,9,0,9,1.0
vs. FBS (I-A),2021,Ohio State,11,2,13,0.8461538461538461
vs. FCS (I-AA),2021,Ohio State,0,0,0,
vs. FBS Winning,2021,Ohio State,7,2,9,0.7777777777777778
vs. FBS Non-Winning,2021,Ohio State,4,0,4,1.0
vs. BCS AQ,2021,Ohio State,10,2,12,0.8333333333333334
vs. BCS non-AQ,2021,Ohio State,1,0,1,1.0
vs. FBS Power 5,2021,Ohio State,9,2,11,0.8181818181818182
vs. FBS non-Power 5,2021,Ohio State,2,0,2,1.0
in August/September,2021,Ohio State,3,1,4,0.75
in October,2021,Ohio State,4,0,4,1.0
in November,2021,Ohio State,3,1,4,0.75
in December/January,2021,Ohio State,1,0,1,1.0
All Games,2022,Ohio State,11,2,13,0.8461538461538461
at Home,2022,Ohio State,7,1,8,0.875
on Road/Neutral Site,2022,Ohio State,4,1,5,0.8
vs. Conference,2022,Ohio State,8,1,9,0.8888888888888888
vs. Non-Conference,2022,Ohio State,3,1,4,0.75
vs. Ranked (AP),2022,Ohio State,2,2,4,0.5
vs. Unranked (AP),2022,Ohio State,9,0,9,1.0
vs. FBS (I-A),2022,Ohio State,11,2,13,0.8461538461538461
vs. FCS (I-AA),2022,Ohio State,0,0,0,
vs. FBS Winning,2022,Ohio State,6,2,8,0.75
vs. FBS Non-Winning,2022,Ohio State,5,0,5,1.0
vs. BCS AQ,2022,Ohio State,9,2,11,0.8181818181818182
vs. BCS non-AQ,2022,Ohio State,2,0,2,1.0
vs. FBS Power 5,2022,Ohio State,8,2,10,0.8
vs. FBS non-Power 5,2022,Ohio State,3,0,3,1.0
in August/September,2022,Ohio State,4,0,4,1.0
in October,2022,Ohio State,4,0,4,1.0
in November,2022,Ohio State,3,1,4,0.75
in December/January,2022,Ohio State,0,1,1,0.0
All Games,2009,Oklahoma,8,5,13,0.6153846153846154
at Home,2009,Oklahoma,6,0,6,1.0
on Road/Neutral Site,2009,Oklahoma,2,5,7,0.2857142857142857
vs. Conference,2009,Oklahoma,5,3,8,0.625
vs. Non-Conference,2009,Oklahoma,3,2,5,0.6
vs. Ranked (AP),2009,Oklahoma,0,5,5,0.0
vs. Unranked (AP),2009,Oklahoma,8,0,8,1.0
vs. FBS (I-A),2009,Oklahoma,7,5,12,0.5833333333333334
vs. FCS (I-AA),2009,Oklahoma,1,0,1,1.0
vs. FBS Winning,2009,Oklahoma,2,5,7,0.2857142857142857
vs. FBS Non-Winning,2009,Oklahoma,5,0,5,1.0
vs. BCS AQ,2009,Oklahoma,6,4,10,0.6
vs. BCS non-AQ,2009,Oklahoma,1,1,2,0.5
vs. FBS Power 5,2009,Oklahoma,6,4,10,0.6
vs. FBS non-Power 5,2009,Oklahoma,1,1,2,0.5
in August/September,2009,Oklahoma,2,1,3,0.6666666666666666
in October,2009,Oklahoma,3,2,5,0.6
in November,2009,Oklahoma,2,2,4,0.5
in December/January,2009,Oklahoma,1,0,1,1.0
All Games,2010,Oklahoma,12,2,14,0.8571428571428571
at Home,2010,Oklahoma,6,0,6,1.0
on Road/Neutral Site,2010,Oklahoma,6,2,8,0.75
vs. Conference,2010,Oklahoma,7,2,9,0.7777777777777778
vs. Non-Conference,2010,Oklahoma,5,0,5,1.0
vs. Ranked (AP),2010,Oklahoma,3,2,5,0.6
vs. Unranked (AP),2010,Oklahoma,9,0,9,1.0
vs. FBS (I-A),2010,Oklahoma,12,2,14,0.8571428571428571
vs. FCS (I-AA),2010,Oklahoma,0,0,0,
vs. FBS Winning,2010,Oklahoma,7,2,9,0.7777777777777778
vs. FBS Non-Winning,2010,Oklahoma,5,0,5,1.0
vs. BCS AQ,2010,Oklahoma,10,2,12,0.8333333333333334
vs. BCS non-AQ,2010,Oklahoma,2,0,2,1.0
vs. FBS Power 5,2010,Oklahoma,8,2,10,0.8
vs. FBS non-Power 5,2010,Oklahoma,4,0,4,1.0
in August/September,2010,Oklahoma,4,0,4,1.0
in October,2010,Oklahoma,3,1,4,0.75
in November,2010,Oklahoma,3,1,4,0.75
in December/January,2010,Oklahoma,2,0,2,1.0
All Games,2011,Oklahoma,10,3,13,0.7692307692307693
at Home,2011,Oklahoma,5,1,6,0.8333333333333334
on Road/Neutral Site,2011,Oklahoma,5,2,7,0.7142857142857143
vs. Conference,2011,Oklahoma,6,3,9,0.6666666666666666
vs. Non-Conference,2011,Oklahoma,4,0,4,1.0
vs. Ranked (AP),2011,Oklahoma,2,2,4,0.5
vs. Unranked (AP),2011,Oklahoma,8,1,9,0.8888888888888888
vs. FBS (I-A),2011,Oklahoma,10,3,13,0.7692307692307693
vs. FCS (I-AA),2011,Oklahoma,0,0,0,
vs. FBS Winning,2011,Oklahoma,7,2,9,0.7777777777777778
vs. FBS Non-Winning,2011,Oklahoma,3,1,4,0.75
vs. BCS AQ,2011,Oklahoma,8,3,11,0.7272727272727273
vs. BCS non-AQ,2011,Oklahoma,2,0,2,1.0
vs. FBS Power 5,2011,Oklahoma,8,3,11,0.7272727272727273
vs. FBS non-Power 5,2011,Oklahoma,2,0,2,1.0
in August/September,2011,Oklahoma,3,0,3,1.0
in October,2011,Oklahoma,4,1,5,0.8
in November,2011,Oklahoma,2,1,3,0.6666666666666666
in December/January,2011,Oklahoma,1,1,2,0.5
All Games,2012,Oklahoma,10,3,13,0.7692307692307693
at Home,2012,Oklahoma,4,2,6,0.6666666666666666
on Road/Neutral Site,2012,Oklahoma,6,1,7,0.8571428571428571
vs. Conference,2012,Oklahoma,8,1,9,0.8888888888888888
vs. Non-Conference,2012,Oklahoma,2,2,4,0.5
vs. Ranked (AP),2012,Oklahoma,1,3,4,0.25
vs. Unranked (AP),2012,Oklahoma,9,0,9,1.0
vs. FBS (I-A),2012,Oklahoma,9,3,12,0.75
vs. FCS (I-AA),2012,Oklahoma,1,0,1,1.0
vs. FBS Winning,2012,Oklahoma,6,3,9,0.6666666666666666
vs. FBS Non-Winning,2012,Oklahoma,3,0,3,1.0
vs. BCS AQ,2012,Oklahoma,8,3,11,0.7272727272727273
vs. BCS non-AQ,2012,Oklahoma,1,0,1,1.0
vs. FBS Power 5,2012,Oklahoma,8,2,10,0.8
vs. FBS non-Power 5,2012,Oklahoma,1,1,2,0.5
in August/September,2012,Oklahoma,2,1,3,0.6666666666666666
in October,2012,Oklahoma,3,1,4,0.75
in November,2012,Oklahoma,4,0,4,1.0
in December/January,2012,Oklahoma,1,1,2,0.5
All Games,2013,Oklahoma,11,2,13,0.8461538461538461
at Home,2013,Oklahoma,6,0,6,1.0
on Road/Neutral Site,2013,Oklahoma,5,2,7,0.7142857142857143
vs. Conference,2013,Oklahoma,7,2,9,0.7777777777777778
vs. Non-Conference,2013,Oklahoma,4,0,4,1.0
vs. Ranked (AP),2013,Oklahoma,3,1,4,0.75
vs. Unranked (AP),2013,Oklahoma,8,1,9,0.8888888888888888
vs. FBS (I-A),2013,Oklahoma,11,2,13,0.8461538461538461
vs. FCS (I-AA),2013,Oklahoma,0,0,0,
vs. FBS Winning,2013,Oklahoma,5,2,7,0.7142857142857143
vs. FBS Non-Winning,2013,Oklahoma,6,0,6,1.0
vs. BCS AQ,2013,Oklahoma,9,2,11,0.8181818181818182
vs. BCS non-AQ,2013,Oklahoma,2,0,2,1.0
vs. FBS Power 5,2013,Oklahoma,8,2,10,0.8
vs. FBS non-Power 5,2013,Oklahoma,3,0,3,1.0
in August/September,2013,Oklahoma,4,0,4,1.0
in October,2013,Oklahoma,3,1,4,0.75
in November,2013,Oklahoma,2,1,3,0.6666666666666666
in December/January,2013,Oklahoma,2,0,2,1.0
All Games,2014,Oklahoma,8,5,13,0.6153846153846154
at Home,2014,Oklahoma,3,3,6,0.5
on Road/Neutral Site,2014,Oklahoma,5,2,7,0.7142857142857143
vs. Conference,2014,Oklahoma,5,4,9,0.5555555555555556
vs. Non-Conference,2014,Oklahoma,3,1,4,0.75
vs. Ranked (AP),2014,Oklahoma,0,4,4,0.0
vs. Unranked (AP),2014,Oklahoma,8,1,9,0.8888888888888888
vs. FBS (I-A),2014,Oklahoma,8,5,13,0.6153846153846154
vs. FCS (I-AA),2014,Oklahoma,0,0,0,
vs. FBS Winning,2014,Oklahoma,3,5,8,0.375
vs. FBS Non-Winning,2014,Oklahoma,5,0,5,1.0
vs. BCS AQ,2014,Oklahoma,7,5,12,0.5833333333333334
vs. BCS non-AQ,2014,Oklahoma,1,0,1,1.0
vs. FBS Power 5,2014,Oklahoma,6,5,11,0.5454545454545454
vs. FBS non-Power 5,2014,Oklahoma,2,0,2,1.0
in August/September,2014,Oklahoma,4,0,4,1.0
in October,2014,Oklahoma,1,2,3,0.3333333333333333
in November,2014,Oklahoma,3,1,4,0.75
in December/January,2014,Oklahoma,0,2,2,0.0
All Games,2015,Oklahoma,11,2,13,0.8461538461538461
at Home,2015,Oklahoma,6,0,6,1.0
on Road/Neutral Site,2015,Oklahoma,5,2,7,0.7142857142857143
vs. Conference,2015,Oklahoma,8,1,9,0.8888888888888888
vs. Non-Conference,2015,Oklahoma,3,1,4,0.75
vs. Ranked (AP),2015,Oklahoma,4,1,5,0.8
vs. Unranked (AP),2015,Oklahoma,7,1,8,0.875
vs. FBS (I-A),2015,Oklahoma,11,2,13,0.8461538461538461
vs. FCS (I-AA),2015,Oklahoma,0,0,0,
vs. FBS Winning,2015,Oklahoma,7,1,8,0.875
vs. FBS Non-Winning,2015,Oklahoma,4,1,5,0.8
vs. BCS AQ,2015,Oklahoma,10,2,12,0.8333333333333334
vs. BCS non-AQ,2015,Oklahoma,1,0,1,1.0
vs. FBS Power 5,2015,Oklahoma,9,2,11,0.8181818181818182
vs. FBS non-Power 5,2015,Oklahoma,2,0,2,1.0
in August/September,2015,Oklahoma,3,0,3,1.0
in October,2015,Oklahoma,4,1,5,0.8
in November,2015,Oklahoma,4,0,4,1.0
in December/January,2015,Oklahoma,0,1,1,0.0
All Games,2016,Oklahoma,11,2,13,0.8461538461538461
at Home,2016,Oklahoma,5,1,6,0.8333333333333334
on Road/Neutral Site,2016,Oklahoma,6,1,7,0.8571428571428571
vs. Conference,2016,Oklahoma,9,0,9,1.0
vs. Non-Conference,2016,Oklahoma,2,2,4,0.5
vs. Ranked (AP),2016,Oklahoma,3,1,4,0.75
vs. Unranked (AP),2016,Oklahoma,8,1,9,0.8888888888888888
vs. FBS (I-A),2016,Oklahoma,11,2,13,0.8461538461538461
vs. FCS (I-AA),2016,Oklahoma,0,0,0,
vs. FBS Winning,2016,Oklahoma,5,2,7,0.7142857142857143
vs. FBS Non-Winning,2016,Oklahoma,6,0,6,1.0
vs. BCS AQ,2016,Oklahoma,10,2,12,0.8333333333333334
vs. BCS non-AQ,2016,Oklahoma,1,0,1,1.0
vs. FBS Power 5,2016,Oklahoma,10,1,11,0.9090909090909091
vs. FBS non-Power 5,2016,Oklahoma,1,1,2,0.5
in August/September,2016,Oklahoma,1,2,3,0.3333333333333333
in October,2016,Oklahoma,5,0,5,1.0
in November,2016,Oklahoma,3,0,3,1.0
in December/January,2016,Oklahoma,2,0,2,1.0
All Games,2017,Oklahoma,12,2,14,0.8571428571428571
at Home,2017,Oklahoma,5,1,6,0.8333333333333334
on Road/Neutral Site,2017,Oklahoma,7,1,8,0.875
vs. Conference,2017,Oklahoma,9,1,10,0.9
vs. Non-Conference,2017,Oklahoma,3,1,4,0.75
vs. Ranked (AP),2017,Oklahoma,4,1,5,0.8
vs. Unranked (AP),2017,Oklahoma,8,1,9,0.8888888888888888
vs. FBS (I-A),2017,Oklahoma,12,2,14,0.8571428571428571
vs. FCS (I-AA),2017,Oklahoma,0,0,0,
vs. FBS Winning,2017,Oklahoma,7,2,9,0.7777777777777778
vs. FBS Non-Winning,2017,Oklahoma,5,0,5,1.0
vs. BCS AQ,2017,Oklahoma,11,2,13,0.8461538461538461
vs. BCS non-AQ,2017,Oklahoma,1,0,1,1.0
vs. FBS Power 5,2017,Oklahoma,10,2,12,0.8333333333333334
vs. FBS non-Power 5,2017,Oklahoma,2,0,2,1.0
in August/September,2017,Oklahoma,4,0,4,1.0
in October,2017,Oklahoma,3,1,4,0.75
in November,2017,Oklahoma,4,0,4,1.0
in December/January,2017,Oklahoma,1,1,2,0.5
All Games,2018,Oklahoma,12,2,14,0.8571428571428571
at Home,2018,Oklahoma,7,0,7,1.0
on Road/Neutral Site,2018,Oklahoma,5,2,7,0.7142857142857143
vs. Conference,2018,Oklahoma,9,1,10,0.9
vs. Non-Conference,2018,Oklahoma,3,1,4,0.75
vs. Ranked (AP),2018,Oklahoma,3,2,5,0.6
vs. Unranked (AP),2018,Oklahoma,9,0,9,1.0
vs. FBS (I-A),2018,Oklahoma,12,2,14,0.8571428571428571
vs. FCS (I-AA),2018,Oklahoma,0,0,0,
vs. FBS Winning,2018,Oklahoma,7,2,9,0.7777777777777778
vs. FBS Non-Winning,2018,Oklahoma,5,0,5,1.0
vs. BCS AQ,2018,Oklahoma,10,2,12,0.8333333333333334
vs. BCS non-AQ,2018,Oklahoma,2,0,2,1.0
vs. FBS Power 5,2018,Oklahoma,10,2,12,0.8333333333333334
vs. FBS non-Power 5,2018,Oklahoma,2,0,2,1.0
in August/September,2018,Oklahoma,5,0,5,1.0
in October,2018,Oklahoma,2,1,3,0.6666666666666666
in November,2018,Oklahoma,4,0,4,1.0
in December/January,2018,Oklahoma,1,1,2,0.5
All Games,2019,Oklahoma,12,2,14,0.8571428571428571
at Home,2019,Oklahoma,6,0,6,1.0
on Road/Neutral Site,2019,Oklahoma,6,2,8,0.75
vs. Conference,2019,Oklahoma,9,1,10,0.9
vs. Non-Conference,2019,Oklahoma,3,1,4,0.75
vs. Ranked (AP),2019,Oklahoma,3,1,4,0.75
vs. Unranked (AP),2019,Oklahoma,9,1,10,0.9
vs. FBS (I-A),2019,Oklahoma,11,2,13,0.8461538461538461
vs. FCS (I-AA),2019,Oklahoma,1,0,1,1.0
vs. FBS Winning,2019,Oklahoma,5,2,7,0.7142857142857143
vs. FBS Non-Winning,2019,Oklahoma,6,0,6,1.0
vs. BCS AQ,2019,Oklahoma,11,2,13,0.8461538461538461
vs. BCS non-AQ,2019,Oklahoma,0,0,0,
vs. FBS Power 5,2019,Oklahoma,10,2,12,0.8333333333333334
vs. FBS non-Power 5,2019,Oklahoma,1,0,1,1.0
in August/September,2019,Oklahoma,4,0,4,1.0
in October,2019,Oklahoma,3,1,4,0.75
in November,2019,Oklahoma,4,0,4,1.0
in December/January,2019,Oklahoma,1,1,2,0.5
All Games,2020,Oklahoma,9,2,11,0.8181818181818182
at Home,2020,Oklahoma,4,1,5,0.8
on Road/Neutral Site,2020,Oklahoma,5,1,6,0.8333333333333334
vs. Conference,2020,Oklahoma,7,2,9,0.7777777777777778
vs. Non-Conference,2020,Oklahoma,2,0,2,1.0
vs. Ranked (AP),2020,Oklahoma,3,1,4,0.75
vs. Unranked (AP),2020,Oklahoma,6,1,7,0.8571428571428571
vs. FBS (I-A),2020,Oklahoma,8,2,10,0.8
vs. FCS (I-AA),2020,Oklahoma,1,0,1,1.0
vs. FBS Winning,2020,Oklahoma,5,1,6,0.8333333333333334
vs. FBS Non-Winning,2020,Oklahoma,3,1,4,0.75
vs. BCS AQ,2020,Oklahoma,8,2,10,0.8
vs. BCS non-AQ,2020,Oklahoma,0,0,0,
vs. FBS Power 5,2020,Oklahoma,8,2,10,0.8
vs. FBS non-Power 5,2020,Oklahoma,0,0,0,
in August/September,2020,Oklahoma,1,1,2,0.5
in October,2020,Oklahoma,3,1,4,0.75
in November,2020,Oklahoma,2,0,2,1.0
in December/January,2020,Oklahoma,3,0,3,1.0
All Games,2021,Oklahoma,11,2,13,0.8461538461538461
at Home,2021,Oklahoma,7,0,7,1.0
on Road/Neutral Site,2021,Oklahoma,4,2,6,0.6666666666666666
vs. Conference,2021,Oklahoma,7,2,9,0.7777777777777778
vs. Non-Conference,2021,Oklahoma,4,0,4,1.0
vs. Ranked (AP),2021,Oklahoma,1,2,3,0.3333333333333333
vs. Unranked (AP),2021,Oklahoma,10,0,10,1.0
vs. FBS (I-A),2021,Oklahoma,10,2,12,0.8333333333333334
vs. FCS (I-AA),2021,Oklahoma,1,0,1,1.0
vs. FBS Winning,2021,Oklahoma,4,2,6,0.6666666666666666
vs. FBS Non-Winning,2021,Oklahoma,6,0,6,1.0
vs. BCS AQ,2021,Oklahoma,10,2,12,0.8333333333333334
vs. BCS non-AQ,2021,Oklahoma,0,0,0,
vs. FBS Power 5,2021,Oklahoma,9,2,11,0.8181818181818182
vs. FBS non-Power 5,2021,Oklahoma,1,0,1,1.0
in August/September,2021,Oklahoma,4,0,4,1.0
in October,2021,Oklahoma,5,0,5,1.0
in November,2021,Oklahoma,1,2,3,0.3333333333333333
in December/January,2021,Oklahoma,1,0,1,1.0
All Games,2022,Oklahoma,6,7,13,0.46153846153846156
at Home,2022,Oklahoma,4,2,6,0.6666666666666666
on Road/Neutral Site,2022,Oklahoma,2,5,7,0.2857142857142857
vs. Conference,2022,Oklahoma,3,6,9,0.3333333333333333
vs. Non-Conference,2022,Oklahoma,3,1,4,0.75
vs. Ranked (AP),2022,Oklahoma,0,4,4,0.0
vs. Unranked (AP),2022,Oklahoma,6,3,9,0.6666666666666666
vs. FBS (I-A),2022,Oklahoma,6,7,13,0.46153846153846156
vs. FCS (I-AA),2022,Oklahoma,0,0,0,
vs. FBS Winning,2022,Oklahoma,1,5,6,0.16666666666666666
vs. FBS Non-Winning,2022,Oklahoma,5,2,7,0.7142857142857143
vs. BCS AQ,2022,Oklahoma,4,7,11,0.36363636363636365
vs. BCS non-AQ,2022,Oklahoma,2,0,2,1.0
vs. FBS Power 5,2022,Oklahoma,4,7,11,0.36363636363636365
vs. FBS non-Power 5,2022,Oklahoma,2,0,2,1.0
in August/September,2022,Oklahoma,3,1,4,0.75
in October,2022,Oklahoma,2,2,4,0.5
in November,2022,Oklahoma,1,3,4,0.25
in December/January,2022,Oklahoma,0,1,1,0.0
All Games,2009,Oklahoma State,9,4,13,0.6923076923076923
at Home,2009,Oklahoma State,6,2,8,0.75
on Road/Neutral Site,2009,Oklahoma State,3,2,5,0.6
vs. Conference,2009,Oklahoma State,6,2,8,0.75
vs. Non-Conference,2009,Oklahoma State,3,2,5,0.6
vs. Ranked (AP),2009,Oklahoma State,1,2,3,0.3333333333333333
vs. Unranked (AP),2009,Oklahoma State,8,2,10,0.8
vs. FBS (I-A),2009,Oklahoma State,8,4,12,0.6666666666666666
vs. FCS (I-AA),2009,Oklahoma State,1,0,1,1.0
vs. FBS Winning,2009,Oklahoma State,4,4,8,0.5
vs. FBS Non-Winning,2009,Oklahoma State,4,0,4,1.0
vs. BCS AQ,2009,Oklahoma State,7,3,10,0.7
vs. BCS non-AQ,2009,Oklahoma State,1,1,2,0.5
vs. FBS Power 5,2009,Oklahoma State,7,3,10,0.7
vs. FBS non-Power 5,2009,Oklahoma State,1,1,2,0.5
in August/September,2009,Oklahoma State,3,1,4,0.75
in October,2009,Oklahoma State,3,1,4,0.75
in November,2009,Oklahoma State,3,1,4,0.75
in December/January,2009,Oklahoma State,0,1,1,0.0
All Games,2010,Oklahoma State,11,2,13,0.8461538461538461
at Home,2010,Oklahoma State,5,2,7,0.7142857142857143
on Road/Neutral Site,2010,Oklahoma State,6,0,6,1.0
vs. Conference,2010,Oklahoma State,6,2,8,0.75
vs. Non-Conference,2010,Oklahoma State,5,0,5,1.0
vs. Ranked (AP),2010,Oklahoma State,2,2,4,0.5
vs. Unranked (AP),2010,Oklahoma State,9,0,9,1.0
vs. FBS (I-A),2010,Oklahoma State,11,2,13,0.8461538461538461
vs. FCS (I-AA),2010,Oklahoma State,0,0,0,
vs. FBS Winning,2010,Oklahoma State,7,2,9,0.7777777777777778
vs. FBS Non-Winning,2010,Oklahoma State,4,0,4,1.0
vs. BCS AQ,2010,Oklahoma State,8,2,10,0.8
vs. BCS non-AQ,2010,Oklahoma State,3,0,3,1.0
vs. FBS Power 5,2010,Oklahoma State,8,2,10,0.8
vs. FBS non-Power 5,2010,Oklahoma State,3,0,3,1.0
in August/September,2010,Oklahoma State,4,0,4,1.0
in October,2010,Oklahoma State,3,1,4,0.75
in November,2010,Oklahoma State,3,1,4,0.75
in December/January,2010,Oklahoma State,1,0,1,1.0
All Games,2011,Oklahoma State,12,1,13,0.9230769230769231
at Home,2011,Oklahoma State,6,0,6,1.0
on Road/Neutral Site,2011,Oklahoma State,6,1,7,0.8571428571428571
vs. Conference,2011,Oklahoma State,8,1,9,0.8888888888888888
vs. Non-Conference,2011,Oklahoma State,4,0,4,1.0
vs. Ranked (AP),2011,Oklahoma State,4,0,4,1.0
vs. Unranked (AP),2011,Oklahoma State,8,1,9,0.8888888888888888
vs. FBS (I-A),2011,Oklahoma State,12,1,13,0.9230769230769231
vs. FCS (I-AA),2011,Oklahoma State,0,0,0,
vs. FBS Winning,2011,Oklahoma State,9,0,9,1.0
vs. FBS Non-Winning,2011,Oklahoma State,3,1,4,0.75
vs. BCS AQ,2011,Oklahoma State,10,1,11,0.9090909090909091
vs. BCS non-AQ,2011,Oklahoma State,2,0,2,1.0
vs. FBS Power 5,2011,Oklahoma State,10,1,11,0.9090909090909091
vs. FBS non-Power 5,2011,Oklahoma State,2,0,2,1.0
in August/September,2011,Oklahoma State,4,0,4,1.0
in October,2011,Oklahoma State,4,0,4,1.0
in November,2011,Oklahoma State,2,1,3,0.6666666666666666
in December/January,2011,Oklahoma State,2,0,2,1.0
All Games,2012,Oklahoma State,8,5,13,0.6153846153846154
at Home,2012,Oklahoma State,6,1,7,0.8571428571428571
on Road/Neutral Site,2012,Oklahoma State,2,4,6,0.3333333333333333
vs. Conference,2012,Oklahoma State,5,4,9,0.5555555555555556
vs. Non-Conference,2012,Oklahoma State,3,1,4,0.75
vs. Ranked (AP),2012,Oklahoma State,0,3,3,0.0
vs. Unranked (AP),2012,Oklahoma State,8,2,10,0.8
vs. FBS (I-A),2012,Oklahoma State,7,5,12,0.5833333333333334
vs. FCS (I-AA),2012,Oklahoma State,1,0,1,1.0
vs. FBS Winning,2012,Oklahoma State,4,5,9,0.4444444444444444
vs. FBS Non-Winning,2012,Oklahoma State,3,0,3,1.0
vs. BCS AQ,2012,Oklahoma State,6,5,11,0.5454545454545454
vs. BCS non-AQ,2012,Oklahoma State,1,0,1,1.0
vs. FBS Power 5,2012,Oklahoma State,6,5,11,0.5454545454545454
vs. FBS non-Power 5,2012,Oklahoma State,1,0,1,1.0
in August/September,2012,Oklahoma State,2,2,4,0.5
in October,2012,Oklahoma State,3,0,3,1.0
in November,2012,Oklahoma State,2,2,4,0.5
in December/January,2012,Oklahoma State,1,1,2,0.5
All Games,2013,Oklahoma State,10,3,13,0.7692307692307693
at Home,2013,Oklahoma State,5,1,6,0.8333333333333334
on Road/Neutral Site,2013,Oklahoma State,5,2,7,0.7142857142857143
vs. Conference,2013,Oklahoma State,7,2,9,0.7777777777777778
vs. Non-Conference,2013,Oklahoma State,3,1,4,0.75
vs. Ranked (AP),2013,Oklahoma State,1,2,3,0.3333333333333333
vs. Unranked (AP),2013,Oklahoma State,9,1,10,0.9
vs. FBS (I-A),2013,Oklahoma State,9,3,12,0.75
vs. FCS (I-AA),2013,Oklahoma State,1,0,1,1.0
vs. FBS Winning,2013,Oklahoma State,6,2,8,0.75
vs. FBS Non-Winning,2013,Oklahoma State,3,1,4,0.75
vs. BCS AQ,2013,Oklahoma State,8,3,11,0.7272727272727273
vs. BCS non-AQ,2013,Oklahoma State,1,0,1,1.0
vs. FBS Power 5,2013,Oklahoma State,8,3,11,0.7272727272727273
vs. FBS non-Power 5,2013,Oklahoma State,1,0,1,1.0
in August/September,2013,Oklahoma State,3,1,4,0.75
in October,2013,Oklahoma State,3,0,3,1.0
in November,2013,Oklahoma State,4,0,4,1.0
in December/January,2013,Oklahoma State,0,2,2,0.0
All Games,2014,Oklahoma State,7,6,13,0.5384615384615384
at Home,2014,Oklahoma State,4,2,6,0.6666666666666666
on Road/Neutral Site,2014,Oklahoma State,3,4,7,0.42857142857142855
vs. Conference,2014,Oklahoma State,4,5,9,0.4444444444444444
vs. Non-Conference,2014,Oklahoma State,3,1,4,0.75
vs. Ranked (AP),2014,Oklahoma State,0,4,4,0.0
vs. Unranked (AP),2014,Oklahoma State,7,2,9,0.7777777777777778
vs. FBS (I-A),2014,Oklahoma State,6,6,12,0.5
vs. FCS (I-AA),2014,Oklahoma State,1,0,1,1.0
vs. FBS Winning,2014,Oklahoma State,2,5,7,0.2857142857142857
vs. FBS Non-Winning,2014,Oklahoma State,4,1,5,0.8
vs. BCS AQ,2014,Oklahoma State,5,6,11,0.45454545454545453
vs. BCS non-AQ,2014,Oklahoma State,1,0,1,1.0
vs. FBS Power 5,2014,Oklahoma State,5,6,11,0.45454545454545453
vs. FBS non-Power 5,2014,Oklahoma State,1,0,1,1.0
in August/September,2014,Oklahoma State,3,1,4,0.75
in October,2014,Oklahoma State,2,2,4,0.5
in November,2014,Oklahoma State,0,3,3,0.0
in December/January,2014,Oklahoma State,2,0,2,1.0
All Games,2015,Oklahoma State,10,3,13,0.7692307692307693
at Home,2015,Oklahoma State,5,2,7,0.7142857142857143
on Road/Neutral Site,2015,Oklahoma State,5,1,6,0.8333333333333334
vs. Conference,2015,Oklahoma State,7,2,9,0.7777777777777778
vs. Non-Conference,2015,Oklahoma State,3,1,4,0.75
vs. Ranked (AP),2015,Oklahoma State,1,3,4,0.25
vs. Unranked (AP),2015,Oklahoma State,9,0,9,1.0
vs. FBS (I-A),2015,Oklahoma State,9,3,12,0.75
vs. FCS (I-AA),2015,Oklahoma State,1,0,1,1.0
vs. FBS Winning,2015,Oklahoma State,4,3,7,0.5714285714285714
vs. FBS Non-Winning,2015,Oklahoma State,5,0,5,1.0
vs. BCS AQ,2015,Oklahoma State,7,3,10,0.7
vs. BCS non-AQ,2015,Oklahoma State,2,0,2,1.0
vs. FBS Power 5,2015,Oklahoma State,7,3,10,0.7
vs. FBS non-Power 5,2015,Oklahoma State,2,0,2,1.0
in August/September,2015,Oklahoma State,4,0,4,1.0
in October,2015,Oklahoma State,4,0,4,1.0
in November,2015,Oklahoma State,2,2,4,0.5
in December/January,2015,Oklahoma State,0,1,1,0.0
All Games,2016,Oklahoma State,10,3,13,0.7692307692307693
at Home,2016,Oklahoma State,6,1,7,0.8571428571428571
on Road/Neutral Site,2016,Oklahoma State,4,2,6,0.6666666666666666
vs. Conference,2016,Oklahoma State,7,2,9,0.7777777777777778
vs. Non-Conference,2016,Oklahoma State,3,1,4,0.75
vs. Ranked (AP),2016,Oklahoma State,3,1,4,0.75
vs. Unranked (AP),2016,Oklahoma State,7,2,9,0.7777777777777778
vs. FBS (I-A),2016,Oklahoma State,9,3,12,0.75
vs. FCS (I-AA),2016,Oklahoma State,1,0,1,1.0
vs. FBS Winning,2016,Oklahoma State,4,2,6,0.6666666666666666
vs. FBS Non-Winning,2016,Oklahoma State,5,1,6,0.8333333333333334
vs. BCS AQ,2016,Oklahoma State,9,2,11,0.8181818181818182
vs. BCS non-AQ,2016,Oklahoma State,0,1,1,0.0
vs. FBS Power 5,2016,Oklahoma State,9,2,11,0.8181818181818182
vs. FBS non-Power 5,2016,Oklahoma State,0,1,1,0.0
in August/September,2016,Oklahoma State,2,2,4,0.5
in October,2016,Oklahoma State,4,0,4,1.0
in November,2016,Oklahoma State,3,0,3,1.0
in December/January,2016,Oklahoma State,1,1,2,0.5
All Games,2017,Oklahoma State,10,3,13,0.7692307692307693
at Home,2017,Oklahoma State,3,3,6,0.5
on Road/Neutral Site,2017,Oklahoma State,7,0,7,1.0
vs. Conference,2017,Oklahoma State,6,3,9,0.6666666666666666
vs. Non-Conference,2017,Oklahoma State,4,0,4,1.0
vs. Ranked (AP),2017,Oklahoma State,1,2,3,0.3333333333333333
vs. Unranked (AP),2017,Oklahoma State,9,1,10,0.9
vs. FBS (I-A),2017,Oklahoma State,10,3,13,0.7692307692307693
vs. FCS (I-AA),2017,Oklahoma State,0,0,0,
vs. FBS Winning,2017,Oklahoma State,4,3,7,0.5714285714285714
vs. FBS Non-Winning,2017,Oklahoma State,6,0,6,1.0
vs. BCS AQ,2017,Oklahoma State,9,3,12,0.75
vs. BCS non-AQ,2017,Oklahoma State,1,0,1,1.0
vs. FBS Power 5,2017,Oklahoma State,8,3,11,0.7272727272727273
vs. FBS non-Power 5,2017,Oklahoma State,2,0,2,1.0
in August/September,2017,Oklahoma State,4,1,5,0.8
in October,2017,Oklahoma State,3,0,3,1.0
in November,2017,Oklahoma State,2,2,4,0.5
in December/January,2017,Oklahoma State,1,0,1,1.0
All Games,2018,Oklahoma State,7,6,13,0.5384615384615384
at Home,2018,Oklahoma State,5,2,7,0.7142857142857143
on Road/Neutral Site,2018,Oklahoma State,2,4,6,0.3333333333333333
vs. Conference,2018,Oklahoma State,3,6,9,0.3333333333333333
vs. Non-Conference,2018,Oklahoma State,4,0,4,1.0
vs. Ranked (AP),2018,Oklahoma State,3,1,4,0.75
vs. Unranked (AP),2018,Oklahoma State,4,5,9,0.4444444444444444
vs. FBS (I-A),2018,Oklahoma State,6,6,12,0.5
vs. FCS (I-AA),2018,Oklahoma State,1,0,1,1.0
vs. FBS Winning,2018,Oklahoma State,4,4,8,0.5
vs. FBS Non-Winning,2018,Oklahoma State,2,2,4,0.5
vs. BCS AQ,2018,Oklahoma State,4,6,10,0.4
vs. BCS non-AQ,2018,Oklahoma State,2,0,2,1.0
vs. FBS Power 5,2018,Oklahoma State,4,6,10,0.4
vs. FBS non-Power 5,2018,Oklahoma State,2,0,2,1.0
in August/September,2018,Oklahoma State,4,1,5,0.8
in October,2018,Oklahoma State,1,2,3,0.3333333333333333
in November,2018,Oklahoma State,1,3,4,0.25
in December/January,2018,Oklahoma State,1,0,1,1.0
All Games,2019,Oklahoma State,8,5,13,0.6153846153846154
at Home,2019,Oklahoma State,4,2,6,0.6666666666666666
on Road/Neutral Site,2019,Oklahoma State,4,3,7,0.5714285714285714
vs. Conference,2019,Oklahoma State,5,4,9,0.5555555555555556
vs. Non-Conference,2019,Oklahoma State,3,1,4,0.75
vs. Ranked (AP),2019,Oklahoma State,0,3,3,0.0
vs. Unranked (AP),2019,Oklahoma State,8,2,10,0.8
vs. FBS (I-A),2019,Oklahoma State,7,5,12,0.5833333333333334
vs. FCS (I-AA),2019,Oklahoma State,1,0,1,1.0
vs. FBS Winning,2019,Oklahoma State,2,4,6,0.3333333333333333
vs. FBS Non-Winning,2019,Oklahoma State,5,1,6,0.8333333333333334
vs. BCS AQ,2019,Oklahoma State,7,5,12,0.5833333333333334
vs. BCS non-AQ,2019,Oklahoma State,0,0,0,
vs. FBS Power 5,2019,Oklahoma State,6,5,11,0.5454545454545454
vs. FBS non-Power 5,2019,Oklahoma State,1,0,1,1.0
in August/September,2019,Oklahoma State,4,1,5,0.8
in October,2019,Oklahoma State,1,2,3,0.3333333333333333
in November,2019,Oklahoma State,3,1,4,0.75
in December/January,2019,Oklahoma State,0,1,1,0.0
All Games,2020,Oklahoma State,8,3,11,0.7272727272727273
at Home,2020,Oklahoma State,4,1,5,0.8
on Road/Neutral Site,2020,Oklahoma State,4,2,6,0.6666666666666666
vs. Conference,2020,Oklahoma State,6,3,9,0.6666666666666666
vs. Non-Conference,2020,Oklahoma State,2,0,2,1.0
vs. Ranked (AP),2020,Oklahoma State,3,2,5,0.6
vs. Unranked (AP),2020,Oklahoma State,5,1,6,0.8333333333333334
vs. FBS (I-A),2020,Oklahoma State,8,3,11,0.7272727272727273
vs. FCS (I-AA),2020,Oklahoma State,0,0,0,
vs. FBS Winning,2020,Oklahoma State,4,3,7,0.5714285714285714
vs. FBS Non-Winning,2020,Oklahoma State,4,0,4,1.0
vs. BCS AQ,2020,Oklahoma State,8,3,11,0.7272727272727273
vs. BCS non-AQ,2020,Oklahoma State,0,0,0,
vs. FBS Power 5,2020,Oklahoma State,7,3,10,0.7
vs. FBS non-Power 5,2020,Oklahoma State,1,0,1,1.0
in August/September,2020,Oklahoma State,2,0,2,1.0
in October,2020,Oklahoma State,2,1,3,0.6666666666666666
in November,2020,Oklahoma State,2,1,3,0.6666666666666666
in December/January,2020,Oklahoma State,2,1,3,0.6666666666666666
All Games,2021,Oklahoma State,12,2,14,0.8571428571428571
at Home,2021,Oklahoma State,7,0,7,1.0
on Road/Neutral Site,2021,Oklahoma State,5,2,7,0.7142857142857143
vs. Conference,2021,Oklahoma State,8,2,10,0.8
vs. Non-Conference,2021,Oklahoma State,4,0,4,1.0
vs. Ranked (AP),2021,Oklahoma State,3,1,4,0.75
vs. Unranked (AP),2021,Oklahoma State,9,1,10,0.9
vs. FBS (I-A),2021,Oklahoma State,11,2,13,0.8461538461538461
vs. FCS (I-AA),2021,Oklahoma State,1,0,1,1.0
vs. FBS Winning,2021,Oklahoma State,7,2,9,0.7777777777777778
vs. FBS Non-Winning,2021,Oklahoma State,4,0,4,1.0
vs. BCS AQ,2021,Oklahoma State,10,2,12,0.8333333333333334
vs. BCS non-AQ,2021,Oklahoma State,1,0,1,1.0
vs. FBS Power 5,2021,Oklahoma State,8,2,10,0.8
vs. FBS non-Power 5,2021,Oklahoma State,3,0,3,1.0
in August/September,2021,Oklahoma State,4,0,4,1.0
in October,2021,Oklahoma State,3,1,4,0.75
in November,2021,Oklahoma State,4,0,4,1.0
in December/January,2021,Oklahoma State,1,1,2,0.5
All Games,2022,Oklahoma State,7,6,13,0.5384615384615384
at Home,2022,Oklahoma State,6,1,7,0.8571428571428571
on Road/Neutral Site,2022,Oklahoma State,1,5,6,0.16666666666666666
vs. Conference,2022,Oklahoma State,4,5,9,0.4444444444444444
vs. Non-Conference,2022,Oklahoma State,3,1,4,0.75
vs. Ranked (AP),2022,Oklahoma State,1,2,3,0.3333333333333333
vs. Unranked (AP),2022,Oklahoma State,6,4,10,0.6
vs. FBS (I-A),2022,Oklahoma State,6,6,12,0.5
vs. FCS (I-AA),2022,Oklahoma State,1,0,1,1.0
vs. FBS Winning,2022,Oklahoma State,2,3,5,0.4
vs. FBS Non-Winning,2022,Oklahoma State,4,3,7,0.5714285714285714
vs. BCS AQ,2022,Oklahoma State,5,6,11,0.45454545454545453
vs. BCS non-AQ,2022,Oklahoma State,1,0,1,1.0
vs. FBS Power 5,2022,Oklahoma State,5,6,11,0.45454545454545453
vs. FBS non-Power 5,2022,Oklahoma State,1,0,1,1.0
in August/September,2022,Oklahoma State,3,0,3,1.0
in October,2022,Oklahoma State,3,2,5,0.6
in November,2022,Oklahoma State,1,3,4,0.25
in December/January,2022,Oklahoma State,0,1,1,0.0
All Games,2014,Old Dominion,6,6,12,0.5
at Home,2014,Old Dominion,4,2,6,0.6666666666666666
on Road/Neutral Site,2014,Old Dominion,2,4,6,0.3333333333333333
vs. Conference,2014,Old Dominion,4,4,8,0.5
vs. Non-Conference,2014,Old Dominion,2,2,4,0.5
vs. Ranked (AP),2014,Old Dominion,0,1,1,0.0
vs. Unranked (AP),2014,Old Dominion,6,5,11,0.5454545454545454
vs. FBS (I-A),2014,Old Dominion,5,6,11,0.45454545454545453
vs. FCS (I-AA),2014,Old Dominion,1,0,1,1.0
vs. FBS Winning,2014,Old Dominion,2,4,6,0.3333333333333333
vs. FBS Non-Winning,2014,Old Dominion,3,2,5,0.6
vs. BCS AQ,2014,Old Dominion,0,2,2,0.0
vs. BCS non-AQ,2014,Old Dominion,5,4,9,0.5555555555555556
vs. FBS Power 5,2014,Old Dominion,0,2,2,0.0
vs. FBS non-Power 5,2014,Old Dominion,5,4,9,0.5555555555555556
in August/September,2014,Old Dominion,3,2,5,0.6
in October,2014,Old Dominion,0,3,3,0.0
in November,2014,Old Dominion,3,1,4,0.75
in December/January,2014,Old Dominion,0,0,0,
All Games,2015,Old Dominion,5,7,12,0.4166666666666667
at Home,2015,Old Dominion,3,4,7,0.42857142857142855
on Road/Neutral Site,2015,Old Dominion,2,3,5,0.4
vs. Conference,2015,Old Dominion,3,5,8,0.375
vs. Non-Conference,2015,Old Dominion,2,2,4,0.5
vs. Ranked (AP),2015,Old Dominion,0,1,1,0.0
vs. Unranked (AP),2015,Old Dominion,5,6,11,0.45454545454545453
vs. FBS (I-A),2015,Old Dominion,4,7,11,0.36363636363636365
vs. FCS (I-AA),2015,Old Dominion,1,0,1,1.0
vs. FBS Winning,2015,Old Dominion,0,5,5,0.0
vs. FBS Non-Winning,2015,Old Dominion,4,2,6,0.6666666666666666
vs. BCS AQ,2015,Old Dominion,0,1,1,0.0
vs. BCS non-AQ,2015,Old Dominion,4,6,10,0.4
vs. FBS Power 5,2015,Old Dominion,0,1,1,0.0
vs. FBS non-Power 5,2015,Old Dominion,4,6,10,0.4
in August/September,2015,Old Dominion,2,2,4,0.5
in October,2015,Old Dominion,1,3,4,0.25
in November,2015,Old Dominion,2,2,4,0.5
in December/January,2015,Old Dominion,0,0,0,
All Games,2016,Old Dominion,10,3,13,0.7692307692307693
at Home,2016,Old Dominion,6,0,6,1.0
on Road/Neutral Site,2016,Old Dominion,4,3,7,0.5714285714285714
vs. Conference,2016,Old Dominion,7,1,8,0.875
vs. Non-Conference,2016,Old Dominion,3,2,5,0.6
vs. Ranked (AP),2016,Old Dominion,0,0,0,
vs. Unranked (AP),2016,Old Dominion,10,3,13,0.7692307692307693
vs. FBS (I-A),2016,Old Dominion,9,3,12,0.75
vs. FCS (I-AA),2016,Old Dominion,1,0,1,1.0
vs. FBS Winning,2016,Old Dominion,2,3,5,0.4
vs. FBS Non-Winning,2016,Old Dominion,7,0,7,1.0
vs. BCS AQ,2016,Old Dominion,0,1,1,0.0
vs. BCS non-AQ,2016,Old Dominion,9,2,11,0.8181818181818182
vs. FBS Power 5,2016,Old Dominion,0,1,1,0.0
vs. FBS non-Power 5,2016,Old Dominion,9,2,11,0.8181818181818182
in August/September,2016,Old Dominion,2,2,4,0.5
in October,2016,Old Dominion,3,1,4,0.75
in November,2016,Old Dominion,4,0,4,1.0
in December/January,2016,Old Dominion,1,0,1,1.0
All Games,2017,Old Dominion,5,7,12,0.4166666666666667
at Home,2017,Old Dominion,3,3,6,0.5
on Road/Neutral Site,2017,Old Dominion,2,4,6,0.3333333333333333
vs. Conference,2017,Old Dominion,3,5,8,0.375
vs. Non-Conference,2017,Old Dominion,2,2,4,0.5
vs. Ranked (AP),2017,Old Dominion,0,1,1,0.0
vs. Unranked (AP),2017,Old Dominion,5,6,11,0.45454545454545453
vs. FBS (I-A),2017,Old Dominion,4,7,11,0.36363636363636365
vs. FCS (I-AA),2017,Old Dominion,1,0,1,1.0
vs. FBS Winning,2017,Old Dominion,1,5,6,0.16666666666666666
vs. FBS Non-Winning,2017,Old Dominion,3,2,5,0.6
vs. BCS AQ,2017,Old Dominion,0,2,2,0.0
vs. BCS non-AQ,2017,Old Dominion,4,5,9,0.4444444444444444
vs. FBS Power 5,2017,Old Dominion,0,2,2,0.0
vs. FBS non-Power 5,2017,Old Dominion,4,5,9,0.4444444444444444
in August/September,2017,Old Dominion,2,2,4,0.5
in October,2017,Old Dominion,0,4,4,0.0
in November,2017,Old Dominion,3,1,4,0.75
in December/January,2017,Old Dominion,0,0,0,
All Games,2018,Old Dominion,4,8,12,0.3333333333333333
at Home,2018,Old Dominion,3,3,6,0.5
on Road/Neutral Site,2018,Old Dominion,1,5,6,0.16666666666666666
vs. Conference,2018,Old Dominion,2,6,8,0.25
vs. Non-Conference,2018,Old Dominion,2,2,4,0.5
vs. Ranked (AP),2018,Old Dominion,0,0,0,
vs. Unranked (AP),2018,Old Dominion,4,8,12,0.3333333333333333
vs. FBS (I-A),2018,Old Dominion,3,8,11,0.2727272727272727
vs. FCS (I-AA),2018,Old Dominion,1,0,1,1.0
vs. FBS Winning,2018,Old Dominion,1,3,4,0.25
vs. FBS Non-Winning,2018,Old Dominion,2,5,7,0.2857142857142857
vs. BCS AQ,2018,Old Dominion,1,1,2,0.5
vs. BCS non-AQ,2018,Old Dominion,2,7,9,0.2222222222222222
vs. FBS Power 5,2018,Old Dominion,1,0,1,1.0
vs. FBS non-Power 5,2018,Old Dominion,2,8,10,0.2
in August/September,2018,Old Dominion,1,4,5,0.2
in October,2018,Old Dominion,1,3,4,0.25
in November,2018,Old Dominion,2,1,3,0.6666666666666666
in December/January,2018,Old Dominion,0,0,0,
All Games,2019,Old Dominion,1,11,12,0.08333333333333333
at Home,2019,Old Dominion,1,5,6,0.16666666666666666
on Road/Neutral Site,2019,Old Dominion,0,6,6,0.0
vs. Conference,2019,Old Dominion,0,8,8,0.0
vs. Non-Conference,2019,Old Dominion,1,3,4,0.25
vs. Ranked (AP),2019,Old Dominion,0,0,0,
vs. Unranked (AP),2019,Old Dominion,1,11,12,0.08333333333333333
vs. FBS (I-A),2019,Old Dominion,0,11,11,0.0
vs. FCS (I-AA),2019,Old Dominion,1,0,1,1.0
vs. FBS Winning,2019,Old Dominion,0,7,7,0.0
vs. FBS Non-Winning,2019,Old Dominion,0,4,4,0.0
vs. BCS AQ,2019,Old Dominion,0,3,3,0.0
vs. BCS non-AQ,2019,Old Dominion,0,8,8,0.0
vs. FBS Power 5,2019,Old Dominion,0,2,2,0.0
vs. FBS non-Power 5,2019,Old Dominion,0,9,9,0.0
in August/September,2019,Old Dominion,1,3,4,0.25
in October,2019,Old Dominion,0,4,4,0.0
in November,2019,Old Dominion,0,4,4,0.0
in December/January,2019,Old Dominion,0,0,0,
All Games,2020,Old Dominion,0,0,0,
at Home,2020,Old Dominion,0,0,0,
on Road/Neutral Site,2020,Old Dominion,0,0,0,
vs. Conference,2020,Old Dominion,0,0,0,
vs. Non-Conference,2020,Old Dominion,0,0,0,
vs. Ranked (AP),2020,Old Dominion,0,0,0,
vs. Unranked (AP),2020,Old Dominion,0,0,0,
vs. FBS (I-A),2020,Old Dominion,0,0,0,
vs. FCS (I-AA),2020,Old Dominion,0,0,0,
vs. FBS Winning,2020,Old Dominion,0,0,0,
vs. FBS Non-Winning,2020,Old Dominion,0,0,0,
vs. BCS AQ,2020,Old Dominion,0,0,0,
vs. BCS non-AQ,2020,Old Dominion,0,0,0,
vs. FBS Power 5,2020,Old Dominion,0,0,0,
vs. FBS non-Power 5,2020,Old Dominion,0,0,0,
in August/September,2020,Old Dominion,0,0,0,
in October,2020,Old Dominion,0,0,0,
in November,2020,Old Dominion,0,0,0,
in December/January,2020,Old Dominion,0,0,0,
All Games,2021,Old Dominion,6,7,13,0.46153846153846156
at Home,2021,Old Dominion,4,2,6,0.6666666666666666
on Road/Neutral Site,2021,Old Dominion,2,5,7,0.2857142857142857
vs. Conference,2021,Old Dominion,5,3,8,0.625
vs. Non-Conference,2021,Old Dominion,1,4,5,0.2
vs. Ranked (AP),2021,Old Dominion,0,1,1,0.0
vs. Unranked (AP),2021,Old Dominion,6,6,12,0.5
vs. FBS (I-A),2021,Old Dominion,5,7,12,0.4166666666666667
vs. FCS (I-AA),2021,Old Dominion,1,0,1,1.0
vs. FBS Winning,2021,Old Dominion,1,6,7,0.14285714285714285
vs. FBS Non-Winning,2021,Old Dominion,4,1,5,0.8
vs. BCS AQ,2021,Old Dominion,0,2,2,0.0
vs. BCS non-AQ,2021,Old Dominion,5,5,10,0.5
vs. FBS Power 5,2021,Old Dominion,0,1,1,0.0
vs. FBS non-Power 5,2021,Old Dominion,5,6,11,0.45454545454545453
in August/September,2021,Old Dominion,1,3,4,0.25
in October,2021,Old Dominion,1,3,4,0.25
in November,2021,Old Dominion,4,0,4,1.0
in December/January,2021,Old Dominion,0,1,1,0.0
All Games,2022,Old Dominion,3,9,12,0.25
at Home,2022,Old Dominion,2,4,6,0.3333333333333333
on Road/Neutral Site,2022,Old Dominion,1,5,6,0.16666666666666666
vs. Conference,2022,Old Dominion,2,6,8,0.25
vs. Non-Conference,2022,Old Dominion,1,3,4,0.25
vs. Ranked (AP),2022,Old Dominion,0,0,0,
vs. Unranked (AP),2022,Old Dominion,3,9,12,0.25
vs. FBS (I-A),2022,Old Dominion,3,9,12,0.25
vs. FCS (I-AA),2022,Old Dominion,0,0,0,
vs. FBS Winning,2022,Old Dominion,1,5,6,0.16666666666666666
vs. FBS Non-Winning,2022,Old Dominion,2,4,6,0.3333333333333333
vs. BCS AQ,2022,Old Dominion,1,2,3,0.3333333333333333
vs. BCS non-AQ,2022,Old Dominion,2,7,9,0.2222222222222222
vs. FBS Power 5,2022,Old Dominion,1,1,2,0.5
vs. FBS non-Power 5,2022,Old Dominion,2,8,10,0.2
in August/September,2022,Old Dominion,2,2,4,0.5
in October,2022,Old Dominion,1,3,4,0.25
in November,2022,Old Dominion,0,4,4,0.0
in December/January,2022,Old Dominion,0,0,0,
All Games,2009,Oregon,10,3,13,0.7692307692307693
at Home,2009,Oregon,7,0,7,1.0
on Road/Neutral Site,2009,Oregon,3,3,6,0.5
vs. Conference,2009,Oregon,8,1,9,0.8888888888888888
vs. Non-Conference,2009,Oregon,2,2,4,0.5
vs. Ranked (AP),2009,Oregon,2,2,4,0.5
vs. Unranked (AP),2009,Oregon,8,1,9,0.8888888888888888
vs. FBS (I-A),2009,Oregon,10,3,13,0.7692307692307693
vs. FCS (I-AA),2009,Oregon,0,0,0,
vs. FBS Winning,2009,Oregon,6,3,9,0.6666666666666666
vs. FBS Non-Winning,2009,Oregon,4,0,4,1.0
vs. BCS AQ,2009,Oregon,9,2,11,0.8181818181818182
vs. BCS non-AQ,2009,Oregon,1,1,2,0.5
vs. FBS Power 5,2009,Oregon,9,2,11,0.8181818181818182
vs. FBS non-Power 5,2009,Oregon,1,1,2,0.5
in August/September,2009,Oregon,3,1,4,0.75
in October,2009,Oregon,4,0,4,1.0
in November,2009,Oregon,2,1,3,0.6666666666666666
in December/January,2009,Oregon,1,1,2,0.5
All Games,2010,Oregon,12,1,13,0.9230769230769231
at Home,2010,Oregon,6,0,6,1.0
on Road/Neutral Site,2010,Oregon,6,1,7,0.8571428571428571
vs. Conference,2010,Oregon,9,0,9,1.0
vs. Non-Conference,2010,Oregon,3,1,4,0.75
vs. Ranked (AP),2010,Oregon,1,1,2,0.5
vs. Unranked (AP),2010,Oregon,11,0,11,1.0
vs. FBS (I-A),2010,Oregon,11,1,12,0.9166666666666666
vs. FCS (I-AA),2010,Oregon,1,0,1,1.0
vs. FBS Winning,2010,Oregon,4,1,5,0.8
vs. FBS Non-Winning,2010,Oregon,7,0,7,1.0
vs. BCS AQ,2010,Oregon,10,1,11,0.9090909090909091
vs. BCS non-AQ,2010,Oregon,1,0,1,1.0
vs. FBS Power 5,2010,Oregon,10,1,11,0.9090909090909091
vs. FBS non-Power 5,2010,Oregon,1,0,1,1.0
in August/September,2010,Oregon,4,0,4,1.0
in October,2010,Oregon,4,0,4,1.0
in November,2010,Oregon,3,0,3,1.0
in December/January,2010,Oregon,1,1,2,0.5
All Games,2011,Oregon,12,2,14,0.8571428571428571
at Home,2011,Oregon,7,1,8,0.875
on Road/Neutral Site,2011,Oregon,5,1,6,0.8333333333333334
vs. Conference,2011,Oregon,9,1,10,0.9
vs. Non-Conference,2011,Oregon,3,1,4,0.75
vs. Ranked (AP),2011,Oregon,2,2,4,0.5
vs. Unranked (AP),2011,Oregon,10,0,10,1.0
vs. FBS (I-A),2011,Oregon,11,2,13,0.8461538461538461
vs. FCS (I-AA),2011,Oregon,1,0,1,1.0
vs. FBS Winning,2011,Oregon,5,2,7,0.7142857142857143
vs. FBS Non-Winning,2011,Oregon,6,0,6,1.0
vs. BCS AQ,2011,Oregon,10,2,12,0.8333333333333334
vs. BCS non-AQ,2011,Oregon,1,0,1,1.0
vs. FBS Power 5,2011,Oregon,10,2,12,0.8333333333333334
vs. FBS non-Power 5,2011,Oregon,1,0,1,1.0
in August/September,2011,Oregon,3,1,4,0.75
in October,2011,Oregon,4,0,4,1.0
in November,2011,Oregon,3,1,4,0.75
in December/January,2011,Oregon,2,0,2,1.0
All Games,2012,Oregon,12,1,13,0.9230769230769231
at Home,2012,Oregon,6,1,7,0.8571428571428571
on Road/Neutral Site,2012,Oregon,6,0,6,1.0
vs. Conference,2012,Oregon,8,1,9,0.8888888888888888
vs. Non-Conference,2012,Oregon,4,0,4,1.0
vs. Ranked (AP),2012,Oregon,2,1,3,0.6666666666666666
vs. Unranked (AP),2012,Oregon,10,0,10,1.0
vs. FBS (I-A),2012,Oregon,11,1,12,0.9166666666666666
vs. FCS (I-AA),2012,Oregon,1,0,1,1.0
vs. FBS Winning,2012,Oregon,8,1,9,0.8888888888888888
vs. FBS Non-Winning,2012,Oregon,3,0,3,1.0
vs. BCS AQ,2012,Oregon,9,1,10,0.9
vs. BCS non-AQ,2012,Oregon,2,0,2,1.0
vs. FBS Power 5,2012,Oregon,9,1,10,0.9
vs. FBS non-Power 5,2012,Oregon,2,0,2,1.0
in August/September,2012,Oregon,5,0,5,1.0
in October,2012,Oregon,3,0,3,1.0
in November,2012,Oregon,3,1,4,0.75
in December/January,2012,Oregon,1,0,1,1.0
All Games,2013,Oregon,11,2,13,0.8461538461538461
at Home,2013,Oregon,7,0,7,1.0
on Road/Neutral Site,2013,Oregon,4,2,6,0.6666666666666666
vs. Conference,2013,Oregon,7,2,9,0.7777777777777778
vs. Non-Conference,2013,Oregon,4,0,4,1.0
vs. Ranked (AP),2013,Oregon,2,1,3,0.6666666666666666
vs. Unranked (AP),2013,Oregon,9,1,10,0.9
vs. FBS (I-A),2013,Oregon,10,2,12,0.8333333333333334
vs. FCS (I-AA),2013,Oregon,1,0,1,1.0
vs. FBS Winning,2013,Oregon,4,2,6,0.6666666666666666
vs. FBS Non-Winning,2013,Oregon,6,0,6,1.0
vs. BCS AQ,2013,Oregon,10,2,12,0.8333333333333334
vs. BCS non-AQ,2013,Oregon,0,0,0,
vs. FBS Power 5,2013,Oregon,10,2,12,0.8333333333333334
vs. FBS non-Power 5,2013,Oregon,0,0,0,
in August/September,2013,Oregon,4,0,4,1.0
in October,2013,Oregon,4,0,4,1.0
in November,2013,Oregon,2,2,4,0.5
in December/January,2013,Oregon,1,0,1,1.0
All Games,2014,Oregon,13,2,15,0.8666666666666667
at Home,2014,Oregon,6,1,7,0.8571428571428571
on Road/Neutral Site,2014,Oregon,7,1,8,0.875
vs. Conference,2014,Oregon,9,1,10,0.9
vs. Non-Conference,2014,Oregon,4,1,5,0.8
vs. Ranked (AP),2014,Oregon,5,2,7,0.7142857142857143
vs. Unranked (AP),2014,Oregon,8,0,8,1.0
vs. FBS (I-A),2014,Oregon,12,2,14,0.8571428571428571
vs. FCS (I-AA),2014,Oregon,1,0,1,1.0
vs. FBS Winning,2014,Oregon,7,2,9,0.7777777777777778
vs. FBS Non-Winning,2014,Oregon,5,0,5,1.0
vs. BCS AQ,2014,Oregon,11,2,13,0.8461538461538461
vs. BCS non-AQ,2014,Oregon,1,0,1,1.0
vs. FBS Power 5,2014,Oregon,11,2,13,0.8461538461538461
vs. FBS non-Power 5,2014,Oregon,1,0,1,1.0
in August/September,2014,Oregon,4,0,4,1.0
in October,2014,Oregon,3,1,4,0.75
in November,2014,Oregon,4,0,4,1.0
in December/January,2014,Oregon,2,1,3,0.6666666666666666
All Games,2015,Oregon,9,4,13,0.6923076923076923
at Home,2015,Oregon,5,2,7,0.7142857142857143
on Road/Neutral Site,2015,Oregon,4,2,6,0.6666666666666666
vs. Conference,2015,Oregon,7,2,9,0.7777777777777778
vs. Non-Conference,2015,Oregon,2,2,4,0.5
vs. Ranked (AP),2015,Oregon,1,3,4,0.25
vs. Unranked (AP),2015,Oregon,8,1,9,0.8888888888888888
vs. FBS (I-A),2015,Oregon,8,4,12,0.6666666666666666
vs. FCS (I-AA),2015,Oregon,1,0,1,1.0
vs. FBS Winning,2015,Oregon,4,4,8,0.5
vs. FBS Non-Winning,2015,Oregon,4,0,4,1.0
vs. BCS AQ,2015,Oregon,7,4,11,0.6363636363636364
vs. BCS non-AQ,2015,Oregon,1,0,1,1.0
vs. FBS Power 5,2015,Oregon,7,4,11,0.6363636363636364
vs. FBS non-Power 5,2015,Oregon,1,0,1,1.0
in August/September,2015,Oregon,2,2,4,0.5
in October,2015,Oregon,3,1,4,0.75
in November,2015,Oregon,4,0,4,1.0
in December/January,2015,Oregon,0,1,1,0.0
All Games,2016,Oregon,4,8,12,0.3333333333333333
at Home,2016,Oregon,3,3,6,0.5
on Road/Neutral Site,2016,Oregon,1,5,6,0.16666666666666666
vs. Conference,2016,Oregon,2,7,9,0.2222222222222222
vs. Non-Conference,2016,Oregon,2,1,3,0.6666666666666666
vs. Ranked (AP),2016,Oregon,0,5,5,0.0
vs. Unranked (AP),2016,Oregon,4,3,7,0.5714285714285714
vs. FBS (I-A),2016,Oregon,3,8,11,0.2727272727272727
vs. FCS (I-AA),2016,Oregon,1,0,1,1.0
vs. FBS Winning,2016,Oregon,1,6,7,0.14285714285714285
vs. FBS Non-Winning,2016,Oregon,2,2,4,0.5
vs. BCS AQ,2016,Oregon,3,8,11,0.2727272727272727
vs. BCS non-AQ,2016,Oregon,0,0,0,
vs. FBS Power 5,2016,Oregon,3,8,11,0.2727272727272727
vs. FBS non-Power 5,2016,Oregon,0,0,0,
in August/September,2016,Oregon,2,2,4,0.5
in October,2016,Oregon,1,3,4,0.25
in November,2016,Oregon,1,3,4,0.25
in December/January,2016,Oregon,0,0,0,
All Games,2017,Oregon,7,6,13,0.5384615384615384
at Home,2017,Oregon,6,1,7,0.8571428571428571
on Road/Neutral Site,2017,Oregon,1,5,6,0.16666666666666666
vs. Conference,2017,Oregon,4,5,9,0.4444444444444444
vs. Non-Conference,2017,Oregon,3,1,4,0.75
vs. Ranked (AP),2017,Oregon,0,3,3,0.0
vs. Unranked (AP),2017,Oregon,7,3,10,0.7
vs. FBS (I-A),2017,Oregon,6,6,12,0.5
vs. FCS (I-AA),2017,Oregon,1,0,1,1.0
vs. FBS Winning,2017,Oregon,3,5,8,0.375
vs. FBS Non-Winning,2017,Oregon,3,1,4,0.75
vs. BCS AQ,2017,Oregon,5,5,10,0.5
vs. BCS non-AQ,2017,Oregon,1,1,2,0.5
vs. FBS Power 5,2017,Oregon,5,5,10,0.5
vs. FBS non-Power 5,2017,Oregon,1,1,2,0.5
in August/September,2017,Oregon,4,1,5,0.8
in October,2017,Oregon,1,3,4,0.25
in November,2017,Oregon,2,1,3,0.6666666666666666
in December/January,2017,Oregon,0,1,1,0.0
All Games,2018,Oregon,9,4,13,0.6923076923076923
at Home,2018,Oregon,6,1,7,0.8571428571428571
on Road/Neutral Site,2018,Oregon,3,3,6,0.5
vs. Conference,2018,Oregon,5,4,9,0.5555555555555556
vs. Non-Conference,2018,Oregon,4,0,4,1.0
vs. Ranked (AP),2018,Oregon,1,1,2,0.5
vs. Unranked (AP),2018,Oregon,8,3,11,0.7272727272727273
vs. FBS (I-A),2018,Oregon,8,4,12,0.6666666666666666
vs. FCS (I-AA),2018,Oregon,1,0,1,1.0
vs. FBS Winning,2018,Oregon,4,3,7,0.5714285714285714
vs. FBS Non-Winning,2018,Oregon,4,1,5,0.8
vs. BCS AQ,2018,Oregon,6,4,10,0.6
vs. BCS non-AQ,2018,Oregon,2,0,2,1.0
vs. FBS Power 5,2018,Oregon,6,4,10,0.6
vs. FBS non-Power 5,2018,Oregon,2,0,2,1.0
in August/September,2018,Oregon,4,1,5,0.8
in October,2018,Oregon,1,2,3,0.3333333333333333
in November,2018,Oregon,3,1,4,0.75
in December/January,2018,Oregon,1,0,1,1.0
All Games,2019,Oregon,12,2,14,0.8571428571428571
at Home,2019,Oregon,7,0,7,1.0
on Road/Neutral Site,2019,Oregon,5,2,7,0.7142857142857143
vs. Conference,2019,Oregon,9,1,10,0.9
vs. Non-Conference,2019,Oregon,3,1,4,0.75
vs. Ranked (AP),2019,Oregon,2,1,3,0.6666666666666666
vs. Unranked (AP),2019,Oregon,10,1,11,0.9090909090909091
vs. FBS (I-A),2019,Oregon,11,2,13,0.8461538461538461
vs. FCS (I-AA),2019,Oregon,1,0,1,1.0
vs. FBS Winning,2019,Oregon,6,2,8,0.75
vs. FBS Non-Winning,2019,Oregon,5,0,5,1.0
vs. BCS AQ,2019,Oregon,10,2,12,0.8333333333333334
vs. BCS non-AQ,2019,Oregon,1,0,1,1.0
vs. FBS Power 5,2019,Oregon,10,2,12,0.8333333333333334
vs. FBS non-Power 5,2019,Oregon,1,0,1,1.0
in August/September,2019,Oregon,3,1,4,0.75
in October,2019,Oregon,4,0,4,1.0
in November,2019,Oregon,3,1,4,0.75
in December/January,2019,Oregon,2,0,2,1.0
All Games,2020,Oregon,4,3,7,0.5714285714285714
at Home,2020,Oregon,2,0,2,1.0
on Road/Neutral Site,2020,Oregon,2,3,5,0.4
vs. Conference,2020,Oregon,4,2,6,0.6666666666666666
vs. Non-Conference,2020,Oregon,0,1,1,0.0
vs. Ranked (AP),2020,Oregon,1,1,2,0.5
vs. Unranked (AP),2020,Oregon,3,2,5,0.6
vs. FBS (I-A),2020,Oregon,4,3,7,0.5714285714285714
vs. FCS (I-AA),2020,Oregon,0,0,0,
vs. FBS Winning,2020,Oregon,2,1,3,0.6666666666666666
vs. FBS Non-Winning,2020,Oregon,2,2,4,0.5
vs. BCS AQ,2020,Oregon,4,3,7,0.5714285714285714
vs. BCS non-AQ,2020,Oregon,0,0,0,
vs. FBS Power 5,2020,Oregon,4,3,7,0.5714285714285714
vs. FBS non-Power 5,2020,Oregon,0,0,0,
in August/September,2020,Oregon,0,0,0,
in October,2020,Oregon,0,0,0,
in November,2020,Oregon,3,1,4,0.75
in December/January,2020,Oregon,1,2,3,0.3333333333333333
All Games,2021,Oregon,10,4,14,0.7142857142857143
at Home,2021,Oregon,7,0,7,1.0
on Road/Neutral Site,2021,Oregon,3,4,7,0.42857142857142855
vs. Conference,2021,Oregon,7,3,10,0.7
vs. Non-Conference,2021,Oregon,3,1,4,0.75
vs. Ranked (AP),2021,Oregon,1,3,4,0.25
vs. Unranked (AP),2021,Oregon,9,1,10,0.9
vs. FBS (I-A),2021,Oregon,9,4,13,0.6923076923076923
vs. FCS (I-AA),2021,Oregon,1,0,1,1.0
vs. FBS Winning,2021,Oregon,5,3,8,0.625
vs. FBS Non-Winning,2021,Oregon,4,1,5,0.8
vs. BCS AQ,2021,Oregon,8,4,12,0.6666666666666666
vs. BCS non-AQ,2021,Oregon,1,0,1,1.0
vs. FBS Power 5,2021,Oregon,8,4,12,0.6666666666666666
vs. FBS non-Power 5,2021,Oregon,1,0,1,1.0
in August/September,2021,Oregon,4,0,4,1.0
in October,2021,Oregon,3,1,4,0.75
in November,2021,Oregon,3,1,4,0.75
in December/January,2021,Oregon,0,2,2,0.0
All Games,2022,Oregon,10,3,13,0.7692307692307693
at Home,2022,Oregon,5,1,6,0.8333333333333334
on Road/Neutral Site,2022,Oregon,5,2,7,0.7142857142857143
vs. Conference,2022,Oregon,7,2,9,0.7777777777777778
vs. Non-Conference,2022,Oregon,3,1,4,0.75
vs. Ranked (AP),2022,Oregon,2,3,5,0.4
vs. Unranked (AP),2022,Oregon,8,0,8,1.0
vs. FBS (I-A),2022,Oregon,9,3,12,0.75
vs. FCS (I-AA),2022,Oregon,1,0,1,1.0
vs. FBS Winning,2022,Oregon,5,3,8,0.625
vs. FBS Non-Winning,2022,Oregon,4,0,4,1.0
vs. BCS AQ,2022,Oregon,8,3,11,0.7272727272727273
vs. BCS non-AQ,2022,Oregon,1,0,1,1.0
vs. FBS Power 5,2022,Oregon,8,3,11,0.7272727272727273
vs. FBS non-Power 5,2022,Oregon,1,0,1,1.0
in August/September,2022,Oregon,3,1,4,0.75
in October,2022,Oregon,4,0,4,1.0
in November,2022,Oregon,2,2,4,0.5
in December/January,2022,Oregon,1,0,1,1.0
All Games,2009,Oregon State,8,5,13,0.6153846153846154
at Home,2009,Oregon State,4,2,6,0.6666666666666666
on Road/Neutral Site,2009,Oregon State,4,3,7,0.5714285714285714
vs. Conference,2009,Oregon State,6,3,9,0.6666666666666666
vs. Non-Conference,2009,Oregon State,2,2,4,0.5
vs. Ranked (AP),2009,Oregon State,0,4,4,0.0
vs. Unranked (AP),2009,Oregon State,8,1,9,0.8888888888888888
vs. FBS (I-A),2009,Oregon State,7,5,12,0.5833333333333334
vs. FCS (I-AA),2009,Oregon State,1,0,1,1.0
vs. FBS Winning,2009,Oregon State,3,5,8,0.375
vs. FBS Non-Winning,2009,Oregon State,4,0,4,1.0
vs. BCS AQ,2009,Oregon State,6,4,10,0.6
vs. BCS non-AQ,2009,Oregon State,1,1,2,0.5
vs. FBS Power 5,2009,Oregon State,6,3,9,0.6666666666666666
vs. FBS non-Power 5,2009,Oregon State,1,2,3,0.3333333333333333
in August/September,2009,Oregon State,2,2,4,0.5
in October,2009,Oregon State,3,1,4,0.75
in November,2009,Oregon State,3,0,3,1.0
in December/January,2009,Oregon State,0,2,2,0.0
All Games,2010,Oregon State,5,7,12,0.4166666666666667
at Home,2010,Oregon State,4,2,6,0.6666666666666666
on Road/Neutral Site,2010,Oregon State,1,5,6,0.16666666666666666
vs. Conference,2010,Oregon State,4,5,9,0.4444444444444444
vs. Non-Conference,2010,Oregon State,1,2,3,0.3333333333333333
vs. Ranked (AP),2010,Oregon State,0,4,4,0.0
vs. Unranked (AP),2010,Oregon State,5,3,8,0.625
vs. FBS (I-A),2010,Oregon State,5,7,12,0.4166666666666667
vs. FCS (I-AA),2010,Oregon State,0,0,0,
vs. FBS Winning,2010,Oregon State,3,5,8,0.375
vs. FBS Non-Winning,2010,Oregon State,2,2,4,0.5
vs. BCS AQ,2010,Oregon State,5,5,10,0.5
vs. BCS non-AQ,2010,Oregon State,0,2,2,0.0
vs. FBS Power 5,2010,Oregon State,4,5,9,0.4444444444444444
vs. FBS non-Power 5,2010,Oregon State,1,2,3,0.3333333333333333
in August/September,2010,Oregon State,1,2,3,0.3333333333333333
in October,2010,Oregon State,3,1,4,0.75
in November,2010,Oregon State,1,3,4,0.25
in December/January,2010,Oregon State,0,1,1,0.0
All Games,2011,Oregon State,3,9,12,0.25
at Home,2011,Oregon State,2,4,6,0.3333333333333333
on Road/Neutral Site,2011,Oregon State,1,5,6,0.16666666666666666
vs. Conference,2011,Oregon State,3,6,9,0.3333333333333333
vs. Non-Conference,2011,Oregon State,0,3,3,0.0
vs. Ranked (AP),2011,Oregon State,0,3,3,0.0
vs. Unranked (AP),2011,Oregon State,3,6,9,0.3333333333333333
vs. FBS (I-A),2011,Oregon State,3,8,11,0.2727272727272727
vs. FCS (I-AA),2011,Oregon State,0,1,1,0.0
vs. FBS Winning,2011,Oregon State,1,6,7,0.14285714285714285
vs. FBS Non-Winning,2011,Oregon State,2,2,4,0.5
vs. BCS AQ,2011,Oregon State,3,7,10,0.3
vs. BCS non-AQ,2011,Oregon State,0,1,1,0.0
vs. FBS Power 5,2011,Oregon State,3,7,10,0.3
vs. FBS non-Power 5,2011,Oregon State,0,1,1,0.0
in August/September,2011,Oregon State,0,3,3,0.0
in October,2011,Oregon State,2,3,5,0.4
in November,2011,Oregon State,1,3,4,0.25
in December/January,2011,Oregon State,0,0,0,
All Games,2012,Oregon State,9,4,13,0.6923076923076923
at Home,2012,Oregon State,6,1,7,0.8571428571428571
on Road/Neutral Site,2012,Oregon State,3,3,6,0.5
vs. Conference,2012,Oregon State,6,3,9,0.6666666666666666
vs. Non-Conference,2012,Oregon State,3,1,4,0.75
vs. Ranked (AP),2012,Oregon State,0,3,3,0.0
vs. Unranked (AP),2012,Oregon State,9,1,10,0.9
vs. FBS (I-A),2012,Oregon State,8,4,12,0.6666666666666666
vs. FCS (I-AA),2012,Oregon State,1,0,1,1.0
vs. FBS Winning,2012,Oregon State,5,4,9,0.5555555555555556
vs. FBS Non-Winning,2012,Oregon State,3,0,3,1.0
vs. BCS AQ,2012,Oregon State,7,4,11,0.6363636363636364
vs. BCS non-AQ,2012,Oregon State,1,0,1,1.0
vs. FBS Power 5,2012,Oregon State,7,4,11,0.6363636363636364
vs. FBS non-Power 5,2012,Oregon State,1,0,1,1.0
in August/September,2012,Oregon State,3,0,3,1.0
in October,2012,Oregon State,3,1,4,0.75
in November,2012,Oregon State,2,2,4,0.5
in December/January,2012,Oregon State,1,1,2,0.5
All Games,2013,Oregon State,7,6,13,0.5384615384615384
at Home,2013,Oregon State,2,4,6,0.3333333333333333
on Road/Neutral Site,2013,Oregon State,5,2,7,0.7142857142857143
vs. Conference,2013,Oregon State,4,5,9,0.4444444444444444
vs. Non-Conference,2013,Oregon State,3,1,4,0.75
vs. Ranked (AP),2013,Oregon State,0,5,5,0.0
vs. Unranked (AP),2013,Oregon State,7,1,8,0.875
vs. FBS (I-A),2013,Oregon State,7,5,12,0.5833333333333334
vs. FCS (I-AA),2013,Oregon State,0,1,1,0.0
vs. FBS Winning,2013,Oregon State,2,5,7,0.2857142857142857
vs. FBS Non-Winning,2013,Oregon State,5,0,5,1.0
vs. BCS AQ,2013,Oregon State,4,5,9,0.4444444444444444
vs. BCS non-AQ,2013,Oregon State,3,0,3,1.0
vs. FBS Power 5,2013,Oregon State,4,5,9,0.4444444444444444
vs. FBS non-Power 5,2013,Oregon State,3,0,3,1.0
in August/September,2013,Oregon State,4,1,5,0.8
in October,2013,Oregon State,2,1,3,0.6666666666666666
in November,2013,Oregon State,0,4,4,0.0
in December/January,2013,Oregon State,1,0,1,1.0
All Games,2014,Oregon State,5,7,12,0.4166666666666667
at Home,2014,Oregon State,3,4,7,0.42857142857142855
on Road/Neutral Site,2014,Oregon State,2,3,5,0.4
vs. Conference,2014,Oregon State,2,7,9,0.2222222222222222
vs. Non-Conference,2014,Oregon State,3,0,3,1.0
vs. Ranked (AP),2014,Oregon State,1,3,4,0.25
vs. Unranked (AP),2014,Oregon State,4,4,8,0.5
vs. FBS (I-A),2014,Oregon State,4,7,11,0.36363636363636365
vs. FCS (I-AA),2014,Oregon State,1,0,1,1.0
vs. FBS Winning,2014,Oregon State,2,5,7,0.2857142857142857
vs. FBS Non-Winning,2014,Oregon State,2,2,4,0.5
vs. BCS AQ,2014,Oregon State,2,7,9,0.2222222222222222
vs. BCS non-AQ,2014,Oregon State,2,0,2,1.0
vs. FBS Power 5,2014,Oregon State,2,7,9,0.2222222222222222
vs. FBS non-Power 5,2014,Oregon State,2,0,2,1.0
in August/September,2014,Oregon State,3,1,4,0.75
in October,2014,Oregon State,1,2,3,0.3333333333333333
in November,2014,Oregon State,1,4,5,0.2
in December/January,2014,Oregon State,0,0,0,
All Games,2015,Oregon State,2,10,12,0.16666666666666666
at Home,2015,Oregon State,2,4,6,0.3333333333333333
on Road/Neutral Site,2015,Oregon State,0,6,6,0.0
vs. Conference,2015,Oregon State,0,9,9,0.0
vs. Non-Conference,2015,Oregon State,2,1,3,0.6666666666666666
vs. Ranked (AP),2015,Oregon State,0,4,4,0.0
vs. Unranked (AP),2015,Oregon State,2,6,8,0.25
vs. FBS (I-A),2015,Oregon State,1,10,11,0.09090909090909091
vs. FCS (I-AA),2015,Oregon State,1,0,1,1.0
vs. FBS Winning,2015,Oregon State,0,9,9,0.0
vs. FBS Non-Winning,2015,Oregon State,1,1,2,0.5
vs. BCS AQ,2015,Oregon State,0,10,10,0.0
vs. BCS non-AQ,2015,Oregon State,1,0,1,1.0
vs. FBS Power 5,2015,Oregon State,0,10,10,0.0
vs. FBS non-Power 5,2015,Oregon State,1,0,1,1.0
in August/September,2015,Oregon State,2,2,4,0.5
in October,2015,Oregon State,0,4,4,0.0
in November,2015,Oregon State,0,4,4,0.0
in December/January,2015,Oregon State,0,0,0,
All Games,2016,Oregon State,4,8,12,0.3333333333333333
at Home,2016,Oregon State,4,3,7,0.5714285714285714
on Road/Neutral Site,2016,Oregon State,0,5,5,0.0
vs. Conference,2016,Oregon State,3,6,9,0.3333333333333333
vs. Non-Conference,2016,Oregon State,1,2,3,0.3333333333333333
vs. Ranked (AP),2016,Oregon State,0,3,3,0.0
vs. Unranked (AP),2016,Oregon State,4,5,9,0.4444444444444444
vs. FBS (I-A),2016,Oregon State,3,8,11,0.2727272727272727
vs. FCS (I-AA),2016,Oregon State,1,0,1,1.0
vs. FBS Winning,2016,Oregon State,0,7,7,0.0
vs. FBS Non-Winning,2016,Oregon State,3,1,4,0.75
vs. BCS AQ,2016,Oregon State,3,7,10,0.3
vs. BCS non-AQ,2016,Oregon State,0,1,1,0.0
vs. FBS Power 5,2016,Oregon State,3,7,10,0.3
vs. FBS non-Power 5,2016,Oregon State,0,1,1,0.0
in August/September,2016,Oregon State,1,2,3,0.3333333333333333
in October,2016,Oregon State,1,4,5,0.2
in November,2016,Oregon State,2,2,4,0.5
in December/January,2016,Oregon State,0,0,0,
All Games,2017,Oregon State,1,11,12,0.08333333333333333
at Home,2017,Oregon State,1,5,6,0.16666666666666666
on Road/Neutral Site,2017,Oregon State,0,6,6,0.0
vs. Conference,2017,Oregon State,0,9,9,0.0
vs. Non-Conference,2017,Oregon State,1,2,3,0.3333333333333333
vs. Ranked (AP),2017,Oregon State,0,3,3,0.0
vs. Unranked (AP),2017,Oregon State,1,8,9,0.1111111111111111
vs. FBS (I-A),2017,Oregon State,0,11,11,0.0
vs. FCS (I-AA),2017,Oregon State,1,0,1,1.0
vs. FBS Winning,2017,Oregon State,0,8,8,0.0
vs. FBS Non-Winning,2017,Oregon State,0,3,3,0.0
vs. BCS AQ,2017,Oregon State,0,10,10,0.0
vs. BCS non-AQ,2017,Oregon State,0,1,1,0.0
vs. FBS Power 5,2017,Oregon State,0,10,10,0.0
vs. FBS non-Power 5,2017,Oregon State,0,1,1,0.0
in August/September,2017,Oregon State,1,4,5,0.2
in October,2017,Oregon State,0,3,3,0.0
in November,2017,Oregon State,0,4,4,0.0
in December/January,2017,Oregon State,0,0,0,
All Games,2018,Oregon State,2,10,12,0.16666666666666666
at Home,2018,Oregon State,1,5,6,0.16666666666666666
on Road/Neutral Site,2018,Oregon State,1,5,6,0.16666666666666666
vs. Conference,2018,Oregon State,1,8,9,0.1111111111111111
vs. Non-Conference,2018,Oregon State,1,2,3,0.3333333333333333
vs. Ranked (AP),2018,Oregon State,0,3,3,0.0
vs. Unranked (AP),2018,Oregon State,2,7,9,0.2222222222222222
vs. FBS (I-A),2018,Oregon State,1,10,11,0.09090909090909091
vs. FCS (I-AA),2018,Oregon State,1,0,1,1.0
vs. FBS Winning,2018,Oregon State,0,8,8,0.0
vs. FBS Non-Winning,2018,Oregon State,1,2,3,0.3333333333333333
vs. BCS AQ,2018,Oregon State,1,9,10,0.1
vs. BCS non-AQ,2018,Oregon State,0,1,1,0.0
vs. FBS Power 5,2018,Oregon State,1,9,10,0.1
vs. FBS non-Power 5,2018,Oregon State,0,1,1,0.0
in August/September,2018,Oregon State,1,4,5,0.2
in October,2018,Oregon State,1,2,3,0.3333333333333333
in November,2018,Oregon State,0,4,4,0.0
in December/January,2018,Oregon State,0,0,0,
All Games,2019,Oregon State,5,7,12,0.4166666666666667
at Home,2019,Oregon State,2,4,6,0.3333333333333333
on Road/Neutral Site,2019,Oregon State,3,3,6,0.5
vs. Conference,2019,Oregon State,4,5,9,0.4444444444444444
vs. Non-Conference,2019,Oregon State,1,2,3,0.3333333333333333
vs. Ranked (AP),2019,Oregon State,0,2,2,0.0
vs. Unranked (AP),2019,Oregon State,5,5,10,0.5
vs. FBS (I-A),2019,Oregon State,4,7,11,0.36363636363636365
vs. FCS (I-AA),2019,Oregon State,1,0,1,1.0
vs. FBS Winning,2019,Oregon State,2,5,7,0.2857142857142857
vs. FBS Non-Winning,2019,Oregon State,2,2,4,0.5
vs. BCS AQ,2019,Oregon State,4,6,10,0.4
vs. BCS non-AQ,2019,Oregon State,0,1,1,0.0
vs. FBS Power 5,2019,Oregon State,4,6,10,0.4
vs. FBS non-Power 5,2019,Oregon State,0,1,1,0.0
in August/September,2019,Oregon State,1,3,4,0.25
in October,2019,Oregon State,2,1,3,0.6666666666666666
in November,2019,Oregon State,2,3,5,0.4
in December/January,2019,Oregon State,0,0,0,
All Games,2020,Oregon State,2,5,7,0.2857142857142857
at Home,2020,Oregon State,2,3,5,0.4
on Road/Neutral Site,2020,Oregon State,0,2,2,0.0
vs. Conference,2020,Oregon State,2,5,7,0.2857142857142857
vs. Non-Conference,2020,Oregon State,0,0,0,
vs. Ranked (AP),2020,Oregon State,1,0,1,1.0
vs. Unranked (AP),2020,Oregon State,1,5,6,0.16666666666666666
vs. FBS (I-A),2020,Oregon State,2,5,7,0.2857142857142857
vs. FCS (I-AA),2020,Oregon State,0,0,0,
vs. FBS Winning,2020,Oregon State,1,3,4,0.25
vs. FBS Non-Winning,2020,Oregon State,1,2,3,0.3333333333333333
vs. BCS AQ,2020,Oregon State,2,5,7,0.2857142857142857
vs. BCS non-AQ,2020,Oregon State,0,0,0,
vs. FBS Power 5,2020,Oregon State,2,5,7,0.2857142857142857
vs. FBS non-Power 5,2020,Oregon State,0,0,0,
in August/September,2020,Oregon State,0,0,0,
in October,2020,Oregon State,0,0,0,
in November,2020,Oregon State,2,2,4,0.5
in December/January,2020,Oregon State,0,3,3,0.0
All Games,2021,Oregon State,7,6,13,0.5384615384615384
at Home,2021,Oregon State,6,0,6,1.0
on Road/Neutral Site,2021,Oregon State,1,6,7,0.14285714285714285
vs. Conference,2021,Oregon State,5,4,9,0.5555555555555556
vs. Non-Conference,2021,Oregon State,2,2,4,0.5
vs. Ranked (AP),2021,Oregon State,1,2,3,0.3333333333333333
vs. Unranked (AP),2021,Oregon State,6,4,10,0.6
vs. FBS (I-A),2021,Oregon State,6,6,12,0.5
vs. FCS (I-AA),2021,Oregon State,1,0,1,1.0
vs. FBS Winning,2021,Oregon State,2,4,6,0.3333333333333333
vs. FBS Non-Winning,2021,Oregon State,4,2,6,0.6666666666666666
vs. BCS AQ,2021,Oregon State,5,5,10,0.5
vs. BCS non-AQ,2021,Oregon State,1,1,2,0.5
vs. FBS Power 5,2021,Oregon State,5,5,10,0.5
vs. FBS non-Power 5,2021,Oregon State,1,1,2,0.5
in August/September,2021,Oregon State,3,1,4,0.75
in October,2021,Oregon State,2,2,4,0.5
in November,2021,Oregon State,2,2,4,0.5
in December/January,2021,Oregon State,0,1,1,0.0
All Games,2022,Oregon State,10,3,13,0.7692307692307693
at Home,2022,Oregon State,5,1,6,0.8333333333333334
on Road/Neutral Site,2022,Oregon State,5,2,7,0.7142857142857143
vs. Conference,2022,Oregon State,6,3,9,0.6666666666666666
vs. Non-Conference,2022,Oregon State,4,0,4,1.0
vs. Ranked (AP),2022,Oregon State,2,3,5,0.4
vs. Unranked (AP),2022,Oregon State,8,0,8,1.0
vs. FBS (I-A),2022,Oregon State,9,3,12,0.75
vs. FCS (I-AA),2022,Oregon State,1,0,1,1.0
vs. FBS Winning,2022,Oregon State,4,3,7,0.5714285714285714
vs. FBS Non-Winning,2022,Oregon State,5,0,5,1.0
vs. BCS AQ,2022,Oregon State,7,3,10,0.7
vs. BCS non-AQ,2022,Oregon State,2,0,2,1.0
vs. FBS Power 5,2022,Oregon State,7,3,10,0.7
vs. FBS non-Power 5,2022,Oregon State,2,0,2,1.0
in August/September,2022,Oregon State,3,1,4,0.75
in October,2022,Oregon State,3,1,4,0.75
in November,2022,Oregon State,3,1,4,0.75
in December/January,2022,Oregon State,1,0,1,1.0
All Games,2009,Penn State,11,2,13,0.8461538461538461
at Home,2009,Penn State,6,2,8,0.75
on Road/Neutral Site,2009,Penn State,5,0,5,1.0
vs. Conference,2009,Penn State,6,2,8,0.75
vs. Non-Conference,2009,Penn State,5,0,5,1.0
vs. Ranked (AP),2009,Penn State,1,2,3,0.3333333333333333
vs. Unranked (AP),2009,Penn State,10,0,10,1.0
vs. FBS (I-A),2009,Penn State,10,2,12,0.8333333333333334
vs. FCS (I-AA),2009,Penn State,1,0,1,1.0
vs. FBS Winning,2009,Penn State,3,2,5,0.6
vs. FBS Non-Winning,2009,Penn State,7,0,7,1.0
vs. BCS AQ,2009,Penn State,8,2,10,0.8
vs. BCS non-AQ,2009,Penn State,2,0,2,1.0
vs. FBS Power 5,2009,Penn State,7,2,9,0.7777777777777778
vs. FBS non-Power 5,2009,Penn State,3,0,3,1.0
in August/September,2009,Penn State,3,1,4,0.75
in October,2009,Penn State,5,0,5,1.0
in November,2009,Penn State,2,1,3,0.6666666666666666
in December/January,2009,Penn State,1,0,1,1.0
All Games,2010,Penn State,7,6,13,0.5384615384615384
at Home,2010,Penn State,5,2,7,0.7142857142857143
on Road/Neutral Site,2010,Penn State,2,4,6,0.3333333333333333
vs. Conference,2010,Penn State,4,4,8,0.5
vs. Non-Conference,2010,Penn State,3,2,5,0.6
vs. Ranked (AP),2010,Penn State,0,3,3,0.0
vs. Unranked (AP),2010,Penn State,7,3,10,0.7
vs. FBS (I-A),2010,Penn State,6,6,12,0.5
vs. FCS (I-AA),2010,Penn State,1,0,1,1.0
vs. FBS Winning,2010,Penn State,3,6,9,0.3333333333333333
vs. FBS Non-Winning,2010,Penn State,3,0,3,1.0
vs. BCS AQ,2010,Penn State,4,6,10,0.4
vs. BCS non-AQ,2010,Penn State,2,0,2,1.0
vs. FBS Power 5,2010,Penn State,4,6,10,0.4
vs. FBS non-Power 5,2010,Penn State,2,0,2,1.0
in August/September,2010,Penn State,3,1,4,0.75
in October,2010,Penn State,2,2,4,0.5
in November,2010,Penn State,2,2,4,0.5
in December/January,2010,Penn State,0,1,1,0.0
All Games,2011,Penn State,9,4,13,0.6923076923076923
at Home,2011,Penn State,5,2,7,0.7142857142857143
on Road/Neutral Site,2011,Penn State,4,2,6,0.6666666666666666
vs. Conference,2011,Penn State,6,2,8,0.75
vs. Non-Conference,2011,Penn State,3,2,5,0.6
vs. Ranked (AP),2011,Penn State,0,4,4,0.0
vs. Unranked (AP),2011,Penn State,9,0,9,1.0
vs. FBS (I-A),2011,Penn State,8,4,12,0.6666666666666666
vs. FCS (I-AA),2011,Penn State,1,0,1,1.0
vs. FBS Winning,2011,Penn State,4,4,8,0.5
vs. FBS Non-Winning,2011,Penn State,4,0,4,1.0
vs. BCS AQ,2011,Penn State,6,3,9,0.6666666666666666
vs. BCS non-AQ,2011,Penn State,2,1,3,0.6666666666666666
vs. FBS Power 5,2011,Penn State,6,3,9,0.6666666666666666
vs. FBS non-Power 5,2011,Penn State,2,1,3,0.6666666666666666
in August/September,2011,Penn State,3,1,4,0.75
in October,2011,Penn State,5,0,5,1.0
in November,2011,Penn State,1,2,3,0.3333333333333333
in December/January,2011,Penn State,0,1,1,0.0
All Games,2012,Penn State,8,4,12,0.6666666666666666
at Home,2012,Penn State,5,2,7,0.7142857142857143
on Road/Neutral Site,2012,Penn State,3,2,5,0.6
vs. Conference,2012,Penn State,6,2,8,0.75
vs. Non-Conference,2012,Penn State,2,2,4,0.5
vs. Ranked (AP),2012,Penn State,1,2,3,0.3333333333333333
vs. Unranked (AP),2012,Penn State,7,2,9,0.7777777777777778
vs. FBS (I-A),2012,Penn State,8,4,12,0.6666666666666666
vs. FCS (I-AA),2012,Penn State,0,0,0,
vs. FBS Winning,2012,Penn State,3,3,6,0.5
vs. FBS Non-Winning,2012,Penn State,5,1,6,0.8333333333333334
vs. BCS AQ,2012,Penn State,7,3,10,0.7
vs. BCS non-AQ,2012,Penn State,1,1,2,0.5
vs. FBS Power 5,2012,Penn State,6,3,9,0.6666666666666666
vs. FBS non-Power 5,2012,Penn State,2,1,3,0.6666666666666666
in August/September,2012,Penn State,3,2,5,0.6
in October,2012,Penn State,2,1,3,0.6666666666666666
in November,2012,Penn State,3,1,4,0.75
in December/January,2012,Penn State,0,0,0,
All Games,2013,Penn State,7,5,12,0.5833333333333334
at Home,2013,Penn State,5,2,7,0.7142857142857143
on Road/Neutral Site,2013,Penn State,2,3,5,0.4
vs. Conference,2013,Penn State,4,4,8,0.5
vs. Non-Conference,2013,Penn State,3,1,4,0.75
vs. Ranked (AP),2013,Penn State,1,2,3,0.3333333333333333
vs. Unranked (AP),2013,Penn State,6,3,9,0.6666666666666666
vs. FBS (I-A),2013,Penn State,7,5,12,0.5833333333333334
vs. FCS (I-AA),2013,Penn State,0,0,0,
vs. FBS Winning,2013,Penn State,3,4,7,0.42857142857142855
vs. FBS Non-Winning,2013,Penn State,4,1,5,0.8
vs. BCS AQ,2013,Penn State,5,5,10,0.5
vs. BCS non-AQ,2013,Penn State,2,0,2,1.0
vs. FBS Power 5,2013,Penn State,5,4,9,0.5555555555555556
vs. FBS non-Power 5,2013,Penn State,2,1,3,0.6666666666666666
in August/September,2013,Penn State,3,1,4,0.75
in October,2013,Penn State,1,2,3,0.3333333333333333
in November,2013,Penn State,3,2,5,0.6
in December/January,2013,Penn State,0,0,0,
All Games,2014,Penn State,7,6,13,0.5384615384615384
at Home,2014,Penn State,3,4,7,0.42857142857142855
on Road/Neutral Site,2014,Penn State,4,2,6,0.6666666666666666
vs. Conference,2014,Penn State,2,6,8,0.25
vs. Non-Conference,2014,Penn State,5,0,5,1.0
vs. Ranked (AP),2014,Penn State,0,2,2,0.0
vs. Unranked (AP),2014,Penn State,7,4,11,0.6363636363636364
vs. FBS (I-A),2014,Penn State,7,6,13,0.5384615384615384
vs. FCS (I-AA),2014,Penn State,0,0,0,
vs. FBS Winning,2014,Penn State,3,3,6,0.5
vs. FBS Non-Winning,2014,Penn State,4,3,7,0.5714285714285714
vs. BCS AQ,2014,Penn State,5,6,11,0.45454545454545453
vs. BCS non-AQ,2014,Penn State,2,0,2,1.0
vs. FBS Power 5,2014,Penn State,3,6,9,0.3333333333333333
vs. FBS non-Power 5,2014,Penn State,4,0,4,1.0
in August/September,2014,Penn State,4,1,5,0.8
in October,2014,Penn State,0,2,2,0.0
in November,2014,Penn State,2,3,5,0.4
in December/January,2014,Penn State,1,0,1,1.0
All Games,2015,Penn State,7,6,13,0.5384615384615384
at Home,2015,Penn State,6,1,7,0.8571428571428571
on Road/Neutral Site,2015,Penn State,1,5,6,0.16666666666666666
vs. Conference,2015,Penn State,4,4,8,0.5
vs. Non-Conference,2015,Penn State,3,2,5,0.6
vs. Ranked (AP),2015,Penn State,0,4,4,0.0
vs. Unranked (AP),2015,Penn State,7,2,9,0.7777777777777778
vs. FBS (I-A),2015,Penn State,7,6,13,0.5384615384615384
vs. FCS (I-AA),2015,Penn State,0,0,0,
vs. FBS Winning,2015,Penn State,1,6,7,0.14285714285714285
vs. FBS Non-Winning,2015,Penn State,6,0,6,1.0
vs. BCS AQ,2015,Penn State,4,6,10,0.4
vs. BCS non-AQ,2015,Penn State,3,0,3,1.0
vs. FBS Power 5,2015,Penn State,4,5,9,0.4444444444444444
vs. FBS non-Power 5,2015,Penn State,3,1,4,0.75
in August/September,2015,Penn State,3,1,4,0.75
in October,2015,Penn State,4,1,5,0.8
in November,2015,Penn State,0,3,3,0.0
in December/January,2015,Penn State,0,1,1,0.0
All Games,2016,Penn State,11,3,14,0.7857142857142857
at Home,2016,Penn State,7,0,7,1.0
on Road/Neutral Site,2016,Penn State,4,3,7,0.5714285714285714
vs. Conference,2016,Penn State,9,1,10,0.9
vs. Non-Conference,2016,Penn State,2,2,4,0.5
vs. Ranked (AP),2016,Penn State,4,3,7,0.5714285714285714
vs. Unranked (AP),2016,Penn State,7,0,7,1.0
vs. FBS (I-A),2016,Penn State,11,3,14,0.7857142857142857
vs. FCS (I-AA),2016,Penn State,0,0,0,
vs. FBS Winning,2016,Penn State,5,3,8,0.625
vs. FBS Non-Winning,2016,Penn State,6,0,6,1.0
vs. BCS AQ,2016,Penn State,10,3,13,0.7692307692307693
vs. BCS non-AQ,2016,Penn State,1,0,1,1.0
vs. FBS Power 5,2016,Penn State,9,3,12,0.75
vs. FBS non-Power 5,2016,Penn State,2,0,2,1.0
in August/September,2016,Penn State,2,2,4,0.5
in October,2016,Penn State,4,0,4,1.0
in November,2016,Penn State,4,0,4,1.0
in December/January,2016,Penn State,1,1,2,0.5
All Games,2017,Penn State,11,2,13,0.8461538461538461
at Home,2017,Penn State,7,0,7,1.0
on Road/Neutral Site,2017,Penn State,4,2,6,0.6666666666666666
vs. Conference,2017,Penn State,7,2,9,0.7777777777777778
vs. Non-Conference,2017,Penn State,4,0,4,1.0
vs. Ranked (AP),2017,Penn State,2,2,4,0.5
vs. Unranked (AP),2017,Penn State,9,0,9,1.0
vs. FBS (I-A),2017,Penn State,11,2,13,0.8461538461538461
vs. FCS (I-AA),2017,Penn State,0,0,0,
vs. FBS Winning,2017,Penn State,5,2,7,0.7142857142857143
vs. FBS Non-Winning,2017,Penn State,6,0,6,1.0
vs. BCS AQ,2017,Penn State,9,2,11,0.8181818181818182
vs. BCS non-AQ,2017,Penn State,2,0,2,1.0
vs. FBS Power 5,2017,Penn State,9,2,11,0.8181818181818182
vs. FBS non-Power 5,2017,Penn State,2,0,2,1.0
in August/September,2017,Penn State,5,0,5,1.0
in October,2017,Penn State,2,1,3,0.6666666666666666
in November,2017,Penn State,3,1,4,0.75
in December/January,2017,Penn State,1,0,1,1.0
All Games,2018,Penn State,9,4,13,0.6923076923076923
at Home,2018,Penn State,5,2,7,0.7142857142857143
on Road/Neutral Site,2018,Penn State,4,2,6,0.6666666666666666
vs. Conference,2018,Penn State,6,3,9,0.6666666666666666
vs. Non-Conference,2018,Penn State,3,1,4,0.75
vs. Ranked (AP),2018,Penn State,1,3,4,0.25
vs. Unranked (AP),2018,Penn State,8,1,9,0.8888888888888888
vs. FBS (I-A),2018,Penn State,9,4,13,0.6923076923076923
vs. FCS (I-AA),2018,Penn State,0,0,0,
vs. FBS Winning,2018,Penn State,3,4,7,0.42857142857142855
vs. FBS Non-Winning,2018,Penn State,6,0,6,1.0
vs. BCS AQ,2018,Penn State,7,4,11,0.6363636363636364
vs. BCS non-AQ,2018,Penn State,2,0,2,1.0
vs. FBS Power 5,2018,Penn State,7,4,11,0.6363636363636364
vs. FBS non-Power 5,2018,Penn State,2,0,2,1.0
in August/September,2018,Penn State,4,1,5,0.8
in October,2018,Penn State,2,1,3,0.6666666666666666
in November,2018,Penn State,3,1,4,0.75
in December/January,2018,Penn State,0,1,1,0.0
All Games,2019,Penn State,11,2,13,0.8461538461538461
at Home,2019,Penn State,7,0,7,1.0
on Road/Neutral Site,2019,Penn State,4,2,6,0.6666666666666666
vs. Conference,2019,Penn State,7,2,9,0.7777777777777778
vs. Non-Conference,2019,Penn State,4,0,4,1.0
vs. Ranked (AP),2019,Penn State,3,2,5,0.6
vs. Unranked (AP),2019,Penn State,8,0,8,1.0
vs. FBS (I-A),2019,Penn State,10,2,12,0.8333333333333334
vs. FCS (I-AA),2019,Penn State,1,0,1,1.0
vs. FBS Winning,2019,Penn State,7,2,9,0.7777777777777778
vs. FBS Non-Winning,2019,Penn State,3,0,3,1.0
vs. BCS AQ,2019,Penn State,9,2,11,0.8181818181818182
vs. BCS non-AQ,2019,Penn State,1,0,1,1.0
vs. FBS Power 5,2019,Penn State,8,2,10,0.8
vs. FBS non-Power 5,2019,Penn State,2,0,2,1.0
in August/September,2019,Penn State,4,0,4,1.0
in October,2019,Penn State,4,0,4,1.0
in November,2019,Penn State,2,2,4,0.5
in December/January,2019,Penn State,1,0,1,1.0
All Games,2020,Penn State,4,5,9,0.4444444444444444
at Home,2020,Penn State,2,3,5,0.4
on Road/Neutral Site,2020,Penn State,2,2,4,0.5
vs. Conference,2020,Penn State,4,5,9,0.4444444444444444
vs. Non-Conference,2020,Penn State,0,0,0,
vs. Ranked (AP),2020,Penn State,0,3,3,0.0
vs. Unranked (AP),2020,Penn State,4,2,6,0.6666666666666666
vs. FBS (I-A),2020,Penn State,4,5,9,0.4444444444444444
vs. FCS (I-AA),2020,Penn State,0,0,0,
vs. FBS Winning,2020,Penn State,0,3,3,0.0
vs. FBS Non-Winning,2020,Penn State,4,2,6,0.6666666666666666
vs. BCS AQ,2020,Penn State,4,5,9,0.4444444444444444
vs. BCS non-AQ,2020,Penn State,0,0,0,
vs. FBS Power 5,2020,Penn State,4,5,9,0.4444444444444444
vs. FBS non-Power 5,2020,Penn State,0,0,0,
in August/September,2020,Penn State,0,0,0,
in October,2020,Penn State,0,2,2,0.0
in November,2020,Penn State,1,3,4,0.25
in December/January,2020,Penn State,3,0,3,1.0
All Games,2021,Penn State,7,6,13,0.5384615384615384
at Home,2021,Penn State,5,2,7,0.7142857142857143
on Road/Neutral Site,2021,Penn State,2,4,6,0.3333333333333333
vs. Conference,2021,Penn State,4,5,9,0.4444444444444444
vs. Non-Conference,2021,Penn State,3,1,4,0.75
vs. Ranked (AP),2021,Penn State,0,5,5,0.0
vs. Unranked (AP),2021,Penn State,7,1,8,0.875
vs. FBS (I-A),2021,Penn State,6,6,12,0.5
vs. FCS (I-AA),2021,Penn State,1,0,1,1.0
vs. FBS Winning,2021,Penn State,2,5,7,0.2857142857142857
vs. FBS Non-Winning,2021,Penn State,4,1,5,0.8
vs. BCS AQ,2021,Penn State,5,6,11,0.45454545454545453
vs. BCS non-AQ,2021,Penn State,1,0,1,1.0
vs. FBS Power 5,2021,Penn State,5,6,11,0.45454545454545453
vs. FBS non-Power 5,2021,Penn State,1,0,1,1.0
in August/September,2021,Penn State,4,0,4,1.0
in October,2021,Penn State,1,3,4,0.25
in November,2021,Penn State,2,2,4,0.5
in December/January,2021,Penn State,0,1,1,0.0
All Games,2022,Penn State,11,2,13,0.8461538461538461
at Home,2022,Penn State,6,1,7,0.8571428571428571
on Road/Neutral Site,2022,Penn State,5,1,6,0.8333333333333334
vs. Conference,2022,Penn State,7,2,9,0.7777777777777778
vs. Non-Conference,2022,Penn State,4,0,4,1.0
vs. Ranked (AP),2022,Penn State,1,2,3,0.3333333333333333
vs. Unranked (AP),2022,Penn State,10,0,10,1.0
vs. FBS (I-A),2022,Penn State,11,2,13,0.8461538461538461
vs. FCS (I-AA),2022,Penn State,0,0,0,
vs. FBS Winning,2022,Penn State,5,2,7,0.7142857142857143
vs. FBS Non-Winning,2022,Penn State,6,0,6,1.0
vs. BCS AQ,2022,Penn State,9,2,11,0.8181818181818182
vs. BCS non-AQ,2022,Penn State,2,0,2,1.0
vs. FBS Power 5,2022,Penn State,9,2,11,0.8181818181818182
vs. FBS non-Power 5,2022,Penn State,2,0,2,1.0
in August/September,2022,Penn State,4,0,4,1.0
in October,2022,Penn State,2,2,4,0.5
in November,2022,Penn State,4,0,4,1.0
in December/January,2022,Penn State,1,0,1,1.0
All Games,2009,Pittsburgh,10,3,13,0.7692307692307693
at Home,2009,Pittsburgh,6,1,7,0.8571428571428571
on Road/Neutral Site,2009,Pittsburgh,4,2,6,0.6666666666666666
vs. Conference,2009,Pittsburgh,5,2,7,0.7142857142857143
vs. Non-Conference,2009,Pittsburgh,5,1,6,0.8333333333333334
vs. Ranked (AP),2009,Pittsburgh,0,2,2,0.0
vs. Unranked (AP),2009,Pittsburgh,10,1,11,0.9090909090909091
vs. FBS (I-A),2009,Pittsburgh,9,3,12,0.75
vs. FCS (I-AA),2009,Pittsburgh,1,0,1,1.0
vs. FBS Winning,2009,Pittsburgh,5,2,7,0.7142857142857143
vs. FBS Non-Winning,2009,Pittsburgh,4,1,5,0.8
vs. BCS AQ,2009,Pittsburgh,7,3,10,0.7
vs. BCS non-AQ,2009,Pittsburgh,2,0,2,1.0
vs. FBS Power 5,2009,Pittsburgh,1,1,2,0.5
vs. FBS non-Power 5,2009,Pittsburgh,8,2,10,0.8
in August/September,2009,Pittsburgh,3,1,4,0.75
in October,2009,Pittsburgh,4,0,4,1.0
in November,2009,Pittsburgh,2,1,3,0.6666666666666666
in December/January,2009,Pittsburgh,1,1,2,0.5
All Games,2010,Pittsburgh,8,5,13,0.6153846153846154
at Home,2010,Pittsburgh,4,2,6,0.6666666666666666
on Road/Neutral Site,2010,Pittsburgh,4,3,7,0.5714285714285714
vs. Conference,2010,Pittsburgh,5,2,7,0.7142857142857143
vs. Non-Conference,2010,Pittsburgh,3,3,6,0.5
vs. Ranked (AP),2010,Pittsburgh,0,0,0,
vs. Unranked (AP),2010,Pittsburgh,8,5,13,0.6153846153846154
vs. FBS (I-A),2010,Pittsburgh,7,5,12,0.5833333333333334
vs. FCS (I-AA),2010,Pittsburgh,1,0,1,1.0
vs. FBS Winning,2010,Pittsburgh,4,5,9,0.4444444444444444
vs. FBS Non-Winning,2010,Pittsburgh,3,0,3,1.0
vs. BCS AQ,2010,Pittsburgh,6,4,10,0.6
vs. BCS non-AQ,2010,Pittsburgh,1,1,2,0.5
vs. FBS Power 5,2010,Pittsburgh,1,1,2,0.5
vs. FBS non-Power 5,2010,Pittsburgh,6,4,10,0.6
in August/September,2010,Pittsburgh,1,2,3,0.3333333333333333
in October,2010,Pittsburgh,4,1,5,0.8
in November,2010,Pittsburgh,1,2,3,0.3333333333333333
in December/January,2010,Pittsburgh,2,0,2,1.0
All Games,2011,Pittsburgh,6,7,13,0.46153846153846156
at Home,2011,Pittsburgh,5,3,8,0.625
on Road/Neutral Site,2011,Pittsburgh,1,4,5,0.2
vs. Conference,2011,Pittsburgh,4,3,7,0.5714285714285714
vs. Non-Conference,2011,Pittsburgh,2,4,6,0.3333333333333333
vs. Ranked (AP),2011,Pittsburgh,0,2,2,0.0
vs. Unranked (AP),2011,Pittsburgh,6,5,11,0.5454545454545454
vs. FBS (I-A),2011,Pittsburgh,5,7,12,0.4166666666666667
vs. FCS (I-AA),2011,Pittsburgh,1,0,1,1.0
vs. FBS Winning,2011,Pittsburgh,1,7,8,0.125
vs. FBS Non-Winning,2011,Pittsburgh,4,0,4,1.0
vs. BCS AQ,2011,Pittsburgh,4,6,10,0.4
vs. BCS non-AQ,2011,Pittsburgh,1,1,2,0.5
vs. FBS Power 5,2011,Pittsburgh,0,2,2,0.0
vs. FBS non-Power 5,2011,Pittsburgh,5,5,10,0.5
in August/September,2011,Pittsburgh,3,2,5,0.6
in October,2011,Pittsburgh,1,2,3,0.3333333333333333
in November,2011,Pittsburgh,1,2,3,0.3333333333333333
in December/January,2011,Pittsburgh,1,1,2,0.5
All Games,2012,Pittsburgh,6,7,13,0.46153846153846156
at Home,2012,Pittsburgh,4,2,6,0.6666666666666666
on Road/Neutral Site,2012,Pittsburgh,2,5,7,0.2857142857142857
vs. Conference,2012,Pittsburgh,3,4,7,0.42857142857142855
vs. Non-Conference,2012,Pittsburgh,3,3,6,0.5
vs. Ranked (AP),2012,Pittsburgh,0,2,2,0.0
vs. Unranked (AP),2012,Pittsburgh,6,5,11,0.5454545454545454
vs. FBS (I-A),2012,Pittsburgh,5,6,11,0.45454545454545453
vs. FCS (I-AA),2012,Pittsburgh,1,1,2,0.5
vs. FBS Winning,2012,Pittsburgh,2,5,7,0.2857142857142857
vs. FBS Non-Winning,2012,Pittsburgh,3,1,4,0.75
vs. BCS AQ,2012,Pittsburgh,4,6,10,0.4
vs. BCS non-AQ,2012,Pittsburgh,1,0,1,1.0
vs. FBS Power 5,2012,Pittsburgh,1,1,2,0.5
vs. FBS non-Power 5,2012,Pittsburgh,4,5,9,0.4444444444444444
in August/September,2012,Pittsburgh,2,2,4,0.5
in October,2012,Pittsburgh,2,2,4,0.5
in November,2012,Pittsburgh,1,2,3,0.3333333333333333
in December/January,2012,Pittsburgh,1,1,2,0.5
All Games,2013,Pittsburgh,7,6,13,0.5384615384615384
at Home,2013,Pittsburgh,4,3,7,0.5714285714285714
on Road/Neutral Site,2013,Pittsburgh,3,3,6,0.5
vs. Conference,2013,Pittsburgh,3,5,8,0.375
vs. Non-Conference,2013,Pittsburgh,4,1,5,0.8
vs. Ranked (AP),2013,Pittsburgh,2,1,3,0.6666666666666666
vs. Unranked (AP),2013,Pittsburgh,5,5,10,0.5
vs. FBS (I-A),2013,Pittsburgh,6,6,12,0.5
vs. FCS (I-AA),2013,Pittsburgh,1,0,1,1.0
vs. FBS Winning,2013,Pittsburgh,4,6,10,0.4
vs. FBS Non-Winning,2013,Pittsburgh,2,0,2,1.0
vs. BCS AQ,2013,Pittsburgh,4,5,9,0.4444444444444444
vs. BCS non-AQ,2013,Pittsburgh,2,1,3,0.6666666666666666
vs. FBS Power 5,2013,Pittsburgh,3,5,8,0.375
vs. FBS non-Power 5,2013,Pittsburgh,3,1,4,0.75
in August/September,2013,Pittsburgh,3,1,4,0.75
in October,2013,Pittsburgh,1,2,3,0.3333333333333333
in November,2013,Pittsburgh,2,3,5,0.4
in December/January,2013,Pittsburgh,1,0,1,1.0
All Games,2014,Pittsburgh,6,7,13,0.46153846153846156
at Home,2014,Pittsburgh,3,4,7,0.42857142857142855
on Road/Neutral Site,2014,Pittsburgh,3,3,6,0.5
vs. Conference,2014,Pittsburgh,4,4,8,0.5
vs. Non-Conference,2014,Pittsburgh,2,3,5,0.4
vs. Ranked (AP),2014,Pittsburgh,0,1,1,0.0
vs. Unranked (AP),2014,Pittsburgh,6,6,12,0.5
vs. FBS (I-A),2014,Pittsburgh,5,7,12,0.4166666666666667
vs. FCS (I-AA),2014,Pittsburgh,1,0,1,1.0
vs. FBS Winning,2014,Pittsburgh,2,4,6,0.3333333333333333
vs. FBS Non-Winning,2014,Pittsburgh,3,3,6,0.5
vs. BCS AQ,2014,Pittsburgh,4,6,10,0.4
vs. BCS non-AQ,2014,Pittsburgh,1,1,2,0.5
vs. FBS Power 5,2014,Pittsburgh,4,5,9,0.4444444444444444
vs. FBS non-Power 5,2014,Pittsburgh,1,2,3,0.3333333333333333
in August/September,2014,Pittsburgh,3,2,5,0.6
in October,2014,Pittsburgh,1,2,3,0.3333333333333333
in November,2014,Pittsburgh,2,2,4,0.5
in December/January,2014,Pittsburgh,0,1,1,0.0
All Games,2015,Pittsburgh,8,5,13,0.6153846153846154
at Home,2015,Pittsburgh,3,3,6,0.5
on Road/Neutral Site,2015,Pittsburgh,5,2,7,0.7142857142857143
vs. Conference,2015,Pittsburgh,6,2,8,0.75
vs. Non-Conference,2015,Pittsburgh,2,3,5,0.4
vs. Ranked (AP),2015,Pittsburgh,0,4,4,0.0
vs. Unranked (AP),2015,Pittsburgh,8,1,9,0.8888888888888888
vs. FBS (I-A),2015,Pittsburgh,7,5,12,0.5833333333333334
vs. FCS (I-AA),2015,Pittsburgh,1,0,1,1.0
vs. FBS Winning,2015,Pittsburgh,4,5,9,0.4444444444444444
vs. FBS Non-Winning,2015,Pittsburgh,3,0,3,1.0
vs. BCS AQ,2015,Pittsburgh,6,5,11,0.5454545454545454
vs. BCS non-AQ,2015,Pittsburgh,1,0,1,1.0
vs. FBS Power 5,2015,Pittsburgh,6,3,9,0.6666666666666666
vs. FBS non-Power 5,2015,Pittsburgh,1,2,3,0.3333333333333333
in August/September,2015,Pittsburgh,2,1,3,0.6666666666666666
in October,2015,Pittsburgh,4,1,5,0.8
in November,2015,Pittsburgh,2,2,4,0.5
in December/January,2015,Pittsburgh,0,1,1,0.0
All Games,2016,Pittsburgh,8,5,13,0.6153846153846154
at Home,2016,Pittsburgh,6,1,7,0.8571428571428571
on Road/Neutral Site,2016,Pittsburgh,2,4,6,0.3333333333333333
vs. Conference,2016,Pittsburgh,5,3,8,0.625
vs. Non-Conference,2016,Pittsburgh,3,2,5,0.6
vs. Ranked (AP),2016,Pittsburgh,2,2,4,0.5
vs. Unranked (AP),2016,Pittsburgh,6,3,9,0.6666666666666666
vs. FBS (I-A),2016,Pittsburgh,7,5,12,0.5833333333333334
vs. FCS (I-AA),2016,Pittsburgh,1,0,1,1.0
vs. FBS Winning,2016,Pittsburgh,3,5,8,0.375
vs. FBS Non-Winning,2016,Pittsburgh,4,0,4,1.0
vs. BCS AQ,2016,Pittsburgh,6,5,11,0.5454545454545454
vs. BCS non-AQ,2016,Pittsburgh,1,0,1,1.0
vs. FBS Power 5,2016,Pittsburgh,6,5,11,0.5454545454545454
vs. FBS non-Power 5,2016,Pittsburgh,1,0,1,1.0
in August/September,2016,Pittsburgh,2,2,4,0.5
in October,2016,Pittsburgh,3,1,4,0.75
in November,2016,Pittsburgh,3,1,4,0.75
in December/January,2016,Pittsburgh,0,1,1,0.0
All Games,2017,Pittsburgh,5,7,12,0.4166666666666667
at Home,2017,Pittsburgh,4,3,7,0.5714285714285714
on Road/Neutral Site,2017,Pittsburgh,1,4,5,0.2
vs. Conference,2017,Pittsburgh,3,5,8,0.375
vs. Non-Conference,2017,Pittsburgh,2,2,4,0.5
vs. Ranked (AP),2017,Pittsburgh,1,4,5,0.2
vs. Unranked (AP),2017,Pittsburgh,4,3,7,0.5714285714285714
vs. FBS (I-A),2017,Pittsburgh,4,7,11,0.36363636363636365
vs. FCS (I-AA),2017,Pittsburgh,1,0,1,1.0
vs. FBS Winning,2017,Pittsburgh,2,4,6,0.3333333333333333
vs. FBS Non-Winning,2017,Pittsburgh,2,3,5,0.4
vs. BCS AQ,2017,Pittsburgh,3,7,10,0.3
vs. BCS non-AQ,2017,Pittsburgh,1,0,1,1.0
vs. FBS Power 5,2017,Pittsburgh,3,7,10,0.3
vs. FBS non-Power 5,2017,Pittsburgh,1,0,1,1.0
in August/September,2017,Pittsburgh,2,3,5,0.4
in October,2017,Pittsburgh,2,2,4,0.5
in November,2017,Pittsburgh,1,2,3,0.3333333333333333
in December/January,2017,Pittsburgh,0,0,0,
All Games,2018,Pittsburgh,7,7,14,0.5
at Home,2018,Pittsburgh,5,1,6,0.8333333333333334
on Road/Neutral Site,2018,Pittsburgh,2,6,8,0.25
vs. Conference,2018,Pittsburgh,6,3,9,0.6666666666666666
vs. Non-Conference,2018,Pittsburgh,1,4,5,0.2
vs. Ranked (AP),2018,Pittsburgh,1,4,5,0.2
vs. Unranked (AP),2018,Pittsburgh,6,3,9,0.6666666666666666
vs. FBS (I-A),2018,Pittsburgh,6,7,13,0.46153846153846156
vs. FCS (I-AA),2018,Pittsburgh,1,0,1,1.0
vs. FBS Winning,2018,Pittsburgh,5,6,11,0.45454545454545453
vs. FBS Non-Winning,2018,Pittsburgh,1,1,2,0.5
vs. BCS AQ,2018,Pittsburgh,6,7,13,0.46153846153846156
vs. BCS non-AQ,2018,Pittsburgh,0,0,0,
vs. FBS Power 5,2018,Pittsburgh,6,5,11,0.5454545454545454
vs. FBS non-Power 5,2018,Pittsburgh,0,2,2,0.0
in August/September,2018,Pittsburgh,2,3,5,0.4
in October,2018,Pittsburgh,2,1,3,0.6666666666666666
in November,2018,Pittsburgh,3,1,4,0.75
in December/January,2018,Pittsburgh,0,2,2,0.0
All Games,2019,Pittsburgh,8,5,13,0.6153846153846154
at Home,2019,Pittsburgh,4,3,7,0.5714285714285714
on Road/Neutral Site,2019,Pittsburgh,4,2,6,0.6666666666666666
vs. Conference,2019,Pittsburgh,4,4,8,0.5
vs. Non-Conference,2019,Pittsburgh,4,1,5,0.8
vs. Ranked (AP),2019,Pittsburgh,1,1,2,0.5
vs. Unranked (AP),2019,Pittsburgh,7,4,11,0.6363636363636364
vs. FBS (I-A),2019,Pittsburgh,7,5,12,0.5833333333333334
vs. FCS (I-AA),2019,Pittsburgh,1,0,1,1.0
vs. FBS Winning,2019,Pittsburgh,3,3,6,0.5
vs. FBS Non-Winning,2019,Pittsburgh,4,2,6,0.6666666666666666
vs. BCS AQ,2019,Pittsburgh,5,5,10,0.5
vs. BCS non-AQ,2019,Pittsburgh,2,0,2,1.0
vs. FBS Power 5,2019,Pittsburgh,4,5,9,0.4444444444444444
vs. FBS non-Power 5,2019,Pittsburgh,3,0,3,1.0
in August/September,2019,Pittsburgh,3,2,5,0.6
in October,2019,Pittsburgh,2,1,3,0.6666666666666666
in November,2019,Pittsburgh,2,2,4,0.5
in December/January,2019,Pittsburgh,1,0,1,1.0
All Games,2020,Pittsburgh,6,5,11,0.5454545454545454
at Home,2020,Pittsburgh,4,2,6,0.6666666666666666
on Road/Neutral Site,2020,Pittsburgh,2,3,5,0.4
vs. Conference,2020,Pittsburgh,5,5,10,0.5
vs. Non-Conference,2020,Pittsburgh,1,0,1,1.0
vs. Ranked (AP),2020,Pittsburgh,0,4,4,0.0
vs. Unranked (AP),2020,Pittsburgh,6,1,7,0.8571428571428571
vs. FBS (I-A),2020,Pittsburgh,5,5,10,0.5
vs. FCS (I-AA),2020,Pittsburgh,1,0,1,1.0
vs. FBS Winning,2020,Pittsburgh,0,5,5,0.0
vs. FBS Non-Winning,2020,Pittsburgh,5,0,5,1.0
vs. BCS AQ,2020,Pittsburgh,5,5,10,0.5
vs. BCS non-AQ,2020,Pittsburgh,0,0,0,
vs. FBS Power 5,2020,Pittsburgh,5,5,10,0.5
vs. FBS non-Power 5,2020,Pittsburgh,0,0,0,
in August/September,2020,Pittsburgh,3,0,3,1.0
in October,2020,Pittsburgh,0,4,4,0.0
in November,2020,Pittsburgh,2,1,3,0.6666666666666666
in December/January,2020,Pittsburgh,1,0,1,1.0
All Games,2021,Pittsburgh,11,3,14,0.7857142857142857
at Home,2021,Pittsburgh,5,2,7,0.7142857142857143
on Road/Neutral Site,2021,Pittsburgh,6,1,7,0.8571428571428571
vs. Conference,2021,Pittsburgh,8,1,9,0.8888888888888888
vs. Non-Conference,2021,Pittsburgh,3,2,5,0.6
vs. Ranked (AP),2021,Pittsburgh,2,1,3,0.6666666666666666
vs. Unranked (AP),2021,Pittsburgh,9,2,11,0.8181818181818182
vs. FBS (I-A),2021,Pittsburgh,10,3,13,0.7692307692307693
vs. FCS (I-AA),2021,Pittsburgh,1,0,1,1.0
vs. FBS Winning,2021,Pittsburgh,3,3,6,0.5
vs. FBS Non-Winning,2021,Pittsburgh,7,0,7,1.0
vs. BCS AQ,2021,Pittsburgh,9,2,11,0.8181818181818182
vs. BCS non-AQ,2021,Pittsburgh,1,1,2,0.5
vs. FBS Power 5,2021,Pittsburgh,9,2,11,0.8181818181818182
vs. FBS non-Power 5,2021,Pittsburgh,1,1,2,0.5
in August/September,2021,Pittsburgh,3,1,4,0.75
in October,2021,Pittsburgh,3,1,4,0.75
in November,2021,Pittsburgh,4,0,4,1.0
in December/January,2021,Pittsburgh,1,1,2,0.5
All Games,2022,Pittsburgh,9,4,13,0.6923076923076923
at Home,2022,Pittsburgh,5,2,7,0.7142857142857143
on Road/Neutral Site,2022,Pittsburgh,4,2,6,0.6666666666666666
vs. Conference,2022,Pittsburgh,5,3,8,0.625
vs. Non-Conference,2022,Pittsburgh,4,1,5,0.8
vs. Ranked (AP),2022,Pittsburgh,1,1,2,0.5
vs. Unranked (AP),2022,Pittsburgh,8,3,11,0.7272727272727273
vs. FBS (I-A),2022,Pittsburgh,8,4,12,0.6666666666666666
vs. FCS (I-AA),2022,Pittsburgh,1,0,1,1.0
vs. FBS Winning,2022,Pittsburgh,3,3,6,0.5
vs. FBS Non-Winning,2022,Pittsburgh,5,1,6,0.8333333333333334
vs. BCS AQ,2022,Pittsburgh,7,4,11,0.6363636363636364
vs. BCS non-AQ,2022,Pittsburgh,1,0,1,1.0
vs. FBS Power 5,2022,Pittsburgh,7,4,11,0.6363636363636364
vs. FBS non-Power 5,2022,Pittsburgh,1,0,1,1.0
in August/September,2022,Pittsburgh,3,1,4,0.75
in October,2022,Pittsburgh,1,3,4,0.25
in November,2022,Pittsburgh,4,0,4,1.0
in December/January,2022,Pittsburgh,1,0,1,1.0
All Games,2009,Purdue,5,7,12,0.4166666666666667
at Home,2009,Purdue,3,4,7,0.42857142857142855
on Road/Neutral Site,2009,Purdue,2,3,5,0.4
vs. Conference,2009,Purdue,4,4,8,0.5
vs. Non-Conference,2009,Purdue,1,3,4,0.25
vs. Ranked (AP),2009,Purdue,1,2,3,0.3333333333333333
vs. Unranked (AP),2009,Purdue,4,5,9,0.4444444444444444
vs. FBS (I-A),2009,Purdue,5,7,12,0.4166666666666667
vs. FCS (I-AA),2009,Purdue,0,0,0,
vs. FBS Winning,2009,Purdue,1,4,5,0.2
vs. FBS Non-Winning,2009,Purdue,4,3,7,0.5714285714285714
vs. BCS AQ,2009,Purdue,4,6,10,0.4
vs. BCS non-AQ,2009,Purdue,1,1,2,0.5
vs. FBS Power 5,2009,Purdue,4,5,9,0.4444444444444444
vs. FBS non-Power 5,2009,Purdue,1,2,3,0.3333333333333333
in August/September,2009,Purdue,1,3,4,0.25
in October,2009,Purdue,2,3,5,0.4
in November,2009,Purdue,2,1,3,0.6666666666666666
in December/January,2009,Purdue,0,0,0,
All Games,2010,Purdue,4,8,12,0.3333333333333333
at Home,2010,Purdue,3,4,7,0.42857142857142855
on Road/Neutral Site,2010,Purdue,1,4,5,0.2
vs. Conference,2010,Purdue,2,6,8,0.25
vs. Non-Conference,2010,Purdue,2,2,4,0.5
vs. Ranked (AP),2010,Purdue,0,3,3,0.0
vs. Unranked (AP),2010,Purdue,4,5,9,0.4444444444444444
vs. FBS (I-A),2010,Purdue,3,8,11,0.2727272727272727
vs. FCS (I-AA),2010,Purdue,1,0,1,1.0
vs. FBS Winning,2010,Purdue,1,7,8,0.125
vs. FBS Non-Winning,2010,Purdue,2,1,3,0.6666666666666666
vs. BCS AQ,2010,Purdue,2,7,9,0.2222222222222222
vs. BCS non-AQ,2010,Purdue,1,1,2,0.5
vs. FBS Power 5,2010,Purdue,2,6,8,0.25
vs. FBS non-Power 5,2010,Purdue,1,2,3,0.3333333333333333
in August/September,2010,Purdue,2,2,4,0.5
in October,2010,Purdue,2,2,4,0.5
in November,2010,Purdue,0,4,4,0.0
in December/January,2010,Purdue,0,0,0,
All Games,2011,Purdue,7,6,13,0.5384615384615384
at Home,2011,Purdue,5,2,7,0.7142857142857143
on Road/Neutral Site,2011,Purdue,2,4,6,0.3333333333333333
vs. Conference,2011,Purdue,4,4,8,0.5
vs. Non-Conference,2011,Purdue,3,2,5,0.6
vs. Ranked (AP),2011,Purdue,0,2,2,0.0
vs. Unranked (AP),2011,Purdue,7,4,11,0.6363636363636364
vs. FBS (I-A),2011,Purdue,6,6,12,0.5
vs. FCS (I-AA),2011,Purdue,1,0,1,1.0
vs. FBS Winning,2011,Purdue,2,5,7,0.2857142857142857
vs. FBS Non-Winning,2011,Purdue,4,1,5,0.8
vs. BCS AQ,2011,Purdue,4,5,9,0.4444444444444444
vs. BCS non-AQ,2011,Purdue,2,1,3,0.6666666666666666
vs. FBS Power 5,2011,Purdue,4,4,8,0.5
vs. FBS non-Power 5,2011,Purdue,2,2,4,0.5
in August/September,2011,Purdue,2,1,3,0.6666666666666666
in October,2011,Purdue,2,3,5,0.4
in November,2011,Purdue,2,2,4,0.5
in December/January,2011,Purdue,1,0,1,1.0
All Games,2012,Purdue,6,7,13,0.46153846153846156
at Home,2012,Purdue,4,3,7,0.5714285714285714
on Road/Neutral Site,2012,Purdue,2,4,6,0.3333333333333333
vs. Conference,2012,Purdue,3,5,8,0.375
vs. Non-Conference,2012,Purdue,3,2,5,0.6
vs. Ranked (AP),2012,Purdue,0,3,3,0.0
vs. Unranked (AP),2012,Purdue,6,4,10,0.6
vs. FBS (I-A),2012,Purdue,5,7,12,0.4166666666666667
vs. FCS (I-AA),2012,Purdue,1,0,1,1.0
vs. FBS Winning,2012,Purdue,0,6,6,0.0
vs. FBS Non-Winning,2012,Purdue,5,1,6,0.8333333333333334
vs. BCS AQ,2012,Purdue,3,7,10,0.3
vs. BCS non-AQ,2012,Purdue,2,0,2,1.0
vs. FBS Power 5,2012,Purdue,3,6,9,0.3333333333333333
vs. FBS non-Power 5,2012,Purdue,2,1,3,0.6666666666666666
in August/September,2012,Purdue,3,1,4,0.75
in October,2012,Purdue,0,4,4,0.0
in November,2012,Purdue,3,1,4,0.75
in December/January,2012,Purdue,0,1,1,0.0
All Games,2013,Purdue,1,11,12,0.08333333333333333
at Home,2013,Purdue,1,6,7,0.14285714285714285
on Road/Neutral Site,2013,Purdue,0,5,5,0.0
vs. Conference,2013,Purdue,0,8,8,0.0
vs. Non-Conference,2013,Purdue,1,3,4,0.25
vs. Ranked (AP),2013,Purdue,0,4,4,0.0
vs. Unranked (AP),2013,Purdue,1,7,8,0.125
vs. FBS (I-A),2013,Purdue,0,11,11,0.0
vs. FCS (I-AA),2013,Purdue,1,0,1,1.0
vs. FBS Winning,2013,Purdue,0,9,9,0.0
vs. FBS Non-Winning,2013,Purdue,0,2,2,0.0
vs. BCS AQ,2013,Purdue,0,10,10,0.0
vs. BCS non-AQ,2013,Purdue,0,1,1,0.0
vs. FBS Power 5,2013,Purdue,0,8,8,0.0
vs. FBS non-Power 5,2013,Purdue,0,3,3,0.0
in August/September,2013,Purdue,1,4,5,0.2
in October,2013,Purdue,0,2,2,0.0
in November,2013,Purdue,0,5,5,0.0
in December/January,2013,Purdue,0,0,0,
All Games,2014,Purdue,3,9,12,0.25
at Home,2014,Purdue,2,5,7,0.2857142857142857
on Road/Neutral Site,2014,Purdue,1,4,5,0.2
vs. Conference,2014,Purdue,1,7,8,0.125
vs. Non-Conference,2014,Purdue,2,2,4,0.5
vs. Ranked (AP),2014,Purdue,0,2,2,0.0
vs. Unranked (AP),2014,Purdue,3,7,10,0.3
vs. FBS (I-A),2014,Purdue,2,9,11,0.18181818181818182
vs. FCS (I-AA),2014,Purdue,1,0,1,1.0
vs. FBS Winning,2014,Purdue,1,7,8,0.125
vs. FBS Non-Winning,2014,Purdue,1,2,3,0.3333333333333333
vs. BCS AQ,2014,Purdue,1,8,9,0.1111111111111111
vs. BCS non-AQ,2014,Purdue,1,1,2,0.5
vs. FBS Power 5,2014,Purdue,1,7,8,0.125
vs. FBS non-Power 5,2014,Purdue,1,2,3,0.3333333333333333
in August/September,2014,Purdue,2,3,5,0.4
in October,2014,Purdue,1,2,3,0.3333333333333333
in November,2014,Purdue,0,4,4,0.0
in December/January,2014,Purdue,0,0,0,
All Games,2015,Purdue,2,10,12,0.16666666666666666
at Home,2015,Purdue,2,5,7,0.2857142857142857
on Road/Neutral Site,2015,Purdue,0,5,5,0.0
vs. Conference,2015,Purdue,1,7,8,0.125
vs. Non-Conference,2015,Purdue,1,3,4,0.25
vs. Ranked (AP),2015,Purdue,0,4,4,0.0
vs. Unranked (AP),2015,Purdue,2,6,8,0.25
vs. FBS (I-A),2015,Purdue,1,10,11,0.09090909090909091
vs. FCS (I-AA),2015,Purdue,1,0,1,1.0
vs. FBS Winning,2015,Purdue,0,7,7,0.0
vs. FBS Non-Winning,2015,Purdue,1,3,4,0.25
vs. BCS AQ,2015,Purdue,1,8,9,0.1111111111111111
vs. BCS non-AQ,2015,Purdue,0,2,2,0.0
vs. FBS Power 5,2015,Purdue,1,8,9,0.1111111111111111
vs. FBS non-Power 5,2015,Purdue,0,2,2,0.0
in August/September,2015,Purdue,1,3,4,0.25
in October,2015,Purdue,1,3,4,0.25
in November,2015,Purdue,0,4,4,0.0
in December/January,2015,Purdue,0,0,0,
All Games,2016,Purdue,3,9,12,0.25
at Home,2016,Purdue,2,5,7,0.2857142857142857
on Road/Neutral Site,2016,Purdue,1,4,5,0.2
vs. Conference,2016,Purdue,1,8,9,0.1111111111111111
vs. Non-Conference,2016,Purdue,2,1,3,0.6666666666666666
vs. Ranked (AP),2016,Purdue,0,4,4,0.0
vs. Unranked (AP),2016,Purdue,3,5,8,0.375
vs. FBS (I-A),2016,Purdue,2,9,11,0.18181818181818182
vs. FCS (I-AA),2016,Purdue,1,0,1,1.0
vs. FBS Winning,2016,Purdue,0,6,6,0.0
vs. FBS Non-Winning,2016,Purdue,2,3,5,0.4
vs. BCS AQ,2016,Purdue,1,9,10,0.1
vs. BCS non-AQ,2016,Purdue,1,0,1,1.0
vs. FBS Power 5,2016,Purdue,1,8,9,0.1111111111111111
vs. FBS non-Power 5,2016,Purdue,1,1,2,0.5
in August/September,2016,Purdue,2,1,3,0.6666666666666666
in October,2016,Purdue,1,4,5,0.2
in November,2016,Purdue,0,4,4,0.0
in December/January,2016,Purdue,0,0,0,
All Games,2017,Purdue,7,6,13,0.5384615384615384
at Home,2017,Purdue,4,2,6,0.6666666666666666
on Road/Neutral Site,2017,Purdue,3,4,7,0.42857142857142855
vs. Conference,2017,Purdue,4,5,9,0.4444444444444444
vs. Non-Conference,2017,Purdue,3,1,4,0.75
vs. Ranked (AP),2017,Purdue,0,2,2,0.0
vs. Unranked (AP),2017,Purdue,7,4,11,0.6363636363636364
vs. FBS (I-A),2017,Purdue,7,6,13,0.5384615384615384
vs. FCS (I-AA),2017,Purdue,0,0,0,
vs. FBS Winning,2017,Purdue,4,4,8,0.5
vs. FBS Non-Winning,2017,Purdue,3,2,5,0.6
vs. BCS AQ,2017,Purdue,6,6,12,0.5
vs. BCS non-AQ,2017,Purdue,1,0,1,1.0
vs. FBS Power 5,2017,Purdue,6,6,12,0.5
vs. FBS non-Power 5,2017,Purdue,1,0,1,1.0
in August/September,2017,Purdue,2,2,4,0.5
in October,2017,Purdue,1,3,4,0.25
in November,2017,Purdue,3,1,4,0.75
in December/January,2017,Purdue,1,0,1,1.0
All Games,2018,Purdue,6,7,13,0.46153846153846156
at Home,2018,Purdue,3,4,7,0.42857142857142855
on Road/Neutral Site,2018,Purdue,3,3,6,0.5
vs. Conference,2018,Purdue,5,4,9,0.5555555555555556
vs. Non-Conference,2018,Purdue,1,3,4,0.25
vs. Ranked (AP),2018,Purdue,2,1,3,0.6666666666666666
vs. Unranked (AP),2018,Purdue,4,6,10,0.4
vs. FBS (I-A),2018,Purdue,6,7,13,0.46153846153846156
vs. FCS (I-AA),2018,Purdue,0,0,0,
vs. FBS Winning,2018,Purdue,3,7,10,0.3
vs. FBS Non-Winning,2018,Purdue,3,0,3,1.0
vs. BCS AQ,2018,Purdue,6,6,12,0.5
vs. BCS non-AQ,2018,Purdue,0,1,1,0.0
vs. FBS Power 5,2018,Purdue,6,6,12,0.5
vs. FBS non-Power 5,2018,Purdue,0,1,1,0.0
in August/September,2018,Purdue,2,3,5,0.4
in October,2018,Purdue,2,1,3,0.6666666666666666
in November,2018,Purdue,2,2,4,0.5
in December/January,2018,Purdue,0,1,1,0.0
All Games,2019,Purdue,4,8,12,0.3333333333333333
at Home,2019,Purdue,3,4,7,0.42857142857142855
on Road/Neutral Site,2019,Purdue,1,4,5,0.2
vs. Conference,2019,Purdue,3,6,9,0.3333333333333333
vs. Non-Conference,2019,Purdue,1,2,3,0.3333333333333333
vs. Ranked (AP),2019,Purdue,0,4,4,0.0
vs. Unranked (AP),2019,Purdue,4,4,8,0.5
vs. FBS (I-A),2019,Purdue,4,8,12,0.3333333333333333
vs. FCS (I-AA),2019,Purdue,0,0,0,
vs. FBS Winning,2019,Purdue,0,6,6,0.0
vs. FBS Non-Winning,2019,Purdue,4,2,6,0.6666666666666666
vs. BCS AQ,2019,Purdue,4,7,11,0.36363636363636365
vs. BCS non-AQ,2019,Purdue,0,1,1,0.0
vs. FBS Power 5,2019,Purdue,4,7,11,0.36363636363636365
vs. FBS non-Power 5,2019,Purdue,0,1,1,0.0
in August/September,2019,Purdue,1,3,4,0.25
in October,2019,Purdue,1,3,4,0.25
in November,2019,Purdue,2,2,4,0.5
in December/January,2019,Purdue,0,0,0,
All Games,2020,Purdue,2,4,6,0.3333333333333333
at Home,2020,Purdue,1,3,4,0.25
on Road/Neutral Site,2020,Purdue,1,1,2,0.5
vs. Conference,2020,Purdue,2,4,6,0.3333333333333333
vs. Non-Conference,2020,Purdue,0,0,0,
vs. Ranked (AP),2020,Purdue,1,1,2,0.5
vs. Unranked (AP),2020,Purdue,1,3,4,0.25
vs. FBS (I-A),2020,Purdue,2,4,6,0.3333333333333333
vs. FCS (I-AA),2020,Purdue,0,0,0,
vs. FBS Winning,2020,Purdue,1,1,2,0.5
vs. FBS Non-Winning,2020,Purdue,1,3,4,0.25
vs. BCS AQ,2020,Purdue,2,4,6,0.3333333333333333
vs. BCS non-AQ,2020,Purdue,0,0,0,
vs. FBS Power 5,2020,Purdue,2,4,6,0.3333333333333333
vs. FBS non-Power 5,2020,Purdue,0,0,0,
in August/September,2020,Purdue,0,0,0,
in October,2020,Purdue,2,0,2,1.0
in November,2020,Purdue,0,3,3,0.0
in December/January,2020,Purdue,0,1,1,0.0
All Games,2021,Purdue,9,4,13,0.6923076923076923
at Home,2021,Purdue,4,2,6,0.6666666666666666
on Road/Neutral Site,2021,Purdue,5,2,7,0.7142857142857143
vs. Conference,2021,Purdue,6,3,9,0.6666666666666666
vs. Non-Conference,2021,Purdue,3,1,4,0.75
vs. Ranked (AP),2021,Purdue,2,2,4,0.5
vs. Unranked (AP),2021,Purdue,7,2,9,0.7777777777777778
vs. FBS (I-A),2021,Purdue,9,4,13,0.6923076923076923
vs. FCS (I-AA),2021,Purdue,0,0,0,
vs. FBS Winning,2021,Purdue,4,4,8,0.5
vs. FBS Non-Winning,2021,Purdue,5,0,5,1.0
vs. BCS AQ,2021,Purdue,8,4,12,0.6666666666666666
vs. BCS non-AQ,2021,Purdue,1,0,1,1.0
vs. FBS Power 5,2021,Purdue,8,3,11,0.7272727272727273
vs. FBS non-Power 5,2021,Purdue,1,1,2,0.5
in August/September,2021,Purdue,3,1,4,0.75
in October,2021,Purdue,2,2,4,0.5
in November,2021,Purdue,3,1,4,0.75
in December/January,2021,Purdue,1,0,1,1.0
All Games,2022,Purdue,8,6,14,0.5714285714285714
at Home,2022,Purdue,4,2,6,0.6666666666666666
on Road/Neutral Site,2022,Purdue,4,4,8,0.5
vs. Conference,2022,Purdue,6,4,10,0.6
vs. Non-Conference,2022,Purdue,2,2,4,0.5
vs. Ranked (AP),2022,Purdue,0,3,3,0.0
vs. Unranked (AP),2022,Purdue,8,3,11,0.7272727272727273
vs. FBS (I-A),2022,Purdue,7,6,13,0.5384615384615384
vs. FCS (I-AA),2022,Purdue,1,0,1,1.0
vs. FBS Winning,2022,Purdue,3,6,9,0.3333333333333333
vs. FBS Non-Winning,2022,Purdue,4,0,4,1.0
vs. BCS AQ,2022,Purdue,6,6,12,0.5
vs. BCS non-AQ,2022,Purdue,1,0,1,1.0
vs. FBS Power 5,2022,Purdue,6,6,12,0.5
vs. FBS non-Power 5,2022,Purdue,1,0,1,1.0
in August/September,2022,Purdue,2,2,4,0.5
in October,2022,Purdue,3,1,4,0.75
in November,2022,Purdue,3,1,4,0.75
in December/January,2022,Purdue,0,2,2,0.0
All Games,2009,Rice,2,10,12,0.16666666666666666
at Home,2009,Rice,2,4,6,0.3333333333333333
on Road/Neutral Site,2009,Rice,0,6,6,0.0
vs. Conference,2009,Rice,2,6,8,0.25
vs. Non-Conference,2009,Rice,0,4,4,0.0
vs. Ranked (AP),2009,Rice,0,1,1,0.0
vs. Unranked (AP),2009,Rice,2,9,11,0.18181818181818182
vs. FBS (I-A),2009,Rice,2,10,12,0.16666666666666666
vs. FCS (I-AA),2009,Rice,0,0,0,
vs. FBS Winning,2009,Rice,0,7,7,0.0
vs. FBS Non-Winning,2009,Rice,2,3,5,0.4
vs. BCS AQ,2009,Rice,0,3,3,0.0
vs. BCS non-AQ,2009,Rice,2,7,9,0.2222222222222222
vs. FBS Power 5,2009,Rice,0,3,3,0.0
vs. FBS non-Power 5,2009,Rice,2,7,9,0.2222222222222222
in August/September,2009,Rice,0,4,4,0.0
in October,2009,Rice,0,4,4,0.0
in November,2009,Rice,2,2,4,0.5
in December/January,2009,Rice,0,0,0,
All Games,2010,Rice,4,8,12,0.3333333333333333
at Home,2010,Rice,3,4,7,0.42857142857142855
on Road/Neutral Site,2010,Rice,1,4,5,0.2
vs. Conference,2010,Rice,3,5,8,0.375
vs. Non-Conference,2010,Rice,1,3,4,0.25
vs. Ranked (AP),2010,Rice,0,2,2,0.0
vs. Unranked (AP),2010,Rice,4,6,10,0.4
vs. FBS (I-A),2010,Rice,4,8,12,0.3333333333333333
vs. FCS (I-AA),2010,Rice,0,0,0,
vs. FBS Winning,2010,Rice,0,4,4,0.0
vs. FBS Non-Winning,2010,Rice,4,4,8,0.5
vs. BCS AQ,2010,Rice,0,3,3,0.0
vs. BCS non-AQ,2010,Rice,4,5,9,0.4444444444444444
vs. FBS Power 5,2010,Rice,0,3,3,0.0
vs. FBS non-Power 5,2010,Rice,4,5,9,0.4444444444444444
in August/September,2010,Rice,1,3,4,0.25
in October,2010,Rice,1,3,4,0.25
in November,2010,Rice,2,2,4,0.5
in December/January,2010,Rice,0,0,0,
All Games,2011,Rice,4,8,12,0.3333333333333333
at Home,2011,Rice,4,1,5,0.8
on Road/Neutral Site,2011,Rice,0,7,7,0.0
vs. Conference,2011,Rice,3,5,8,0.375
vs. Non-Conference,2011,Rice,1,3,4,0.25
vs. Ranked (AP),2011,Rice,0,3,3,0.0
vs. Unranked (AP),2011,Rice,4,5,9,0.4444444444444444
vs. FBS (I-A),2011,Rice,4,8,12,0.3333333333333333
vs. FCS (I-AA),2011,Rice,0,0,0,
vs. FBS Winning,2011,Rice,1,7,8,0.125
vs. FBS Non-Winning,2011,Rice,3,1,4,0.75
vs. BCS AQ,2011,Rice,1,3,4,0.25
vs. BCS non-AQ,2011,Rice,3,5,8,0.375
vs. FBS Power 5,2011,Rice,1,3,4,0.25
vs. FBS non-Power 5,2011,Rice,3,5,8,0.375
in August/September,2011,Rice,1,2,3,0.3333333333333333
in October,2011,Rice,1,4,5,0.2
in November,2011,Rice,2,2,4,0.5
in December/January,2011,Rice,0,0,0,
All Games,2012,Rice,7,6,13,0.5384615384615384
at Home,2012,Rice,3,2,5,0.6
on Road/Neutral Site,2012,Rice,4,4,8,0.5
vs. Conference,2012,Rice,4,4,8,0.5
vs. Non-Conference,2012,Rice,3,2,5,0.6
vs. Ranked (AP),2012,Rice,0,0,0,
vs. Unranked (AP),2012,Rice,7,6,13,0.5384615384615384
vs. FBS (I-A),2012,Rice,7,6,13,0.5384615384615384
vs. FCS (I-AA),2012,Rice,0,0,0,
vs. FBS Winning,2012,Rice,2,3,5,0.4
vs. FBS Non-Winning,2012,Rice,5,3,8,0.625
vs. BCS AQ,2012,Rice,1,1,2,0.5
vs. BCS non-AQ,2012,Rice,6,5,11,0.5454545454545454
vs. FBS Power 5,2012,Rice,1,1,2,0.5
vs. FBS non-Power 5,2012,Rice,6,5,11,0.5454545454545454
in August/September,2012,Rice,1,4,5,0.2
in October,2012,Rice,2,2,4,0.5
in November,2012,Rice,3,0,3,1.0
in December/January,2012,Rice,1,0,1,1.0
All Games,2013,Rice,10,4,14,0.7142857142857143
at Home,2013,Rice,6,0,6,1.0
on Road/Neutral Site,2013,Rice,4,4,8,0.5
vs. Conference,2013,Rice,8,1,9,0.8888888888888888
vs. Non-Conference,2013,Rice,2,3,5,0.4
vs. Ranked (AP),2013,Rice,0,1,1,0.0
vs. Unranked (AP),2013,Rice,10,3,13,0.7692307692307693
vs. FBS (I-A),2013,Rice,10,4,14,0.7142857142857143
vs. FCS (I-AA),2013,Rice,0,0,0,
vs. FBS Winning,2013,Rice,3,4,7,0.42857142857142855
vs. FBS Non-Winning,2013,Rice,7,0,7,1.0
vs. BCS AQ,2013,Rice,1,3,4,0.25
vs. BCS non-AQ,2013,Rice,9,1,10,0.9
vs. FBS Power 5,2013,Rice,1,2,3,0.3333333333333333
vs. FBS non-Power 5,2013,Rice,9,2,11,0.8181818181818182
in August/September,2013,Rice,2,2,4,0.5
in October,2013,Rice,4,1,5,0.8
in November,2013,Rice,3,0,3,1.0
in December/January,2013,Rice,1,1,2,0.5
All Games,2014,Rice,8,5,13,0.6153846153846154
at Home,2014,Rice,4,1,5,0.8
on Road/Neutral Site,2014,Rice,4,4,8,0.5
vs. Conference,2014,Rice,5,3,8,0.625
vs. Non-Conference,2014,Rice,3,2,5,0.6
vs. Ranked (AP),2014,Rice,0,1,1,0.0
vs. Unranked (AP),2014,Rice,8,4,12,0.6666666666666666
vs. FBS (I-A),2014,Rice,8,5,13,0.6153846153846154
vs. FCS (I-AA),2014,Rice,0,0,0,
vs. FBS Winning,2014,Rice,1,4,5,0.2
vs. FBS Non-Winning,2014,Rice,7,1,8,0.875
vs. BCS AQ,2014,Rice,0,2,2,0.0
vs. BCS non-AQ,2014,Rice,8,3,11,0.7272727272727273
vs. FBS Power 5,2014,Rice,0,1,1,0.0
vs. FBS non-Power 5,2014,Rice,8,4,12,0.6666666666666666
in August/September,2014,Rice,1,3,4,0.25
in October,2014,Rice,3,0,3,1.0
in November,2014,Rice,3,2,5,0.6
in December/January,2014,Rice,1,0,1,1.0
All Games,2015,Rice,5,7,12,0.4166666666666667
at Home,2015,Rice,3,3,6,0.5
on Road/Neutral Site,2015,Rice,2,4,6,0.3333333333333333
vs. Conference,2015,Rice,3,5,8,0.375
vs. Non-Conference,2015,Rice,2,2,4,0.5
vs. Ranked (AP),2015,Rice,0,2,2,0.0
vs. Unranked (AP),2015,Rice,5,5,10,0.5
vs. FBS (I-A),2015,Rice,4,7,11,0.36363636363636365
vs. FCS (I-AA),2015,Rice,1,0,1,1.0
vs. FBS Winning,2015,Rice,0,4,4,0.0
vs. FBS Non-Winning,2015,Rice,4,3,7,0.5714285714285714
vs. BCS AQ,2015,Rice,0,2,2,0.0
vs. BCS non-AQ,2015,Rice,4,5,9,0.4444444444444444
vs. FBS Power 5,2015,Rice,0,2,2,0.0
vs. FBS non-Power 5,2015,Rice,4,5,9,0.4444444444444444
in August/September,2015,Rice,2,2,4,0.5
in October,2015,Rice,2,2,4,0.5
in November,2015,Rice,1,3,4,0.25
in December/January,2015,Rice,0,0,0,
All Games,2016,Rice,3,9,12,0.25
at Home,2016,Rice,2,4,6,0.3333333333333333
on Road/Neutral Site,2016,Rice,1,5,6,0.16666666666666666
vs. Conference,2016,Rice,2,6,8,0.25
vs. Non-Conference,2016,Rice,1,3,4,0.25
vs. Ranked (AP),2016,Rice,0,1,1,0.0
vs. Unranked (AP),2016,Rice,3,8,11,0.2727272727272727
vs. FBS (I-A),2016,Rice,2,9,11,0.18181818181818182
vs. FCS (I-AA),2016,Rice,1,0,1,1.0
vs. FBS Winning,2016,Rice,0,6,6,0.0
vs. FBS Non-Winning,2016,Rice,2,3,5,0.4
vs. BCS AQ,2016,Rice,0,2,2,0.0
vs. BCS non-AQ,2016,Rice,2,7,9,0.2222222222222222
vs. FBS Power 5,2016,Rice,0,2,2,0.0
vs. FBS non-Power 5,2016,Rice,2,7,9,0.2222222222222222
in August/September,2016,Rice,0,4,4,0.0
in October,2016,Rice,1,3,4,0.25
in November,2016,Rice,2,2,4,0.5
in December/January,2016,Rice,0,0,0,
All Games,2017,Rice,1,11,12,0.08333333333333333
at Home,2017,Rice,0,5,5,0.0
on Road/Neutral Site,2017,Rice,1,6,7,0.14285714285714285
vs. Conference,2017,Rice,1,7,8,0.125
vs. Non-Conference,2017,Rice,0,4,4,0.0
vs. Ranked (AP),2017,Rice,0,1,1,0.0
vs. Unranked (AP),2017,Rice,1,10,11,0.09090909090909091
vs. FBS (I-A),2017,Rice,1,11,12,0.08333333333333333
vs. FCS (I-AA),2017,Rice,0,0,0,
vs. FBS Winning,2017,Rice,0,9,9,0.0
vs. FBS Non-Winning,2017,Rice,1,2,3,0.3333333333333333
vs. BCS AQ,2017,Rice,0,3,3,0.0
vs. BCS non-AQ,2017,Rice,1,8,9,0.1111111111111111
vs. FBS Power 5,2017,Rice,0,2,2,0.0
vs. FBS non-Power 5,2017,Rice,1,9,10,0.1
in August/September,2017,Rice,1,4,5,0.2
in October,2017,Rice,0,3,3,0.0
in November,2017,Rice,0,4,4,0.0
in December/January,2017,Rice,0,0,0,
All Games,2018,Rice,2,11,13,0.15384615384615385
at Home,2018,Rice,2,4,6,0.3333333333333333
on Road/Neutral Site,2018,Rice,0,7,7,0.0
vs. Conference,2018,Rice,1,7,8,0.125
vs. Non-Conference,2018,Rice,1,4,5,0.2
vs. Ranked (AP),2018,Rice,0,1,1,0.0
vs. Unranked (AP),2018,Rice,2,10,12,0.16666666666666666
vs. FBS (I-A),2018,Rice,1,11,12,0.08333333333333333
vs. FCS (I-AA),2018,Rice,1,0,1,1.0
vs. FBS Winning,2018,Rice,0,9,9,0.0
vs. FBS Non-Winning,2018,Rice,1,2,3,0.3333333333333333
vs. BCS AQ,2018,Rice,0,3,3,0.0
vs. BCS non-AQ,2018,Rice,1,8,9,0.1111111111111111
vs. FBS Power 5,2018,Rice,0,2,2,0.0
vs. FBS non-Power 5,2018,Rice,1,9,10,0.1
in August/September,2018,Rice,1,4,5,0.2
in October,2018,Rice,0,4,4,0.0
in November,2018,Rice,1,3,4,0.25
in December/January,2018,Rice,0,0,0,
All Games,2019,Rice,3,9,12,0.25
at Home,2019,Rice,1,5,6,0.16666666666666666
on Road/Neutral Site,2019,Rice,2,4,6,0.3333333333333333
vs. Conference,2019,Rice,3,5,8,0.375
vs. Non-Conference,2019,Rice,0,4,4,0.0
vs. Ranked (AP),2019,Rice,0,2,2,0.0
vs. Unranked (AP),2019,Rice,3,7,10,0.3
vs. FBS (I-A),2019,Rice,3,9,12,0.25
vs. FCS (I-AA),2019,Rice,0,0,0,
vs. FBS Winning,2019,Rice,0,7,7,0.0
vs. FBS Non-Winning,2019,Rice,3,2,5,0.6
vs. BCS AQ,2019,Rice,0,3,3,0.0
vs. BCS non-AQ,2019,Rice,3,6,9,0.3333333333333333
vs. FBS Power 5,2019,Rice,0,3,3,0.0
vs. FBS non-Power 5,2019,Rice,3,6,9,0.3333333333333333
in August/September,2019,Rice,0,5,5,0.0
in October,2019,Rice,0,3,3,0.0
in November,2019,Rice,3,1,4,0.75
in December/January,2019,Rice,0,0,0,
All Games,2020,Rice,2,3,5,0.4
at Home,2020,Rice,0,2,2,0.0
on Road/Neutral Site,2020,Rice,2,1,3,0.6666666666666666
vs. Conference,2020,Rice,2,3,5,0.4
vs. Non-Conference,2020,Rice,0,0,0,
vs. Ranked (AP),2020,Rice,0,0,0,
vs. Unranked (AP),2020,Rice,2,3,5,0.4
vs. FBS (I-A),2020,Rice,2,3,5,0.4
vs. FCS (I-AA),2020,Rice,0,0,0,
vs. FBS Winning,2020,Rice,1,1,2,0.5
vs. FBS Non-Winning,2020,Rice,1,2,3,0.3333333333333333
vs. BCS AQ,2020,Rice,0,0,0,
vs. BCS non-AQ,2020,Rice,2,3,5,0.4
vs. FBS Power 5,2020,Rice,0,0,0,
vs. FBS non-Power 5,2020,Rice,2,3,5,0.4
in August/September,2020,Rice,0,0,0,
in October,2020,Rice,1,1,2,0.5
in November,2020,Rice,0,1,1,0.0
in December/January,2020,Rice,1,1,2,0.5
All Games,2021,Rice,4,8,12,0.3333333333333333
at Home,2021,Rice,3,3,6,0.5
on Road/Neutral Site,2021,Rice,1,5,6,0.16666666666666666
vs. Conference,2021,Rice,3,5,8,0.375
vs. Non-Conference,2021,Rice,1,3,4,0.25
vs. Ranked (AP),2021,Rice,0,2,2,0.0
vs. Unranked (AP),2021,Rice,4,6,10,0.4
vs. FBS (I-A),2021,Rice,3,8,11,0.2727272727272727
vs. FCS (I-AA),2021,Rice,1,0,1,1.0
vs. FBS Winning,2021,Rice,1,5,6,0.16666666666666666
vs. FBS Non-Winning,2021,Rice,2,3,5,0.4
vs. BCS AQ,2021,Rice,0,3,3,0.0
vs. BCS non-AQ,2021,Rice,3,5,8,0.375
vs. FBS Power 5,2021,Rice,0,2,2,0.0
vs. FBS non-Power 5,2021,Rice,3,6,9,0.3333333333333333
in August/September,2021,Rice,1,3,4,0.25
in October,2021,Rice,2,2,4,0.5
in November,2021,Rice,1,3,4,0.25
in December/January,2021,Rice,0,0,0,
All Games,2022,Rice,5,8,13,0.38461538461538464
at Home,2022,Rice,4,2,6,0.6666666666666666
on Road/Neutral Site,2022,Rice,1,6,7,0.14285714285714285
vs. Conference,2022,Rice,3,5,8,0.375
vs. Non-Conference,2022,Rice,2,3,5,0.4
vs. Ranked (AP),2022,Rice,0,1,1,0.0
vs. Unranked (AP),2022,Rice,5,7,12,0.4166666666666667
vs. FBS (I-A),2022,Rice,4,8,12,0.3333333333333333
vs. FCS (I-AA),2022,Rice,1,0,1,1.0
vs. FBS Winning,2022,Rice,1,5,6,0.16666666666666666
vs. FBS Non-Winning,2022,Rice,3,3,6,0.5
vs. BCS AQ,2022,Rice,0,2,2,0.0
vs. BCS non-AQ,2022,Rice,4,6,10,0.4
vs. FBS Power 5,2022,Rice,0,1,1,0.0
vs. FBS non-Power 5,2022,Rice,4,7,11,0.36363636363636365
in August/September,2022,Rice,2,2,4,0.5
in October,2022,Rice,2,2,4,0.5
in November,2022,Rice,1,3,4,0.25
in December/January,2022,Rice,0,1,1,0.0
All Games,2009,Rutgers,9,4,13,0.6923076923076923
at Home,2009,Rutgers,4,3,7,0.5714285714285714
on Road/Neutral Site,2009,Rutgers,5,1,6,0.8333333333333334
vs. Conference,2009,Rutgers,3,4,7,0.42857142857142855
vs. Non-Conference,2009,Rutgers,6,0,6,1.0
vs. Ranked (AP),2009,Rutgers,0,3,3,0.0
vs. Unranked (AP),2009,Rutgers,9,1,10,0.9
vs. FBS (I-A),2009,Rutgers,7,4,11,0.6363636363636364
vs. FCS (I-AA),2009,Rutgers,2,0,2,1.0
vs. FBS Winning,2009,Rutgers,3,3,6,0.5
vs. FBS Non-Winning,2009,Rutgers,4,1,5,0.8
vs. BCS AQ,2009,Rutgers,4,4,8,0.5
vs. BCS non-AQ,2009,Rutgers,3,0,3,1.0
vs. FBS Power 5,2009,Rutgers,1,0,1,1.0
vs. FBS non-Power 5,2009,Rutgers,6,4,10,0.6
in August/September,2009,Rutgers,3,1,4,0.75
in October,2009,Rutgers,3,1,4,0.75
in November,2009,Rutgers,2,1,3,0.6666666666666666
in December/January,2009,Rutgers,1,1,2,0.5
All Games,2010,Rutgers,4,8,12,0.3333333333333333
at Home,2010,Rutgers,2,4,6,0.3333333333333333
on Road/Neutral Site,2010,Rutgers,2,4,6,0.3333333333333333
vs. Conference,2010,Rutgers,1,6,7,0.14285714285714285
vs. Non-Conference,2010,Rutgers,3,2,5,0.6
vs. Ranked (AP),2010,Rutgers,0,0,0,
vs. Unranked (AP),2010,Rutgers,4,8,12,0.3333333333333333
vs. FBS (I-A),2010,Rutgers,3,8,11,0.2727272727272727
vs. FCS (I-AA),2010,Rutgers,1,0,1,1.0
vs. FBS Winning,2010,Rutgers,3,6,9,0.3333333333333333
vs. FBS Non-Winning,2010,Rutgers,0,2,2,0.0
vs. BCS AQ,2010,Rutgers,1,7,8,0.125
vs. BCS non-AQ,2010,Rutgers,2,1,3,0.6666666666666666
vs. FBS Power 5,2010,Rutgers,0,1,1,0.0
vs. FBS non-Power 5,2010,Rutgers,3,7,10,0.3
in August/September,2010,Rutgers,2,1,3,0.6666666666666666
in October,2010,Rutgers,2,2,4,0.5
in November,2010,Rutgers,0,4,4,0.0
in December/January,2010,Rutgers,0,1,1,0.0
All Games,2011,Rutgers,9,4,13,0.6923076923076923
at Home,2011,Rutgers,6,1,7,0.8571428571428571
on Road/Neutral Site,2011,Rutgers,3,3,6,0.5
vs. Conference,2011,Rutgers,4,3,7,0.5714285714285714
vs. Non-Conference,2011,Rutgers,5,1,6,0.8333333333333334
vs. Ranked (AP),2011,Rutgers,1,1,2,0.5
vs. Unranked (AP),2011,Rutgers,8,3,11,0.7272727272727273
vs. FBS (I-A),2011,Rutgers,8,4,12,0.6666666666666666
vs. FCS (I-AA),2011,Rutgers,1,0,1,1.0
vs. FBS Winning,2011,Rutgers,2,3,5,0.4
vs. FBS Non-Winning,2011,Rutgers,6,1,7,0.8571428571428571
vs. BCS AQ,2011,Rutgers,5,4,9,0.5555555555555556
vs. BCS non-AQ,2011,Rutgers,3,0,3,1.0
vs. FBS Power 5,2011,Rutgers,1,1,2,0.5
vs. FBS non-Power 5,2011,Rutgers,7,3,10,0.7
in August/September,2011,Rutgers,2,1,3,0.6666666666666666
in October,2011,Rutgers,3,2,5,0.6
in November,2011,Rutgers,3,1,4,0.75
in December/January,2011,Rutgers,1,0,1,1.0
All Games,2012,Rutgers,9,4,13,0.6923076923076923
at Home,2012,Rutgers,4,2,6,0.6666666666666666
on Road/Neutral Site,2012,Rutgers,5,2,7,0.7142857142857143
vs. Conference,2012,Rutgers,5,2,7,0.7142857142857143
vs. Non-Conference,2012,Rutgers,4,2,6,0.6666666666666666
vs. Ranked (AP),2012,Rutgers,0,1,1,0.0
vs. Unranked (AP),2012,Rutgers,9,3,12,0.75
vs. FBS (I-A),2012,Rutgers,8,4,12,0.6666666666666666
vs. FCS (I-AA),2012,Rutgers,1,0,1,1.0
vs. FBS Winning,2012,Rutgers,2,3,5,0.4
vs. FBS Non-Winning,2012,Rutgers,6,1,7,0.8571428571428571
vs. BCS AQ,2012,Rutgers,6,3,9,0.6666666666666666
vs. BCS non-AQ,2012,Rutgers,2,1,3,0.6666666666666666
vs. FBS Power 5,2012,Rutgers,1,1,2,0.5
vs. FBS non-Power 5,2012,Rutgers,7,3,10,0.7
in August/September,2012,Rutgers,4,0,4,1.0
in October,2012,Rutgers,3,1,4,0.75
in November,2012,Rutgers,2,2,4,0.5
in December/January,2012,Rutgers,0,1,1,0.0
All Games,2013,Rutgers,6,7,13,0.46153846153846156
at Home,2013,Rutgers,5,2,7,0.7142857142857143
on Road/Neutral Site,2013,Rutgers,1,5,6,0.16666666666666666
vs. Conference,2013,Rutgers,3,5,8,0.375
vs. Non-Conference,2013,Rutgers,3,2,5,0.6
vs. Ranked (AP),2013,Rutgers,0,3,3,0.0
vs. Unranked (AP),2013,Rutgers,6,4,10,0.6
vs. FBS (I-A),2013,Rutgers,5,7,12,0.4166666666666667
vs. FCS (I-AA),2013,Rutgers,1,0,1,1.0
vs. FBS Winning,2013,Rutgers,0,6,6,0.0
vs. FBS Non-Winning,2013,Rutgers,5,1,6,0.8333333333333334
vs. BCS AQ,2013,Rutgers,4,6,10,0.4
vs. BCS non-AQ,2013,Rutgers,1,1,2,0.5
vs. FBS Power 5,2013,Rutgers,1,0,1,1.0
vs. FBS non-Power 5,2013,Rutgers,4,7,11,0.36363636363636365
in August/September,2013,Rutgers,3,1,4,0.75
in October,2013,Rutgers,1,2,3,0.3333333333333333
in November,2013,Rutgers,1,3,4,0.25
in December/January,2013,Rutgers,1,1,2,0.5
All Games,2014,Rutgers,8,5,13,0.6153846153846154
at Home,2014,Rutgers,4,2,6,0.6666666666666666
on Road/Neutral Site,2014,Rutgers,4,3,7,0.5714285714285714
vs. Conference,2014,Rutgers,3,5,8,0.375
vs. Non-Conference,2014,Rutgers,5,0,5,1.0
vs. Ranked (AP),2014,Rutgers,0,3,3,0.0
vs. Unranked (AP),2014,Rutgers,8,2,10,0.8
vs. FBS (I-A),2014,Rutgers,7,5,12,0.5833333333333334
vs. FCS (I-AA),2014,Rutgers,1,0,1,1.0
vs. FBS Winning,2014,Rutgers,2,5,7,0.2857142857142857
vs. FBS Non-Winning,2014,Rutgers,5,0,5,1.0
vs. BCS AQ,2014,Rutgers,6,5,11,0.5454545454545454
vs. BCS non-AQ,2014,Rutgers,1,0,1,1.0
vs. FBS Power 5,2014,Rutgers,5,5,10,0.5
vs. FBS non-Power 5,2014,Rutgers,2,0,2,1.0
in August/September,2014,Rutgers,4,1,5,0.8
in October,2014,Rutgers,1,2,3,0.3333333333333333
in November,2014,Rutgers,2,2,4,0.5
in December/January,2014,Rutgers,1,0,1,1.0
All Games,2015,Rutgers,4,8,12,0.3333333333333333
at Home,2015,Rutgers,2,5,7,0.2857142857142857
on Road/Neutral Site,2015,Rutgers,2,3,5,0.4
vs. Conference,2015,Rutgers,1,7,8,0.125
vs. Non-Conference,2015,Rutgers,3,1,4,0.75
vs. Ranked (AP),2015,Rutgers,0,4,4,0.0
vs. Unranked (AP),2015,Rutgers,4,4,8,0.5
vs. FBS (I-A),2015,Rutgers,3,8,11,0.2727272727272727
vs. FCS (I-AA),2015,Rutgers,1,0,1,1.0
vs. FBS Winning,2015,Rutgers,0,6,6,0.0
vs. FBS Non-Winning,2015,Rutgers,3,2,5,0.6
vs. BCS AQ,2015,Rutgers,2,8,10,0.2
vs. BCS non-AQ,2015,Rutgers,1,0,1,1.0
vs. FBS Power 5,2015,Rutgers,2,8,10,0.2
vs. FBS non-Power 5,2015,Rutgers,1,0,1,1.0
in August/September,2015,Rutgers,2,2,4,0.5
in October,2015,Rutgers,1,3,4,0.25
in November,2015,Rutgers,1,3,4,0.25
in December/January,2015,Rutgers,0,0,0,
All Games,2016,Rutgers,2,10,12,0.16666666666666666
at Home,2016,Rutgers,2,5,7,0.2857142857142857
on Road/Neutral Site,2016,Rutgers,0,5,5,0.0
vs. Conference,2016,Rutgers,0,9,9,0.0
vs. Non-Conference,2016,Rutgers,2,1,3,0.6666666666666666
vs. Ranked (AP),2016,Rutgers,0,5,5,0.0
vs. Unranked (AP),2016,Rutgers,2,5,7,0.2857142857142857
vs. FBS (I-A),2016,Rutgers,1,10,11,0.09090909090909091
vs. FCS (I-AA),2016,Rutgers,1,0,1,1.0
vs. FBS Winning,2016,Rutgers,1,6,7,0.14285714285714285
vs. FBS Non-Winning,2016,Rutgers,0,4,4,0.0
vs. BCS AQ,2016,Rutgers,0,10,10,0.0
vs. BCS non-AQ,2016,Rutgers,1,0,1,1.0
vs. FBS Power 5,2016,Rutgers,0,10,10,0.0
vs. FBS non-Power 5,2016,Rutgers,1,0,1,1.0
in August/September,2016,Rutgers,2,2,4,0.5
in October,2016,Rutgers,0,4,4,0.0
in November,2016,Rutgers,0,4,4,0.0
in December/January,2016,Rutgers,0,0,0,
All Games,2017,Rutgers,4,8,12,0.3333333333333333
at Home,2017,Rutgers,3,4,7,0.42857142857142855
on Road/Neutral Site,2017,Rutgers,1,4,5,0.2
vs. Conference,2017,Rutgers,3,6,9,0.3333333333333333
vs. Non-Conference,2017,Rutgers,1,2,3,0.3333333333333333
vs. Ranked (AP),2017,Rutgers,0,4,4,0.0
vs. Unranked (AP),2017,Rutgers,4,4,8,0.5
vs. FBS (I-A),2017,Rutgers,3,8,11,0.2727272727272727
vs. FCS (I-AA),2017,Rutgers,1,0,1,1.0
vs. FBS Winning,2017,Rutgers,1,5,6,0.16666666666666666
vs. FBS Non-Winning,2017,Rutgers,2,3,5,0.4
vs. BCS AQ,2017,Rutgers,3,7,10,0.3
vs. BCS non-AQ,2017,Rutgers,0,1,1,0.0
vs. FBS Power 5,2017,Rutgers,3,7,10,0.3
vs. FBS non-Power 5,2017,Rutgers,0,1,1,0.0
in August/September,2017,Rutgers,1,4,5,0.2
in October,2017,Rutgers,2,1,3,0.6666666666666666
in November,2017,Rutgers,1,3,4,0.25
in December/January,2017,Rutgers,0,0,0,
All Games,2018,Rutgers,1,11,12,0.08333333333333333
at Home,2018,Rutgers,1,6,7,0.14285714285714285
on Road/Neutral Site,2018,Rutgers,0,5,5,0.0
vs. Conference,2018,Rutgers,0,9,9,0.0
vs. Non-Conference,2018,Rutgers,1,2,3,0.3333333333333333
vs. Ranked (AP),2018,Rutgers,0,4,4,0.0
vs. Unranked (AP),2018,Rutgers,1,7,8,0.125
vs. FBS (I-A),2018,Rutgers,1,11,12,0.08333333333333333
vs. FCS (I-AA),2018,Rutgers,0,0,0,
vs. FBS Winning,2018,Rutgers,0,7,7,0.0
vs. FBS Non-Winning,2018,Rutgers,1,4,5,0.2
vs. BCS AQ,2018,Rutgers,0,10,10,0.0
vs. BCS non-AQ,2018,Rutgers,1,1,2,0.5
vs. FBS Power 5,2018,Rutgers,0,10,10,0.0
vs. FBS non-Power 5,2018,Rutgers,1,1,2,0.5
in August/September,2018,Rutgers,1,4,5,0.2
in October,2018,Rutgers,0,3,3,0.0
in November,2018,Rutgers,0,4,4,0.0
in December/January,2018,Rutgers,0,0,0,
All Games,2019,Rutgers,2,10,12,0.16666666666666666
at Home,2019,Rutgers,2,5,7,0.2857142857142857
on Road/Neutral Site,2019,Rutgers,0,5,5,0.0
vs. Conference,2019,Rutgers,0,9,9,0.0
vs. Non-Conference,2019,Rutgers,2,1,3,0.6666666666666666
vs. Ranked (AP),2019,Rutgers,0,5,5,0.0
vs. Unranked (AP),2019,Rutgers,2,5,7,0.2857142857142857
vs. FBS (I-A),2019,Rutgers,2,10,12,0.16666666666666666
vs. FCS (I-AA),2019,Rutgers,0,0,0,
vs. FBS Winning,2019,Rutgers,1,7,8,0.125
vs. FBS Non-Winning,2019,Rutgers,1,3,4,0.25
vs. BCS AQ,2019,Rutgers,0,10,10,0.0
vs. BCS non-AQ,2019,Rutgers,2,0,2,1.0
vs. FBS Power 5,2019,Rutgers,0,10,10,0.0
vs. FBS non-Power 5,2019,Rutgers,2,0,2,1.0
in August/September,2019,Rutgers,1,3,4,0.25
in October,2019,Rutgers,1,3,4,0.25
in November,2019,Rutgers,0,4,4,0.0
in December/January,2019,Rutgers,0,0,0,
All Games,2020,Rutgers,3,6,9,0.3333333333333333
at Home,2020,Rutgers,0,5,5,0.0
on Road/Neutral Site,2020,Rutgers,3,1,4,0.75
vs. Conference,2020,Rutgers,3,6,9,0.3333333333333333
vs. Non-Conference,2020,Rutgers,0,0,0,
vs. Ranked (AP),2020,Rutgers,0,2,2,0.0
vs. Unranked (AP),2020,Rutgers,3,4,7,0.42857142857142855
vs. FBS (I-A),2020,Rutgers,3,6,9,0.3333333333333333
vs. FCS (I-AA),2020,Rutgers,0,0,0,
vs. FBS Winning,2020,Rutgers,0,2,2,0.0
vs. FBS Non-Winning,2020,Rutgers,3,4,7,0.42857142857142855
vs. BCS AQ,2020,Rutgers,3,6,9,0.3333333333333333
vs. BCS non-AQ,2020,Rutgers,0,0,0,
vs. FBS Power 5,2020,Rutgers,3,6,9,0.3333333333333333
vs. FBS non-Power 5,2020,Rutgers,0,0,0,
in August/September,2020,Rutgers,0,0,0,
in October,2020,Rutgers,1,1,2,0.5
in November,2020,Rutgers,1,3,4,0.25
in December/January,2020,Rutgers,1,2,3,0.3333333333333333
All Games,2021,Rutgers,5,8,13,0.38461538461538464
at Home,2021,Rutgers,2,4,6,0.3333333333333333
on Road/Neutral Site,2021,Rutgers,3,4,7,0.42857142857142855
vs. Conference,2021,Rutgers,2,7,9,0.2222222222222222
vs. Non-Conference,2021,Rutgers,3,1,4,0.75
vs. Ranked (AP),2021,Rutgers,0,4,4,0.0
vs. Unranked (AP),2021,Rutgers,5,4,9,0.5555555555555556
vs. FBS (I-A),2021,Rutgers,4,8,12,0.3333333333333333
vs. FCS (I-AA),2021,Rutgers,1,0,1,1.0
vs. FBS Winning,2021,Rutgers,0,7,7,0.0
vs. FBS Non-Winning,2021,Rutgers,4,1,5,0.8
vs. BCS AQ,2021,Rutgers,4,8,12,0.3333333333333333
vs. BCS non-AQ,2021,Rutgers,0,0,0,
vs. FBS Power 5,2021,Rutgers,3,8,11,0.2727272727272727
vs. FBS non-Power 5,2021,Rutgers,1,0,1,1.0
in August/September,2021,Rutgers,3,1,4,0.75
in October,2021,Rutgers,1,3,4,0.25
in November,2021,Rutgers,1,3,4,0.25
in December/January,2021,Rutgers,0,1,1,0.0
All Games,2022,Rutgers,4,8,12,0.3333333333333333
at Home,2022,Rutgers,2,4,6,0.3333333333333333
on Road/Neutral Site,2022,Rutgers,2,4,6,0.3333333333333333
vs. Conference,2022,Rutgers,1,8,9,0.1111111111111111
vs. Non-Conference,2022,Rutgers,3,0,3,1.0
vs. Ranked (AP),2022,Rutgers,0,3,3,0.0
vs. Unranked (AP),2022,Rutgers,4,5,9,0.4444444444444444
vs. FBS (I-A),2022,Rutgers,3,8,11,0.2727272727272727
vs. FCS (I-AA),2022,Rutgers,1,0,1,1.0
vs. FBS Winning,2022,Rutgers,0,6,6,0.0
vs. FBS Non-Winning,2022,Rutgers,3,2,5,0.6
vs. BCS AQ,2022,Rutgers,3,8,11,0.2727272727272727
vs. BCS non-AQ,2022,Rutgers,0,0,0,
vs. FBS Power 5,2022,Rutgers,2,8,10,0.2
vs. FBS non-Power 5,2022,Rutgers,1,0,1,1.0
in August/September,2022,Rutgers,3,1,4,0.75
in October,2022,Rutgers,1,3,4,0.25
in November,2022,Rutgers,0,4,4,0.0
in December/January,2022,Rutgers,0,0,0,
All Games,2009,SMU,8,5,13,0.6153846153846154
at Home,2009,SMU,5,1,6,0.8333333333333334
on Road/Neutral Site,2009,SMU,3,4,7,0.42857142857142855
vs. Conference,2009,SMU,6,2,8,0.75
vs. Non-Conference,2009,SMU,2,3,5,0.4
vs. Ranked (AP),2009,SMU,0,1,1,0.0
vs. Unranked (AP),2009,SMU,8,4,12,0.6666666666666666
vs. FBS (I-A),2009,SMU,7,5,12,0.5833333333333334
vs. FCS (I-AA),2009,SMU,1,0,1,1.0
vs. FBS Winning,2009,SMU,2,4,6,0.3333333333333333
vs. FBS Non-Winning,2009,SMU,5,1,6,0.8333333333333334
vs. BCS AQ,2009,SMU,0,1,1,0.0
vs. BCS non-AQ,2009,SMU,7,4,11,0.6363636363636364
vs. FBS Power 5,2009,SMU,0,1,1,0.0
vs. FBS non-Power 5,2009,SMU,7,4,11,0.6363636363636364
in August/September,2009,SMU,2,1,3,0.6666666666666666
in October,2009,SMU,2,3,5,0.4
in November,2009,SMU,3,1,4,0.75
in December/January,2009,SMU,1,0,1,1.0
All Games,2010,SMU,7,7,14,0.5
at Home,2010,SMU,4,2,6,0.6666666666666666
on Road/Neutral Site,2010,SMU,3,5,8,0.375
vs. Conference,2010,SMU,6,3,9,0.6666666666666666
vs. Non-Conference,2010,SMU,1,4,5,0.2
vs. Ranked (AP),2010,SMU,1,2,3,0.3333333333333333
vs. Unranked (AP),2010,SMU,6,5,11,0.5454545454545454
vs. FBS (I-A),2010,SMU,7,7,14,0.5
vs. FCS (I-AA),2010,SMU,0,0,0,
vs. FBS Winning,2010,SMU,1,5,6,0.16666666666666666
vs. FBS Non-Winning,2010,SMU,6,2,8,0.75
vs. BCS AQ,2010,SMU,1,1,2,0.5
vs. BCS non-AQ,2010,SMU,6,6,12,0.5
vs. FBS Power 5,2010,SMU,1,1,2,0.5
vs. FBS non-Power 5,2010,SMU,6,6,12,0.5
in August/September,2010,SMU,2,2,4,0.5
in October,2010,SMU,3,2,5,0.6
in November,2010,SMU,2,1,3,0.6666666666666666
in December/January,2010,SMU,0,2,2,0.0
All Games,2011,SMU,8,5,13,0.6153846153846154
at Home,2011,SMU,5,1,6,0.8333333333333334
on Road/Neutral Site,2011,SMU,3,4,7,0.42857142857142855
vs. Conference,2011,SMU,5,3,8,0.625
vs. Non-Conference,2011,SMU,3,2,5,0.6
vs. Ranked (AP),2011,SMU,1,2,3,0.3333333333333333
vs. Unranked (AP),2011,SMU,7,3,10,0.7
vs. FBS (I-A),2011,SMU,7,5,12,0.5833333333333334
vs. FCS (I-AA),2011,SMU,1,0,1,1.0
vs. FBS Winning,2011,SMU,1,4,5,0.2
vs. FBS Non-Winning,2011,SMU,6,1,7,0.8571428571428571
vs. BCS AQ,2011,SMU,1,1,2,0.5
vs. BCS non-AQ,2011,SMU,6,4,10,0.6
vs. FBS Power 5,2011,SMU,0,1,1,0.0
vs. FBS non-Power 5,2011,SMU,7,4,11,0.6363636363636364
in August/September,2011,SMU,3,1,4,0.75
in October,2011,SMU,2,2,4,0.5
in November,2011,SMU,2,2,4,0.5
in December/January,2011,SMU,1,0,1,1.0
All Games,2012,SMU,7,6,13,0.5384615384615384
at Home,2012,SMU,5,2,7,0.7142857142857143
on Road/Neutral Site,2012,SMU,2,4,6,0.3333333333333333
vs. Conference,2012,SMU,5,3,8,0.625
vs. Non-Conference,2012,SMU,2,3,5,0.4
vs. Ranked (AP),2012,SMU,0,1,1,0.0
vs. Unranked (AP),2012,SMU,7,5,12,0.5833333333333334
vs. FBS (I-A),2012,SMU,6,6,12,0.5
vs. FCS (I-AA),2012,SMU,1,0,1,1.0
vs. FBS Winning,2012,SMU,2,5,7,0.2857142857142857
vs. FBS Non-Winning,2012,SMU,4,1,5,0.8
vs. BCS AQ,2012,SMU,0,3,3,0.0
vs. BCS non-AQ,2012,SMU,6,3,9,0.6666666666666666
vs. FBS Power 5,2012,SMU,0,3,3,0.0
vs. FBS non-Power 5,2012,SMU,6,3,9,0.6666666666666666
in August/September,2012,SMU,1,3,4,0.25
in October,2012,SMU,3,1,4,0.75
in November,2012,SMU,2,2,4,0.5
in December/January,2012,SMU,1,0,1,1.0
All Games,2013,SMU,5,7,12,0.4166666666666667
at Home,2013,SMU,3,3,6,0.5
on Road/Neutral Site,2013,SMU,2,4,6,0.3333333333333333
vs. Conference,2013,SMU,4,4,8,0.5
vs. Non-Conference,2013,SMU,1,3,4,0.25
vs. Ranked (AP),2013,SMU,0,2,2,0.0
vs. Unranked (AP),2013,SMU,5,5,10,0.5
vs. FBS (I-A),2013,SMU,4,7,11,0.36363636363636365
vs. FCS (I-AA),2013,SMU,1,0,1,1.0
vs. FBS Winning,2013,SMU,0,5,5,0.0
vs. FBS Non-Winning,2013,SMU,4,2,6,0.6666666666666666
vs. BCS AQ,2013,SMU,4,7,11,0.36363636363636365
vs. BCS non-AQ,2013,SMU,0,0,0,
vs. FBS Power 5,2013,SMU,0,3,3,0.0
vs. FBS non-Power 5,2013,SMU,4,4,8,0.5
in August/September,2013,SMU,1,3,4,0.25
in October,2013,SMU,2,1,3,0.6666666666666666
in November,2013,SMU,2,2,4,0.5
in December/January,2013,SMU,0,1,1,0.0
All Games,2014,SMU,1,11,12,0.08333333333333333
at Home,2014,SMU,0,6,6,0.0
on Road/Neutral Site,2014,SMU,1,5,6,0.16666666666666666
vs. Conference,2014,SMU,1,7,8,0.125
vs. Non-Conference,2014,SMU,0,4,4,0.0
vs. Ranked (AP),2014,SMU,0,3,3,0.0
vs. Unranked (AP),2014,SMU,1,8,9,0.1111111111111111
vs. FBS (I-A),2014,SMU,1,11,12,0.08333333333333333
vs. FCS (I-AA),2014,SMU,0,0,0,
vs. FBS Winning,2014,SMU,0,8,8,0.0
vs. FBS Non-Winning,2014,SMU,1,3,4,0.25
vs. BCS AQ,2014,SMU,1,10,11,0.09090909090909091
vs. BCS non-AQ,2014,SMU,0,1,1,0.0
vs. FBS Power 5,2014,SMU,0,3,3,0.0
vs. FBS non-Power 5,2014,SMU,1,8,9,0.1111111111111111
in August/September,2014,SMU,0,4,4,0.0
in October,2014,SMU,0,3,3,0.0
in November,2014,SMU,0,4,4,0.0
in December/January,2014,SMU,1,0,1,1.0
All Games,2015,SMU,2,10,12,0.16666666666666666
at Home,2015,SMU,2,5,7,0.2857142857142857
on Road/Neutral Site,2015,SMU,0,5,5,0.0
vs. Conference,2015,SMU,1,7,8,0.125
vs. Non-Conference,2015,SMU,1,3,4,0.25
vs. Ranked (AP),2015,SMU,0,4,4,0.0
vs. Unranked (AP),2015,SMU,2,6,8,0.25
vs. FBS (I-A),2015,SMU,2,9,11,0.18181818181818182
vs. FCS (I-AA),2015,SMU,0,1,1,0.0
vs. FBS Winning,2015,SMU,0,7,7,0.0
vs. FBS Non-Winning,2015,SMU,2,2,4,0.5
vs. BCS AQ,2015,SMU,1,9,10,0.1
vs. BCS non-AQ,2015,SMU,1,0,1,1.0
vs. FBS Power 5,2015,SMU,0,2,2,0.0
vs. FBS non-Power 5,2015,SMU,2,7,9,0.2222222222222222
in August/September,2015,SMU,1,3,4,0.25
in October,2015,SMU,0,4,4,0.0
in November,2015,SMU,1,3,4,0.25
in December/January,2015,SMU,0,0,0,
All Games,2016,SMU,5,7,12,0.4166666666666667
at Home,2016,SMU,2,4,6,0.3333333333333333
on Road/Neutral Site,2016,SMU,3,3,6,0.5
vs. Conference,2016,SMU,3,5,8,0.375
vs. Non-Conference,2016,SMU,2,2,4,0.5
vs. Ranked (AP),2016,SMU,0,2,2,0.0
vs. Unranked (AP),2016,SMU,5,5,10,0.5
vs. FBS (I-A),2016,SMU,4,7,11,0.36363636363636365
vs. FCS (I-AA),2016,SMU,1,0,1,1.0
vs. FBS Winning,2016,SMU,1,6,7,0.14285714285714285
vs. FBS Non-Winning,2016,SMU,3,1,4,0.75
vs. BCS AQ,2016,SMU,3,7,10,0.3
vs. BCS non-AQ,2016,SMU,1,0,1,1.0
vs. FBS Power 5,2016,SMU,0,2,2,0.0
vs. FBS non-Power 5,2016,SMU,4,5,9,0.4444444444444444
in August/September,2016,SMU,2,2,4,0.5
in October,2016,SMU,2,2,4,0.5
in November,2016,SMU,1,3,4,0.25
in December/January,2016,SMU,0,0,0,
All Games,2017,SMU,7,6,13,0.5384615384615384
at Home,2017,SMU,6,1,7,0.8571428571428571
on Road/Neutral Site,2017,SMU,1,5,6,0.16666666666666666
vs. Conference,2017,SMU,4,4,8,0.5
vs. Non-Conference,2017,SMU,3,2,5,0.6
vs. Ranked (AP),2017,SMU,0,3,3,0.0
vs. Unranked (AP),2017,SMU,7,3,10,0.7
vs. FBS (I-A),2017,SMU,6,6,12,0.5
vs. FCS (I-AA),2017,SMU,1,0,1,1.0
vs. FBS Winning,2017,SMU,2,6,8,0.25
vs. FBS Non-Winning,2017,SMU,4,0,4,1.0
vs. BCS AQ,2017,SMU,4,5,9,0.4444444444444444
vs. BCS non-AQ,2017,SMU,2,1,3,0.6666666666666666
vs. FBS Power 5,2017,SMU,0,1,1,0.0
vs. FBS non-Power 5,2017,SMU,6,5,11,0.5454545454545454
in August/September,2017,SMU,4,1,5,0.8
in October,2017,SMU,2,1,3,0.6666666666666666
in November,2017,SMU,1,3,4,0.25
in December/January,2017,SMU,0,1,1,0.0
All Games,2018,SMU,5,7,12,0.4166666666666667
at Home,2018,SMU,3,3,6,0.5
on Road/Neutral Site,2018,SMU,2,4,6,0.3333333333333333
vs. Conference,2018,SMU,4,4,8,0.5
vs. Non-Conference,2018,SMU,1,3,4,0.25
vs. Ranked (AP),2018,SMU,0,3,3,0.0
vs. Unranked (AP),2018,SMU,5,4,9,0.5555555555555556
vs. FBS (I-A),2018,SMU,4,7,11,0.36363636363636365
vs. FCS (I-AA),2018,SMU,1,0,1,1.0
vs. FBS Winning,2018,SMU,2,6,8,0.25
vs. FBS Non-Winning,2018,SMU,2,1,3,0.6666666666666666
vs. BCS AQ,2018,SMU,4,6,10,0.4
vs. BCS non-AQ,2018,SMU,0,1,1,0.0
vs. FBS Power 5,2018,SMU,0,2,2,0.0
vs. FBS non-Power 5,2018,SMU,4,5,9,0.4444444444444444
in August/September,2018,SMU,2,3,5,0.4
in October,2018,SMU,1,2,3,0.3333333333333333
in November,2018,SMU,2,2,4,0.5
in December/January,2018,SMU,0,0,0,
All Games,2019,SMU,10,3,13,0.7692307692307693
at Home,2019,SMU,6,0,6,1.0
on Road/Neutral Site,2019,SMU,4,3,7,0.5714285714285714
vs. Conference,2019,SMU,6,2,8,0.75
vs. Non-Conference,2019,SMU,4,1,5,0.8
vs. Ranked (AP),2019,SMU,0,2,2,0.0
vs. Unranked (AP),2019,SMU,10,1,11,0.9090909090909091
vs. FBS (I-A),2019,SMU,10,3,13,0.7692307692307693
vs. FCS (I-AA),2019,SMU,0,0,0,
vs. FBS Winning,2019,SMU,3,3,6,0.5
vs. FBS Non-Winning,2019,SMU,7,0,7,1.0
vs. BCS AQ,2019,SMU,7,2,9,0.7777777777777778
vs. BCS non-AQ,2019,SMU,3,1,4,0.75
vs. FBS Power 5,2019,SMU,1,0,1,1.0
vs. FBS non-Power 5,2019,SMU,9,3,12,0.75
in August/September,2019,SMU,5,0,5,1.0
in October,2019,SMU,3,0,3,1.0
in November,2019,SMU,2,2,4,0.5
in December/January,2019,SMU,0,1,1,0.0
All Games,2020,SMU,7,3,10,0.7
at Home,2020,SMU,3,1,4,0.75
on Road/Neutral Site,2020,SMU,4,2,6,0.6666666666666666
vs. Conference,2020,SMU,4,3,7,0.5714285714285714
vs. Non-Conference,2020,SMU,3,0,3,1.0
vs. Ranked (AP),2020,SMU,0,2,2,0.0
vs. Unranked (AP),2020,SMU,7,1,8,0.875
vs. FBS (I-A),2020,SMU,6,3,9,0.6666666666666666
vs. FCS (I-AA),2020,SMU,1,0,1,1.0
vs. FBS Winning,2020,SMU,1,2,3,0.3333333333333333
vs. FBS Non-Winning,2020,SMU,5,1,6,0.8333333333333334
vs. BCS AQ,2020,SMU,4,3,7,0.5714285714285714
vs. BCS non-AQ,2020,SMU,2,0,2,1.0
vs. FBS Power 5,2020,SMU,0,0,0,
vs. FBS non-Power 5,2020,SMU,6,3,9,0.6666666666666666
in August/September,2020,SMU,3,0,3,1.0
in October,2020,SMU,3,1,4,0.75
in November,2020,SMU,1,2,3,0.3333333333333333
in December/January,2020,SMU,0,0,0,
All Games,2021,SMU,8,4,12,0.6666666666666666
at Home,2021,SMU,5,1,6,0.8333333333333334
on Road/Neutral Site,2021,SMU,3,3,6,0.5
vs. Conference,2021,SMU,4,4,8,0.5
vs. Non-Conference,2021,SMU,4,0,4,1.0
vs. Ranked (AP),2021,SMU,0,2,2,0.0
vs. Unranked (AP),2021,SMU,8,2,10,0.8
vs. FBS (I-A),2021,SMU,7,4,11,0.6363636363636364
vs. FCS (I-AA),2021,SMU,1,0,1,1.0
vs. FBS Winning,2021,SMU,1,3,4,0.25
vs. FBS Non-Winning,2021,SMU,6,1,7,0.8571428571428571
vs. BCS AQ,2021,SMU,5,4,9,0.5555555555555556
vs. BCS non-AQ,2021,SMU,2,0,2,1.0
vs. FBS Power 5,2021,SMU,1,0,1,1.0
vs. FBS non-Power 5,2021,SMU,6,4,10,0.6
in August/September,2021,SMU,4,0,4,1.0
in October,2021,SMU,3,1,4,0.75
in November,2021,SMU,1,3,4,0.25
in December/January,2021,SMU,0,0,0,
All Games,2022,SMU,7,6,13,0.5384615384615384
at Home,2022,SMU,4,2,6,0.6666666666666666
on Road/Neutral Site,2022,SMU,3,4,7,0.42857142857142855
vs. Conference,2022,SMU,5,3,8,0.625
vs. Non-Conference,2022,SMU,2,3,5,0.4
vs. Ranked (AP),2022,SMU,0,2,2,0.0
vs. Unranked (AP),2022,SMU,7,4,11,0.6363636363636364
vs. FBS (I-A),2022,SMU,6,6,12,0.5
vs. FCS (I-AA),2022,SMU,1,0,1,1.0
vs. FBS Winning,2022,SMU,2,6,8,0.25
vs. FBS Non-Winning,2022,SMU,4,0,4,1.0
vs. BCS AQ,2022,SMU,5,5,10,0.5
vs. BCS non-AQ,2022,SMU,1,1,2,0.5
vs. FBS Power 5,2022,SMU,0,2,2,0.0
vs. FBS non-Power 5,2022,SMU,6,4,10,0.6
in August/September,2022,SMU,2,2,4,0.5
in October,2022,SMU,2,2,4,0.5
in November,2022,SMU,3,1,4,0.75
in December/January,2022,SMU,0,1,1,0.0
All Games,2009,San Diego State,4,8,12,0.3333333333333333
at Home,2009,San Diego State,3,3,6,0.5
on Road/Neutral Site,2009,San Diego State,1,5,6,0.16666666666666666
vs. Conference,2009,San Diego State,2,6,8,0.25
vs. Non-Conference,2009,San Diego State,2,2,4,0.5
vs. Ranked (AP),2009,San Diego State,0,3,3,0.0
vs. Unranked (AP),2009,San Diego State,4,5,9,0.4444444444444444
vs. FBS (I-A),2009,San Diego State,3,8,11,0.2727272727272727
vs. FCS (I-AA),2009,San Diego State,1,0,1,1.0
vs. FBS Winning,2009,San Diego State,0,7,7,0.0
vs. FBS Non-Winning,2009,San Diego State,3,1,4,0.75
vs. BCS AQ,2009,San Diego State,0,1,1,0.0
vs. BCS non-AQ,2009,San Diego State,3,7,10,0.3
vs. FBS Power 5,2009,San Diego State,0,1,1,0.0
vs. FBS non-Power 5,2009,San Diego State,3,7,10,0.3
in August/September,2009,San Diego State,1,3,4,0.25
in October,2009,San Diego State,3,1,4,0.75
in November,2009,San Diego State,0,4,4,0.0
in December/January,2009,San Diego State,0,0,0,
All Games,2010,San Diego State,9,4,13,0.6923076923076923
at Home,2010,San Diego State,5,1,6,0.8333333333333334
on Road/Neutral Site,2010,San Diego State,4,3,7,0.5714285714285714
vs. Conference,2010,San Diego State,5,3,8,0.625
vs. Non-Conference,2010,San Diego State,4,1,5,0.8
vs. Ranked (AP),2010,San Diego State,0,2,2,0.0
vs. Unranked (AP),2010,San Diego State,9,2,11,0.8181818181818182
vs. FBS (I-A),2010,San Diego State,8,4,12,0.6666666666666666
vs. FCS (I-AA),2010,San Diego State,1,0,1,1.0
vs. FBS Winning,2010,San Diego State,2,4,6,0.3333333333333333
vs. FBS Non-Winning,2010,San Diego State,6,0,6,1.0
vs. BCS AQ,2010,San Diego State,0,1,1,0.0
vs. BCS non-AQ,2010,San Diego State,8,3,11,0.7272727272727273
vs. FBS Power 5,2010,San Diego State,0,1,1,0.0
vs. FBS non-Power 5,2010,San Diego State,8,3,11,0.7272727272727273
in August/September,2010,San Diego State,3,1,4,0.75
in October,2010,San Diego State,3,1,4,0.75
in November,2010,San Diego State,2,2,4,0.5
in December/January,2010,San Diego State,1,0,1,1.0
All Games,2011,San Diego State,8,5,13,0.6153846153846154
at Home,2011,San Diego State,4,3,7,0.5714285714285714
on Road/Neutral Site,2011,San Diego State,4,2,6,0.6666666666666666
vs. Conference,2011,San Diego State,4,3,7,0.5714285714285714
vs. Non-Conference,2011,San Diego State,4,2,6,0.6666666666666666
vs. Ranked (AP),2011,San Diego State,0,3,3,0.0
vs. Unranked (AP),2011,San Diego State,8,2,10,0.8
vs. FBS (I-A),2011,San Diego State,7,5,12,0.5833333333333334
vs. FCS (I-AA),2011,San Diego State,1,0,1,1.0
vs. FBS Winning,2011,San Diego State,1,5,6,0.16666666666666666
vs. FBS Non-Winning,2011,San Diego State,6,0,6,1.0
vs. BCS AQ,2011,San Diego State,1,1,2,0.5
vs. BCS non-AQ,2011,San Diego State,6,4,10,0.6
vs. FBS Power 5,2011,San Diego State,1,1,2,0.5
vs. FBS non-Power 5,2011,San Diego State,6,4,10,0.6
in August/September,2011,San Diego State,3,1,4,0.75
in October,2011,San Diego State,1,2,3,0.3333333333333333
in November,2011,San Diego State,3,1,4,0.75
in December/January,2011,San Diego State,1,1,2,0.5
All Games,2012,San Diego State,9,4,13,0.6923076923076923
at Home,2012,San Diego State,6,1,7,0.8571428571428571
on Road/Neutral Site,2012,San Diego State,3,3,6,0.5
vs. Conference,2012,San Diego State,7,1,8,0.875
vs. Non-Conference,2012,San Diego State,2,3,5,0.4
vs. Ranked (AP),2012,San Diego State,1,1,2,0.5
vs. Unranked (AP),2012,San Diego State,8,3,11,0.7272727272727273
vs. FBS (I-A),2012,San Diego State,8,4,12,0.6666666666666666
vs. FCS (I-AA),2012,San Diego State,1,0,1,1.0
vs. FBS Winning,2012,San Diego State,2,4,6,0.3333333333333333
vs. FBS Non-Winning,2012,San Diego State,6,0,6,1.0
vs. BCS AQ,2012,San Diego State,0,1,1,0.0
vs. BCS non-AQ,2012,San Diego State,8,3,11,0.7272727272727273
vs. FBS Power 5,2012,San Diego State,0,1,1,0.0
vs. FBS non-Power 5,2012,San Diego State,8,3,11,0.7272727272727273
in August/September,2012,San Diego State,2,3,5,0.4
in October,2012,San Diego State,4,0,4,1.0
in November,2012,San Diego State,3,0,3,1.0
in December/January,2012,San Diego State,0,1,1,0.0
All Games,2013,San Diego State,8,5,13,0.6153846153846154
at Home,2013,San Diego State,3,3,6,0.5
on Road/Neutral Site,2013,San Diego State,5,2,7,0.7142857142857143
vs. Conference,2013,San Diego State,6,2,8,0.75
vs. Non-Conference,2013,San Diego State,2,3,5,0.4
vs. Ranked (AP),2013,San Diego State,0,1,1,0.0
vs. Unranked (AP),2013,San Diego State,8,4,12,0.6666666666666666
vs. FBS (I-A),2013,San Diego State,8,4,12,0.6666666666666666
vs. FCS (I-AA),2013,San Diego State,0,1,1,0.0
vs. FBS Winning,2013,San Diego State,2,4,6,0.3333333333333333
vs. FBS Non-Winning,2013,San Diego State,6,0,6,1.0
vs. BCS AQ,2013,San Diego State,0,2,2,0.0
vs. BCS non-AQ,2013,San Diego State,8,2,10,0.8
vs. FBS Power 5,2013,San Diego State,0,2,2,0.0
vs. FBS non-Power 5,2013,San Diego State,8,2,10,0.8
in August/September,2013,San Diego State,1,3,4,0.25
in October,2013,San Diego State,2,1,3,0.6666666666666666
in November,2013,San Diego State,4,1,5,0.8
in December/January,2013,San Diego State,1,0,1,1.0
All Games,2014,San Diego State,7,6,13,0.5384615384615384
at Home,2014,San Diego State,6,0,6,1.0
on Road/Neutral Site,2014,San Diego State,1,6,7,0.14285714285714285
vs. Conference,2014,San Diego State,5,3,8,0.625
vs. Non-Conference,2014,San Diego State,2,3,5,0.4
vs. Ranked (AP),2014,San Diego State,0,1,1,0.0
vs. Unranked (AP),2014,San Diego State,7,5,12,0.5833333333333334
vs. FBS (I-A),2014,San Diego State,6,6,12,0.5
vs. FCS (I-AA),2014,San Diego State,1,0,1,1.0
vs. FBS Winning,2014,San Diego State,1,3,4,0.25
vs. FBS Non-Winning,2014,San Diego State,5,3,8,0.625
vs. BCS AQ,2014,San Diego State,0,2,2,0.0
vs. BCS non-AQ,2014,San Diego State,6,4,10,0.6
vs. FBS Power 5,2014,San Diego State,0,2,2,0.0
vs. FBS non-Power 5,2014,San Diego State,6,4,10,0.6
in August/September,2014,San Diego State,2,2,4,0.5
in October,2014,San Diego State,2,1,3,0.6666666666666666
in November,2014,San Diego State,3,2,5,0.6
in December/January,2014,San Diego State,0,1,1,0.0
All Games,2015,San Diego State,11,3,14,0.7857142857142857
at Home,2015,San Diego State,6,1,7,0.8571428571428571
on Road/Neutral Site,2015,San Diego State,5,2,7,0.7142857142857143
vs. Conference,2015,San Diego State,9,0,9,1.0
vs. Non-Conference,2015,San Diego State,2,3,5,0.4
vs. Ranked (AP),2015,San Diego State,0,0,0,
vs. Unranked (AP),2015,San Diego State,11,3,14,0.7857142857142857
vs. FBS (I-A),2015,San Diego State,10,3,13,0.7692307692307693
vs. FCS (I-AA),2015,San Diego State,1,0,1,1.0
vs. FBS Winning,2015,San Diego State,4,2,6,0.6666666666666666
vs. FBS Non-Winning,2015,San Diego State,6,1,7,0.8571428571428571
vs. BCS AQ,2015,San Diego State,1,2,3,0.3333333333333333
vs. BCS non-AQ,2015,San Diego State,9,1,10,0.9
vs. FBS Power 5,2015,San Diego State,0,2,2,0.0
vs. FBS non-Power 5,2015,San Diego State,10,1,11,0.9090909090909091
in August/September,2015,San Diego State,1,3,4,0.25
in October,2015,San Diego State,5,0,5,1.0
in November,2015,San Diego State,3,0,3,1.0
in December/January,2015,San Diego State,2,0,2,1.0
All Games,2016,San Diego State,11,3,14,0.7857142857142857
at Home,2016,San Diego State,5,1,6,0.8333333333333334
on Road/Neutral Site,2016,San Diego State,6,2,8,0.75
vs. Conference,2016,San Diego State,7,2,9,0.7777777777777778
vs. Non-Conference,2016,San Diego State,4,1,5,0.8
vs. Ranked (AP),2016,San Diego State,0,0,0,
vs. Unranked (AP),2016,San Diego State,11,3,14,0.7857142857142857
vs. FBS (I-A),2016,San Diego State,10,3,13,0.7692307692307693
vs. FCS (I-AA),2016,San Diego State,1,0,1,1.0
vs. FBS Winning,2016,San Diego State,2,2,4,0.5
vs. FBS Non-Winning,2016,San Diego State,8,1,9,0.8888888888888888
vs. BCS AQ,2016,San Diego State,2,0,2,1.0
vs. BCS non-AQ,2016,San Diego State,8,3,11,0.7272727272727273
vs. FBS Power 5,2016,San Diego State,1,0,1,1.0
vs. FBS non-Power 5,2016,San Diego State,9,3,12,0.75
in August/September,2016,San Diego State,3,0,3,1.0
in October,2016,San Diego State,4,1,5,0.8
in November,2016,San Diego State,2,2,4,0.5
in December/January,2016,San Diego State,2,0,2,1.0
All Games,2017,San Diego State,10,3,13,0.7692307692307693
at Home,2017,San Diego State,5,2,7,0.7142857142857143
on Road/Neutral Site,2017,San Diego State,5,1,6,0.8333333333333334
vs. Conference,2017,San Diego State,6,2,8,0.75
vs. Non-Conference,2017,San Diego State,4,1,5,0.8
vs. Ranked (AP),2017,San Diego State,1,1,2,0.5
vs. Unranked (AP),2017,San Diego State,9,2,11,0.8181818181818182
vs. FBS (I-A),2017,San Diego State,9,3,12,0.75
vs. FCS (I-AA),2017,San Diego State,1,0,1,1.0
vs. FBS Winning,2017,San Diego State,3,3,6,0.5
vs. FBS Non-Winning,2017,San Diego State,6,0,6,1.0
vs. BCS AQ,2017,San Diego State,2,0,2,1.0
vs. BCS non-AQ,2017,San Diego State,7,3,10,0.7
vs. FBS Power 5,2017,San Diego State,2,0,2,1.0
vs. FBS non-Power 5,2017,San Diego State,7,3,10,0.7
in August/September,2017,San Diego State,5,0,5,1.0
in October,2017,San Diego State,2,2,4,0.5
in November,2017,San Diego State,3,0,3,1.0
in December/January,2017,San Diego State,0,1,1,0.0
All Games,2018,San Diego State,7,6,13,0.5384615384615384
at Home,2018,San Diego State,5,2,7,0.7142857142857143
on Road/Neutral Site,2018,San Diego State,2,4,6,0.3333333333333333
vs. Conference,2018,San Diego State,4,4,8,0.5
vs. Non-Conference,2018,San Diego State,3,2,5,0.6
vs. Ranked (AP),2018,San Diego State,1,1,2,0.5
vs. Unranked (AP),2018,San Diego State,6,5,11,0.5454545454545454
vs. FBS (I-A),2018,San Diego State,6,6,12,0.5
vs. FCS (I-AA),2018,San Diego State,1,0,1,1.0
vs. FBS Winning,2018,San Diego State,3,5,8,0.375
vs. FBS Non-Winning,2018,San Diego State,3,1,4,0.75
vs. BCS AQ,2018,San Diego State,1,1,2,0.5
vs. BCS non-AQ,2018,San Diego State,5,5,10,0.5
vs. FBS Power 5,2018,San Diego State,1,1,2,0.5
vs. FBS non-Power 5,2018,San Diego State,5,5,10,0.5
in August/September,2018,San Diego State,3,1,4,0.75
in October,2018,San Diego State,3,1,4,0.75
in November,2018,San Diego State,1,3,4,0.25
in December/January,2018,San Diego State,0,1,1,0.0
All Games,2019,San Diego State,10,3,13,0.7692307692307693
at Home,2019,San Diego State,4,2,6,0.6666666666666666
on Road/Neutral Site,2019,San Diego State,6,1,7,0.8571428571428571
vs. Conference,2019,San Diego State,5,3,8,0.625
vs. Non-Conference,2019,San Diego State,5,0,5,1.0
vs. Ranked (AP),2019,San Diego State,0,0,0,
vs. Unranked (AP),2019,San Diego State,10,3,13,0.7692307692307693
vs. FBS (I-A),2019,San Diego State,9,3,12,0.75
vs. FCS (I-AA),2019,San Diego State,1,0,1,1.0
vs. FBS Winning,2019,San Diego State,3,3,6,0.5
vs. FBS Non-Winning,2019,San Diego State,6,0,6,1.0
vs. BCS AQ,2019,San Diego State,1,0,1,1.0
vs. BCS non-AQ,2019,San Diego State,8,3,11,0.7272727272727273
vs. FBS Power 5,2019,San Diego State,1,0,1,1.0
vs. FBS non-Power 5,2019,San Diego State,8,3,11,0.7272727272727273
in August/September,2019,San Diego State,3,1,4,0.75
in October,2019,San Diego State,4,0,4,1.0
in November,2019,San Diego State,2,2,4,0.5
in December/January,2019,San Diego State,1,0,1,1.0
All Games,2020,San Diego State,4,4,8,0.5
at Home,2020,San Diego State,3,0,3,1.0
on Road/Neutral Site,2020,San Diego State,1,4,5,0.2
vs. Conference,2020,San Diego State,4,2,6,0.6666666666666666
vs. Non-Conference,2020,San Diego State,0,2,2,0.0
vs. Ranked (AP),2020,San Diego State,0,2,2,0.0
vs. Unranked (AP),2020,San Diego State,4,2,6,0.6666666666666666
vs. FBS (I-A),2020,San Diego State,4,4,8,0.5
vs. FCS (I-AA),2020,San Diego State,0,0,0,
vs. FBS Winning,2020,San Diego State,1,4,5,0.2
vs. FBS Non-Winning,2020,San Diego State,3,0,3,1.0
vs. BCS AQ,2020,San Diego State,0,1,1,0.0
vs. BCS non-AQ,2020,San Diego State,4,3,7,0.5714285714285714
vs. FBS Power 5,2020,San Diego State,0,1,1,0.0
vs. FBS non-Power 5,2020,San Diego State,4,3,7,0.5714285714285714
in August/September,2020,San Diego State,0,0,0,
in October,2020,San Diego State,2,0,2,1.0
in November,2020,San Diego State,1,3,4,0.25
in December/January,2020,San Diego State,1,1,2,0.5
All Games,2021,San Diego State,12,2,14,0.8571428571428571
at Home,2021,San Diego State,6,2,8,0.75
on Road/Neutral Site,2021,San Diego State,6,0,6,1.0
vs. Conference,2021,San Diego State,7,2,9,0.7777777777777778
vs. Non-Conference,2021,San Diego State,5,0,5,1.0
vs. Ranked (AP),2021,San Diego State,1,1,2,0.5
vs. Unranked (AP),2021,San Diego State,11,1,12,0.9166666666666666
vs. FBS (I-A),2021,San Diego State,11,2,13,0.8461538461538461
vs. FCS (I-AA),2021,San Diego State,1,0,1,1.0
vs. FBS Winning,2021,San Diego State,5,2,7,0.7142857142857143
vs. FBS Non-Winning,2021,San Diego State,6,0,6,1.0
vs. BCS AQ,2021,San Diego State,2,0,2,1.0
vs. BCS non-AQ,2021,San Diego State,9,2,11,0.8181818181818182
vs. FBS Power 5,2021,San Diego State,2,0,2,1.0
vs. FBS non-Power 5,2021,San Diego State,9,2,11,0.8181818181818182
in August/September,2021,San Diego State,4,0,4,1.0
in October,2021,San Diego State,3,1,4,0.75
in November,2021,San Diego State,4,0,4,1.0
in December/January,2021,San Diego State,1,1,2,0.5
All Games,2022,San Diego State,7,6,13,0.5384615384615384
at Home,2022,San Diego State,5,2,7,0.7142857142857143
on Road/Neutral Site,2022,San Diego State,2,4,6,0.3333333333333333
vs. Conference,2022,San Diego State,5,3,8,0.625
vs. Non-Conference,2022,San Diego State,2,3,5,0.4
vs. Ranked (AP),2022,San Diego State,0,2,2,0.0
vs. Unranked (AP),2022,San Diego State,7,4,11,0.6363636363636364
vs. FBS (I-A),2022,San Diego State,6,6,12,0.5
vs. FCS (I-AA),2022,San Diego State,1,0,1,1.0
vs. FBS Winning,2022,San Diego State,2,5,7,0.2857142857142857
vs. FBS Non-Winning,2022,San Diego State,4,1,5,0.8
vs. BCS AQ,2022,San Diego State,0,2,2,0.0
vs. BCS non-AQ,2022,San Diego State,6,4,10,0.6
vs. FBS Power 5,2022,San Diego State,0,2,2,0.0
vs. FBS non-Power 5,2022,San Diego State,6,4,10,0.6
in August/September,2022,San Diego State,2,3,5,0.4
in October,2022,San Diego State,2,1,3,0.6666666666666666
in November,2022,San Diego State,3,1,4,0.75
in December/January,2022,San Diego State,0,1,1,0.0
All Games,2009,San Jose State,2,10,12,0.16666666666666666
at Home,2009,San Jose State,2,4,6,0.3333333333333333
on Road/Neutral Site,2009,San Jose State,0,6,6,0.0
vs. Conference,2009,San Jose State,1,7,8,0.125
vs. Non-Conference,2009,San Jose State,1,3,4,0.25
vs. Ranked (AP),2009,San Jose State,0,3,3,0.0
vs. Unranked (AP),2009,San Jose State,2,7,9,0.2222222222222222
vs. FBS (I-A),2009,San Jose State,1,10,11,0.09090909090909091
vs. FCS (I-AA),2009,San Jose State,1,0,1,1.0
vs. FBS Winning,2009,San Jose State,0,7,7,0.0
vs. FBS Non-Winning,2009,San Jose State,1,3,4,0.25
vs. BCS AQ,2009,San Jose State,0,2,2,0.0
vs. BCS non-AQ,2009,San Jose State,1,8,9,0.1111111111111111
vs. FBS Power 5,2009,San Jose State,0,2,2,0.0
vs. FBS non-Power 5,2009,San Jose State,1,8,9,0.1111111111111111
in August/September,2009,San Jose State,1,3,4,0.25
in October,2009,San Jose State,0,3,3,0.0
in November,2009,San Jose State,1,3,4,0.25
in December/January,2009,San Jose State,0,1,1,0.0
All Games,2010,San Jose State,1,12,13,0.07692307692307693
at Home,2010,San Jose State,1,5,6,0.16666666666666666
on Road/Neutral Site,2010,San Jose State,0,7,7,0.0
vs. Conference,2010,San Jose State,0,8,8,0.0
vs. Non-Conference,2010,San Jose State,1,4,5,0.2
vs. Ranked (AP),2010,San Jose State,0,4,4,0.0
vs. Unranked (AP),2010,San Jose State,1,8,9,0.1111111111111111
vs. FBS (I-A),2010,San Jose State,0,11,11,0.0
vs. FCS (I-AA),2010,San Jose State,1,1,2,0.5
vs. FBS Winning,2010,San Jose State,0,7,7,0.0
vs. FBS Non-Winning,2010,San Jose State,0,4,4,0.0
vs. BCS AQ,2010,San Jose State,0,2,2,0.0
vs. BCS non-AQ,2010,San Jose State,0,9,9,0.0
vs. FBS Power 5,2010,San Jose State,0,2,2,0.0
vs. FBS non-Power 5,2010,San Jose State,0,9,9,0.0
in August/September,2010,San Jose State,1,3,4,0.25
in October,2010,San Jose State,0,5,5,0.0
in November,2010,San Jose State,0,3,3,0.0
in December/January,2010,San Jose State,0,1,1,0.0
All Games,2011,San Jose State,5,7,12,0.4166666666666667
at Home,2011,San Jose State,3,2,5,0.6
on Road/Neutral Site,2011,San Jose State,2,5,7,0.2857142857142857
vs. Conference,2011,San Jose State,3,4,7,0.42857142857142855
vs. Non-Conference,2011,San Jose State,2,3,5,0.4
vs. Ranked (AP),2011,San Jose State,0,1,1,0.0
vs. Unranked (AP),2011,San Jose State,5,6,11,0.45454545454545453
vs. FBS (I-A),2011,San Jose State,5,7,12,0.4166666666666667
vs. FCS (I-AA),2011,San Jose State,0,0,0,
vs. FBS Winning,2011,San Jose State,0,5,5,0.0
vs. FBS Non-Winning,2011,San Jose State,5,2,7,0.7142857142857143
vs. BCS AQ,2011,San Jose State,0,2,2,0.0
vs. BCS non-AQ,2011,San Jose State,5,5,10,0.5
vs. FBS Power 5,2011,San Jose State,0,2,2,0.0
vs. FBS non-Power 5,2011,San Jose State,5,5,10,0.5
in August/September,2011,San Jose State,1,3,4,0.25
in October,2011,San Jose State,2,2,4,0.5
in November,2011,San Jose State,2,2,4,0.5
in December/January,2011,San Jose State,0,0,0,
All Games,2012,San Jose State,11,2,13,0.8461538461538461
at Home,2012,San Jose State,5,1,6,0.8333333333333334
on Road/Neutral Site,2012,San Jose State,6,1,7,0.8571428571428571
vs. Conference,2012,San Jose State,5,1,6,0.8333333333333334
vs. Non-Conference,2012,San Jose State,6,1,7,0.8571428571428571
vs. Ranked (AP),2012,San Jose State,0,2,2,0.0
vs. Unranked (AP),2012,San Jose State,11,0,11,1.0
vs. FBS (I-A),2012,San Jose State,10,2,12,0.8333333333333334
vs. FCS (I-AA),2012,San Jose State,1,0,1,1.0
vs. FBS Winning,2012,San Jose State,6,2,8,0.75
vs. FBS Non-Winning,2012,San Jose State,4,0,4,1.0
vs. BCS AQ,2012,San Jose State,0,1,1,0.0
vs. BCS non-AQ,2012,San Jose State,10,1,11,0.9090909090909091
vs. FBS Power 5,2012,San Jose State,0,1,1,0.0
vs. FBS non-Power 5,2012,San Jose State,10,1,11,0.9090909090909091
in August/September,2012,San Jose State,4,1,5,0.8
in October,2012,San Jose State,2,1,3,0.6666666666666666
in November,2012,San Jose State,4,0,4,1.0
in December/January,2012,San Jose State,1,0,1,1.0
All Games,2013,San Jose State,6,6,12,0.5
at Home,2013,San Jose State,3,3,6,0.5
on Road/Neutral Site,2013,San Jose State,3,3,6,0.5
vs. Conference,2013,San Jose State,5,3,8,0.625
vs. Non-Conference,2013,San Jose State,1,3,4,0.25
vs. Ranked (AP),2013,San Jose State,0,1,1,0.0
vs. Unranked (AP),2013,San Jose State,6,5,11,0.5454545454545454
vs. FBS (I-A),2013,San Jose State,5,6,11,0.45454545454545453
vs. FCS (I-AA),2013,San Jose State,1,0,1,1.0
vs. FBS Winning,2013,San Jose State,3,5,8,0.375
vs. FBS Non-Winning,2013,San Jose State,2,1,3,0.6666666666666666
vs. BCS AQ,2013,San Jose State,0,2,2,0.0
vs. BCS non-AQ,2013,San Jose State,5,4,9,0.5555555555555556
vs. FBS Power 5,2013,San Jose State,0,2,2,0.0
vs. FBS non-Power 5,2013,San Jose State,5,4,9,0.5555555555555556
in August/September,2013,San Jose State,1,3,4,0.25
in October,2013,San Jose State,3,0,3,1.0
in November,2013,San Jose State,2,3,5,0.4
in December/January,2013,San Jose State,0,0,0,
All Games,2014,San Jose State,3,9,12,0.25
at Home,2014,San Jose State,2,3,5,0.4
on Road/Neutral Site,2014,San Jose State,1,6,7,0.14285714285714285
vs. Conference,2014,San Jose State,2,6,8,0.25
vs. Non-Conference,2014,San Jose State,1,3,4,0.25
vs. Ranked (AP),2014,San Jose State,0,1,1,0.0
vs. Unranked (AP),2014,San Jose State,3,8,11,0.2727272727272727
vs. FBS (I-A),2014,San Jose State,2,9,11,0.18181818181818182
vs. FCS (I-AA),2014,San Jose State,1,0,1,1.0
vs. FBS Winning,2014,San Jose State,0,7,7,0.0
vs. FBS Non-Winning,2014,San Jose State,2,2,4,0.5
vs. BCS AQ,2014,San Jose State,0,2,2,0.0
vs. BCS non-AQ,2014,San Jose State,2,7,9,0.2222222222222222
vs. FBS Power 5,2014,San Jose State,0,2,2,0.0
vs. FBS non-Power 5,2014,San Jose State,2,7,9,0.2222222222222222
in August/September,2014,San Jose State,1,3,4,0.25
in October,2014,San Jose State,2,1,3,0.6666666666666666
in November,2014,San Jose State,0,5,5,0.0
in December/January,2014,San Jose State,0,0,0,
All Games,2015,San Jose State,6,7,13,0.46153846153846156
at Home,2015,San Jose State,3,3,6,0.5
on Road/Neutral Site,2015,San Jose State,3,4,7,0.42857142857142855
vs. Conference,2015,San Jose State,4,4,8,0.5
vs. Non-Conference,2015,San Jose State,2,3,5,0.4
vs. Ranked (AP),2015,San Jose State,0,0,0,
vs. Unranked (AP),2015,San Jose State,6,7,13,0.46153846153846156
vs. FBS (I-A),2015,San Jose State,5,7,12,0.4166666666666667
vs. FCS (I-AA),2015,San Jose State,1,0,1,1.0
vs. FBS Winning,2015,San Jose State,1,6,7,0.14285714285714285
vs. FBS Non-Winning,2015,San Jose State,4,1,5,0.8
vs. BCS AQ,2015,San Jose State,0,2,2,0.0
vs. BCS non-AQ,2015,San Jose State,5,5,10,0.5
vs. FBS Power 5,2015,San Jose State,0,2,2,0.0
vs. FBS non-Power 5,2015,San Jose State,5,5,10,0.5
in August/September,2015,San Jose State,2,2,4,0.5
in October,2015,San Jose State,2,2,4,0.5
in November,2015,San Jose State,1,3,4,0.25
in December/January,2015,San Jose State,1,0,1,1.0
All Games,2016,San Jose State,4,8,12,0.3333333333333333
at Home,2016,San Jose State,3,3,6,0.5
on Road/Neutral Site,2016,San Jose State,1,5,6,0.16666666666666666
vs. Conference,2016,San Jose State,3,5,8,0.375
vs. Non-Conference,2016,San Jose State,1,3,4,0.25
vs. Ranked (AP),2016,San Jose State,0,0,0,
vs. Unranked (AP),2016,San Jose State,4,8,12,0.3333333333333333
vs. FBS (I-A),2016,San Jose State,3,8,11,0.2727272727272727
vs. FCS (I-AA),2016,San Jose State,1,0,1,1.0
vs. FBS Winning,2016,San Jose State,0,6,6,0.0
vs. FBS Non-Winning,2016,San Jose State,3,2,5,0.6
vs. BCS AQ,2016,San Jose State,0,3,3,0.0
vs. BCS non-AQ,2016,San Jose State,3,5,8,0.375
vs. FBS Power 5,2016,San Jose State,0,2,2,0.0
vs. FBS non-Power 5,2016,San Jose State,3,6,9,0.3333333333333333
in August/September,2016,San Jose State,1,3,4,0.25
in October,2016,San Jose State,2,3,5,0.4
in November,2016,San Jose State,1,2,3,0.3333333333333333
in December/January,2016,San Jose State,0,0,0,
All Games,2017,San Jose State,2,11,13,0.15384615384615385
at Home,2017,San Jose State,2,4,6,0.3333333333333333
on Road/Neutral Site,2017,San Jose State,0,7,7,0.0
vs. Conference,2017,San Jose State,1,7,8,0.125
vs. Non-Conference,2017,San Jose State,1,4,5,0.2
vs. Ranked (AP),2017,San Jose State,0,1,1,0.0
vs. Unranked (AP),2017,San Jose State,2,10,12,0.16666666666666666
vs. FBS (I-A),2017,San Jose State,1,11,12,0.08333333333333333
vs. FCS (I-AA),2017,San Jose State,1,0,1,1.0
vs. FBS Winning,2017,San Jose State,1,6,7,0.14285714285714285
vs. FBS Non-Winning,2017,San Jose State,0,5,5,0.0
vs. BCS AQ,2017,San Jose State,0,3,3,0.0
vs. BCS non-AQ,2017,San Jose State,1,8,9,0.1111111111111111
vs. FBS Power 5,2017,San Jose State,0,2,2,0.0
vs. FBS non-Power 5,2017,San Jose State,1,9,10,0.1
in August/September,2017,San Jose State,1,5,6,0.16666666666666666
in October,2017,San Jose State,0,3,3,0.0
in November,2017,San Jose State,1,3,4,0.25
in December/January,2017,San Jose State,0,0,0,
All Games,2018,San Jose State,1,11,12,0.08333333333333333
at Home,2018,San Jose State,1,4,5,0.2
on Road/Neutral Site,2018,San Jose State,0,7,7,0.0
vs. Conference,2018,San Jose State,1,7,8,0.125
vs. Non-Conference,2018,San Jose State,0,4,4,0.0
vs. Ranked (AP),2018,San Jose State,0,4,4,0.0
vs. Unranked (AP),2018,San Jose State,1,7,8,0.125
vs. FBS (I-A),2018,San Jose State,1,10,11,0.09090909090909091
vs. FCS (I-AA),2018,San Jose State,0,1,1,0.0
vs. FBS Winning,2018,San Jose State,0,8,8,0.0
vs. FBS Non-Winning,2018,San Jose State,1,2,3,0.3333333333333333
vs. BCS AQ,2018,San Jose State,0,2,2,0.0
vs. BCS non-AQ,2018,San Jose State,1,8,9,0.1111111111111111
vs. FBS Power 5,2018,San Jose State,0,2,2,0.0
vs. FBS non-Power 5,2018,San Jose State,1,8,9,0.1111111111111111
in August/September,2018,San Jose State,0,4,4,0.0
in October,2018,San Jose State,1,3,4,0.25
in November,2018,San Jose State,0,4,4,0.0
in December/January,2018,San Jose State,0,0,0,
All Games,2019,San Jose State,5,7,12,0.4166666666666667
at Home,2019,San Jose State,3,3,6,0.5
on Road/Neutral Site,2019,San Jose State,2,4,6,0.3333333333333333
vs. Conference,2019,San Jose State,2,6,8,0.25
vs. Non-Conference,2019,San Jose State,3,1,4,0.75
vs. Ranked (AP),2019,San Jose State,0,2,2,0.0
vs. Unranked (AP),2019,San Jose State,5,5,10,0.5
vs. FBS (I-A),2019,San Jose State,4,7,11,0.36363636363636365
vs. FCS (I-AA),2019,San Jose State,1,0,1,1.0
vs. FBS Winning,2019,San Jose State,0,5,5,0.0
vs. FBS Non-Winning,2019,San Jose State,4,2,6,0.6666666666666666
vs. BCS AQ,2019,San Jose State,1,1,2,0.5
vs. BCS non-AQ,2019,San Jose State,3,6,9,0.3333333333333333
vs. FBS Power 5,2019,San Jose State,1,0,1,1.0
vs. FBS non-Power 5,2019,San Jose State,3,7,10,0.3
in August/September,2019,San Jose State,2,2,4,0.5
in October,2019,San Jose State,2,2,4,0.5
in November,2019,San Jose State,1,3,4,0.25
in December/January,2019,San Jose State,0,0,0,
All Games,2020,San Jose State,7,1,8,0.875
at Home,2020,San Jose State,3,0,3,1.0
on Road/Neutral Site,2020,San Jose State,4,1,5,0.8
vs. Conference,2020,San Jose State,7,0,7,1.0
vs. Non-Conference,2020,San Jose State,0,1,1,0.0
vs. Ranked (AP),2020,San Jose State,0,0,0,
vs. Unranked (AP),2020,San Jose State,7,1,8,0.875
vs. FBS (I-A),2020,San Jose State,7,1,8,0.875
vs. FCS (I-AA),2020,San Jose State,0,0,0,
vs. FBS Winning,2020,San Jose State,3,1,4,0.75
vs. FBS Non-Winning,2020,San Jose State,4,0,4,1.0
vs. BCS AQ,2020,San Jose State,0,0,0,
vs. BCS non-AQ,2020,San Jose State,7,1,8,0.875
vs. FBS Power 5,2020,San Jose State,0,0,0,
vs. FBS non-Power 5,2020,San Jose State,7,1,8,0.875
in August/September,2020,San Jose State,0,0,0,
in October,2020,San Jose State,2,0,2,1.0
in November,2020,San Jose State,2,0,2,1.0
in December/January,2020,San Jose State,3,1,4,0.75
All Games,2021,San Jose State,5,7,12,0.4166666666666667
at Home,2021,San Jose State,3,3,6,0.5
on Road/Neutral Site,2021,San Jose State,2,4,6,0.3333333333333333
vs. Conference,2021,San Jose State,3,5,8,0.375
vs. Non-Conference,2021,San Jose State,2,2,4,0.5
vs. Ranked (AP),2021,San Jose State,0,2,2,0.0
vs. Unranked (AP),2021,San Jose State,5,5,10,0.5
vs. FBS (I-A),2021,San Jose State,4,7,11,0.36363636363636365
vs. FCS (I-AA),2021,San Jose State,1,0,1,1.0
vs. FBS Winning,2021,San Jose State,1,5,6,0.16666666666666666
vs. FBS Non-Winning,2021,San Jose State,3,2,5,0.6
vs. BCS AQ,2021,San Jose State,0,1,1,0.0
vs. BCS non-AQ,2021,San Jose State,4,6,10,0.4
vs. FBS Power 5,2021,San Jose State,0,1,1,0.0
vs. FBS non-Power 5,2021,San Jose State,4,6,10,0.4
in August/September,2021,San Jose State,2,2,4,0.5
in October,2021,San Jose State,3,2,5,0.6
in November,2021,San Jose State,0,3,3,0.0
in December/January,2021,San Jose State,0,0,0,
All Games,2022,San Jose State,7,5,12,0.5833333333333334
at Home,2022,San Jose State,6,0,6,1.0
on Road/Neutral Site,2022,San Jose State,1,5,6,0.16666666666666666
vs. Conference,2022,San Jose State,5,3,8,0.625
vs. Non-Conference,2022,San Jose State,2,2,4,0.5
vs. Ranked (AP),2022,San Jose State,0,1,1,0.0
vs. Unranked (AP),2022,San Jose State,7,4,11,0.6363636363636364
vs. FBS (I-A),2022,San Jose State,6,5,11,0.5454545454545454
vs. FCS (I-AA),2022,San Jose State,1,0,1,1.0
vs. FBS Winning,2022,San Jose State,1,3,4,0.25
vs. FBS Non-Winning,2022,San Jose State,5,2,7,0.7142857142857143
vs. BCS AQ,2022,San Jose State,0,1,1,0.0
vs. BCS non-AQ,2022,San Jose State,6,4,10,0.6
vs. FBS Power 5,2022,San Jose State,0,1,1,0.0
vs. FBS non-Power 5,2022,San Jose State,6,4,10,0.6
in August/September,2022,San Jose State,2,1,3,0.6666666666666666
in October,2022,San Jose State,3,1,4,0.75
in November,2022,San Jose State,2,2,4,0.5
in December/January,2022,San Jose State,0,1,1,0.0
All Games,2012,South Alabama,2,11,13,0.15384615384615385
at Home,2012,South Alabama,2,4,6,0.3333333333333333
on Road/Neutral Site,2012,South Alabama,0,7,7,0.0
vs. Conference,2012,South Alabama,1,7,8,0.125
vs. Non-Conference,2012,South Alabama,1,4,5,0.2
vs. Ranked (AP),2012,South Alabama,0,0,0,
vs. Unranked (AP),2012,South Alabama,2,11,13,0.15384615384615385
vs. FBS (I-A),2012,South Alabama,1,11,12,0.08333333333333333
vs. FCS (I-AA),2012,South Alabama,1,0,1,1.0
vs. FBS Winning,2012,South Alabama,0,7,7,0.0
vs. FBS Non-Winning,2012,South Alabama,1,4,5,0.2
vs. BCS AQ,2012,South Alabama,0,2,2,0.0
vs. BCS non-AQ,2012,South Alabama,1,9,10,0.1
vs. FBS Power 5,2012,South Alabama,0,2,2,0.0
vs. FBS non-Power 5,2012,South Alabama,1,9,10,0.1
in August/September,2012,South Alabama,1,4,5,0.2
in October,2012,South Alabama,1,2,3,0.3333333333333333
in November,2012,South Alabama,0,4,4,0.0
in December/January,2012,South Alabama,0,1,1,0.0
All Games,2013,South Alabama,6,6,12,0.5
at Home,2013,South Alabama,4,2,6,0.6666666666666666
on Road/Neutral Site,2013,South Alabama,2,4,6,0.3333333333333333
vs. Conference,2013,South Alabama,4,3,7,0.5714285714285714
vs. Non-Conference,2013,South Alabama,2,3,5,0.4
vs. Ranked (AP),2013,South Alabama,0,0,0,
vs. Unranked (AP),2013,South Alabama,6,6,12,0.5
vs. FBS (I-A),2013,South Alabama,6,5,11,0.5454545454545454
vs. FCS (I-AA),2013,South Alabama,0,1,1,0.0
vs. FBS Winning,2013,South Alabama,3,2,5,0.6
vs. FBS Non-Winning,2013,South Alabama,3,3,6,0.5
vs. BCS AQ,2013,South Alabama,0,1,1,0.0
vs. BCS non-AQ,2013,South Alabama,6,4,10,0.6
vs. FBS Power 5,2013,South Alabama,0,1,1,0.0
vs. FBS non-Power 5,2013,South Alabama,6,4,10,0.6
in August/September,2013,South Alabama,2,2,4,0.5
in October,2013,South Alabama,1,2,3,0.3333333333333333
in November,2013,South Alabama,2,2,4,0.5
in December/January,2013,South Alabama,1,0,1,1.0
All Games,2014,South Alabama,6,7,13,0.46153846153846156
at Home,2014,South Alabama,3,3,6,0.5
on Road/Neutral Site,2014,South Alabama,3,4,7,0.42857142857142855
vs. Conference,2014,South Alabama,5,3,8,0.625
vs. Non-Conference,2014,South Alabama,1,4,5,0.2
vs. Ranked (AP),2014,South Alabama,0,1,1,0.0
vs. Unranked (AP),2014,South Alabama,6,6,12,0.5
vs. FBS (I-A),2014,South Alabama,6,7,13,0.46153846153846156
vs. FCS (I-AA),2014,South Alabama,0,0,0,
vs. FBS Winning,2014,South Alabama,2,7,9,0.2222222222222222
vs. FBS Non-Winning,2014,South Alabama,4,0,4,1.0
vs. BCS AQ,2014,South Alabama,0,2,2,0.0
vs. BCS non-AQ,2014,South Alabama,6,5,11,0.5454545454545454
vs. FBS Power 5,2014,South Alabama,0,2,2,0.0
vs. FBS non-Power 5,2014,South Alabama,6,5,11,0.5454545454545454
in August/September,2014,South Alabama,2,2,4,0.5
in October,2014,South Alabama,3,0,3,1.0
in November,2014,South Alabama,1,4,5,0.2
in December/January,2014,South Alabama,0,1,1,0.0
All Games,2015,South Alabama,5,7,12,0.4166666666666667
at Home,2015,South Alabama,3,3,6,0.5
on Road/Neutral Site,2015,South Alabama,2,4,6,0.3333333333333333
vs. Conference,2015,South Alabama,3,5,8,0.375
vs. Non-Conference,2015,South Alabama,2,2,4,0.5
vs. Ranked (AP),2015,South Alabama,0,0,0,
vs. Unranked (AP),2015,South Alabama,5,7,12,0.4166666666666667
vs. FBS (I-A),2015,South Alabama,4,7,11,0.36363636363636365
vs. FCS (I-AA),2015,South Alabama,1,0,1,1.0
vs. FBS Winning,2015,South Alabama,1,4,5,0.2
vs. FBS Non-Winning,2015,South Alabama,3,3,6,0.5
vs. BCS AQ,2015,South Alabama,0,2,2,0.0
vs. BCS non-AQ,2015,South Alabama,4,5,9,0.4444444444444444
vs. FBS Power 5,2015,South Alabama,0,2,2,0.0
vs. FBS non-Power 5,2015,South Alabama,4,5,9,0.4444444444444444
in August/September,2015,South Alabama,2,2,4,0.5
in October,2015,South Alabama,1,2,3,0.3333333333333333
in November,2015,South Alabama,2,2,4,0.5
in December/January,2015,South Alabama,0,1,1,0.0
All Games,2016,South Alabama,6,7,13,0.46153846153846156
at Home,2016,South Alabama,5,2,7,0.7142857142857143
on Road/Neutral Site,2016,South Alabama,1,5,6,0.16666666666666666
vs. Conference,2016,South Alabama,2,6,8,0.25
vs. Non-Conference,2016,South Alabama,4,1,5,0.8
vs. Ranked (AP),2016,South Alabama,0,0,0,
vs. Unranked (AP),2016,South Alabama,6,7,13,0.46153846153846156
vs. FBS (I-A),2016,South Alabama,4,7,11,0.36363636363636365
vs. FCS (I-AA),2016,South Alabama,2,0,2,1.0
vs. FBS Winning,2016,South Alabama,1,4,5,0.2
vs. FBS Non-Winning,2016,South Alabama,3,3,6,0.5
vs. BCS AQ,2016,South Alabama,1,0,1,1.0
vs. BCS non-AQ,2016,South Alabama,3,7,10,0.3
vs. FBS Power 5,2016,South Alabama,1,0,1,1.0
vs. FBS non-Power 5,2016,South Alabama,3,7,10,0.3
in August/September,2016,South Alabama,2,2,4,0.5
in October,2016,South Alabama,2,2,4,0.5
in November,2016,South Alabama,1,2,3,0.3333333333333333
in December/January,2016,South Alabama,1,1,2,0.5
All Games,2017,South Alabama,4,8,12,0.3333333333333333
at Home,2017,South Alabama,3,3,6,0.5
on Road/Neutral Site,2017,South Alabama,1,5,6,0.16666666666666666
vs. Conference,2017,South Alabama,3,5,8,0.375
vs. Non-Conference,2017,South Alabama,1,3,4,0.25
vs. Ranked (AP),2017,South Alabama,0,1,1,0.0
vs. Unranked (AP),2017,South Alabama,4,7,11,0.36363636363636365
vs. FBS (I-A),2017,South Alabama,3,8,11,0.2727272727272727
vs. FCS (I-AA),2017,South Alabama,1,0,1,1.0
vs. FBS Winning,2017,South Alabama,2,4,6,0.3333333333333333
vs. FBS Non-Winning,2017,South Alabama,1,4,5,0.2
vs. BCS AQ,2017,South Alabama,0,2,2,0.0
vs. BCS non-AQ,2017,South Alabama,3,6,9,0.3333333333333333
vs. FBS Power 5,2017,South Alabama,0,2,2,0.0
vs. FBS non-Power 5,2017,South Alabama,3,6,9,0.3333333333333333
in August/September,2017,South Alabama,1,4,5,0.2
in October,2017,South Alabama,2,1,3,0.6666666666666666
in November,2017,South Alabama,1,2,3,0.3333333333333333
in December/January,2017,South Alabama,0,1,1,0.0
All Games,2018,South Alabama,3,9,12,0.25
at Home,2018,South Alabama,3,3,6,0.5
on Road/Neutral Site,2018,South Alabama,0,6,6,0.0
vs. Conference,2018,South Alabama,2,6,8,0.25
vs. Non-Conference,2018,South Alabama,1,3,4,0.25
vs. Ranked (AP),2018,South Alabama,0,0,0,
vs. Unranked (AP),2018,South Alabama,3,9,12,0.25
vs. FBS (I-A),2018,South Alabama,2,9,11,0.18181818181818182
vs. FCS (I-AA),2018,South Alabama,1,0,1,1.0
vs. FBS Winning,2018,South Alabama,0,7,7,0.0
vs. FBS Non-Winning,2018,South Alabama,2,2,4,0.5
vs. BCS AQ,2018,South Alabama,0,2,2,0.0
vs. BCS non-AQ,2018,South Alabama,2,7,9,0.2222222222222222
vs. FBS Power 5,2018,South Alabama,0,1,1,0.0
vs. FBS non-Power 5,2018,South Alabama,2,8,10,0.2
in August/September,2018,South Alabama,1,4,5,0.2
in October,2018,South Alabama,1,2,3,0.3333333333333333
in November,2018,South Alabama,1,3,4,0.25
in December/January,2018,South Alabama,0,0,0,
All Games,2019,South Alabama,2,10,12,0.16666666666666666
at Home,2019,South Alabama,2,4,6,0.3333333333333333
on Road/Neutral Site,2019,South Alabama,0,6,6,0.0
vs. Conference,2019,South Alabama,1,7,8,0.125
vs. Non-Conference,2019,South Alabama,1,3,4,0.25
vs. Ranked (AP),2019,South Alabama,0,2,2,0.0
vs. Unranked (AP),2019,South Alabama,2,8,10,0.2
vs. FBS (I-A),2019,South Alabama,1,10,11,0.09090909090909091
vs. FCS (I-AA),2019,South Alabama,1,0,1,1.0
vs. FBS Winning,2019,South Alabama,1,6,7,0.14285714285714285
vs. FBS Non-Winning,2019,South Alabama,0,4,4,0.0
vs. BCS AQ,2019,South Alabama,0,2,2,0.0
vs. BCS non-AQ,2019,South Alabama,1,8,9,0.1111111111111111
vs. FBS Power 5,2019,South Alabama,0,1,1,0.0
vs. FBS non-Power 5,2019,South Alabama,1,9,10,0.1
in August/September,2019,South Alabama,1,4,5,0.2
in October,2019,South Alabama,0,3,3,0.0
in November,2019,South Alabama,1,3,4,0.25
in December/January,2019,South Alabama,0,0,0,
All Games,2020,South Alabama,4,7,11,0.36363636363636365
at Home,2020,South Alabama,2,4,6,0.3333333333333333
on Road/Neutral Site,2020,South Alabama,2,3,5,0.4
vs. Conference,2020,South Alabama,3,5,8,0.375
vs. Non-Conference,2020,South Alabama,1,2,3,0.3333333333333333
vs. Ranked (AP),2020,South Alabama,0,2,2,0.0
vs. Unranked (AP),2020,South Alabama,4,5,9,0.4444444444444444
vs. FBS (I-A),2020,South Alabama,4,7,11,0.36363636363636365
vs. FCS (I-AA),2020,South Alabama,0,0,0,
vs. FBS Winning,2020,South Alabama,0,5,5,0.0
vs. FBS Non-Winning,2020,South Alabama,4,2,6,0.6666666666666666
vs. BCS AQ,2020,South Alabama,0,1,1,0.0
vs. BCS non-AQ,2020,South Alabama,4,6,10,0.4
vs. FBS Power 5,2020,South Alabama,0,0,0,
vs. FBS non-Power 5,2020,South Alabama,4,7,11,0.36363636363636365
in August/September,2020,South Alabama,1,2,3,0.3333333333333333
in October,2020,South Alabama,2,1,3,0.6666666666666666
in November,2020,South Alabama,1,3,4,0.25
in December/January,2020,South Alabama,0,1,1,0.0
All Games,2021,South Alabama,5,7,12,0.4166666666666667
at Home,2021,South Alabama,4,2,6,0.6666666666666666
on Road/Neutral Site,2021,South Alabama,1,5,6,0.16666666666666666
vs. Conference,2021,South Alabama,2,6,8,0.25
vs. Non-Conference,2021,South Alabama,3,1,4,0.75
vs. Ranked (AP),2021,South Alabama,0,1,1,0.0
vs. Unranked (AP),2021,South Alabama,5,6,11,0.45454545454545453
vs. FBS (I-A),2021,South Alabama,4,7,11,0.36363636363636365
vs. FCS (I-AA),2021,South Alabama,1,0,1,1.0
vs. FBS Winning,2021,South Alabama,0,4,4,0.0
vs. FBS Non-Winning,2021,South Alabama,4,3,7,0.5714285714285714
vs. BCS AQ,2021,South Alabama,0,1,1,0.0
vs. BCS non-AQ,2021,South Alabama,4,6,10,0.4
vs. FBS Power 5,2021,South Alabama,0,1,1,0.0
vs. FBS non-Power 5,2021,South Alabama,4,6,10,0.4
in August/September,2021,South Alabama,3,0,3,1.0
in October,2021,South Alabama,2,3,5,0.4
in November,2021,South Alabama,0,4,4,0.0
in December/January,2021,South Alabama,0,0,0,
All Games,2022,South Alabama,10,3,13,0.7692307692307693
at Home,2022,South Alabama,5,1,6,0.8333333333333334
on Road/Neutral Site,2022,South Alabama,5,2,7,0.7142857142857143
vs. Conference,2022,South Alabama,7,1,8,0.875
vs. Non-Conference,2022,South Alabama,3,2,5,0.6
vs. Ranked (AP),2022,South Alabama,0,2,2,0.0
vs. Unranked (AP),2022,South Alabama,10,1,11,0.9090909090909091
vs. FBS (I-A),2022,South Alabama,9,3,12,0.75
vs. FCS (I-AA),2022,South Alabama,1,0,1,1.0
vs. FBS Winning,2022,South Alabama,1,3,4,0.25
vs. FBS Non-Winning,2022,South Alabama,8,0,8,1.0
vs. BCS AQ,2022,South Alabama,0,1,1,0.0
vs. BCS non-AQ,2022,South Alabama,9,2,11,0.8181818181818182
vs. FBS Power 5,2022,South Alabama,0,1,1,0.0
vs. FBS non-Power 5,2022,South Alabama,9,2,11,0.8181818181818182
in August/September,2022,South Alabama,3,1,4,0.75
in October,2022,South Alabama,3,1,4,0.75
in November,2022,South Alabama,4,0,4,1.0
in December/January,2022,South Alabama,0,1,1,0.0
All Games,2009,South Carolina,7,6,13,0.5384615384615384
at Home,2009,South Carolina,6,1,7,0.8571428571428571
on Road/Neutral Site,2009,South Carolina,1,5,6,0.16666666666666666
vs. Conference,2009,South Carolina,3,5,8,0.375
vs. Non-Conference,2009,South Carolina,4,1,5,0.8
vs. Ranked (AP),2009,South Carolina,2,2,4,0.5
vs. Unranked (AP),2009,South Carolina,5,4,9,0.5555555555555556
vs. FBS (I-A),2009,South Carolina,6,6,12,0.5
vs. FCS (I-AA),2009,South Carolina,1,0,1,1.0
vs. FBS Winning,2009,South Carolina,3,6,9,0.3333333333333333
vs. FBS Non-Winning,2009,South Carolina,3,0,3,1.0
vs. BCS AQ,2009,South Carolina,5,6,11,0.45454545454545453
vs. BCS non-AQ,2009,South Carolina,1,0,1,1.0
vs. FBS Power 5,2009,South Carolina,5,5,10,0.5
vs. FBS non-Power 5,2009,South Carolina,1,1,2,0.5
in August/September,2009,South Carolina,3,1,4,0.75
in October,2009,South Carolina,3,2,5,0.6
in November,2009,South Carolina,1,2,3,0.3333333333333333
in December/January,2009,South Carolina,0,1,1,0.0
All Games,2010,South Carolina,9,5,14,0.6428571428571429
at Home,2010,South Carolina,6,1,7,0.8571428571428571
on Road/Neutral Site,2010,South Carolina,3,4,7,0.42857142857142855
vs. Conference,2010,South Carolina,5,4,9,0.5555555555555556
vs. Non-Conference,2010,South Carolina,4,1,5,0.8
vs. Ranked (AP),2010,South Carolina,1,4,5,0.2
vs. Unranked (AP),2010,South Carolina,8,1,9,0.8888888888888888
vs. FBS (I-A),2010,South Carolina,8,5,13,0.6153846153846154
vs. FCS (I-AA),2010,South Carolina,1,0,1,1.0
vs. FBS Winning,2010,South Carolina,4,4,8,0.5
vs. FBS Non-Winning,2010,South Carolina,4,1,5,0.8
vs. BCS AQ,2010,South Carolina,6,5,11,0.5454545454545454
vs. BCS non-AQ,2010,South Carolina,2,0,2,1.0
vs. FBS Power 5,2010,South Carolina,6,5,11,0.5454545454545454
vs. FBS non-Power 5,2010,South Carolina,2,0,2,1.0
in August/September,2010,South Carolina,3,1,4,0.75
in October,2010,South Carolina,3,1,4,0.75
in November,2010,South Carolina,3,1,4,0.75
in December/January,2010,South Carolina,0,2,2,0.0
All Games,2011,South Carolina,11,2,13,0.8461538461538461
at Home,2011,South Carolina,6,1,7,0.8571428571428571
on Road/Neutral Site,2011,South Carolina,5,1,6,0.8333333333333334
vs. Conference,2011,South Carolina,6,2,8,0.75
vs. Non-Conference,2011,South Carolina,5,0,5,1.0
vs. Ranked (AP),2011,South Carolina,3,1,4,0.75
vs. Unranked (AP),2011,South Carolina,8,1,9,0.8888888888888888
vs. FBS (I-A),2011,South Carolina,10,2,12,0.8333333333333334
vs. FCS (I-AA),2011,South Carolina,1,0,1,1.0
vs. FBS Winning,2011,South Carolina,5,2,7,0.7142857142857143
vs. FBS Non-Winning,2011,South Carolina,5,0,5,1.0
vs. BCS AQ,2011,South Carolina,8,2,10,0.8
vs. BCS non-AQ,2011,South Carolina,2,0,2,1.0
vs. FBS Power 5,2011,South Carolina,8,2,10,0.8
vs. FBS non-Power 5,2011,South Carolina,2,0,2,1.0
in August/September,2011,South Carolina,4,0,4,1.0
in October,2011,South Carolina,3,1,4,0.75
in November,2011,South Carolina,3,1,4,0.75
in December/January,2011,South Carolina,1,0,1,1.0
All Games,2012,South Carolina,11,2,13,0.8461538461538461
at Home,2012,South Carolina,7,0,7,1.0
on Road/Neutral Site,2012,South Carolina,4,2,6,0.6666666666666666
vs. Conference,2012,South Carolina,6,2,8,0.75
vs. Non-Conference,2012,South Carolina,5,0,5,1.0
vs. Ranked (AP),2012,South Carolina,4,2,6,0.6666666666666666
vs. Unranked (AP),2012,South Carolina,7,0,7,1.0
vs. FBS (I-A),2012,South Carolina,10,2,12,0.8333333333333334
vs. FCS (I-AA),2012,South Carolina,1,0,1,1.0
vs. FBS Winning,2012,South Carolina,5,2,7,0.7142857142857143
vs. FBS Non-Winning,2012,South Carolina,5,0,5,1.0
vs. BCS AQ,2012,South Carolina,8,2,10,0.8
vs. BCS non-AQ,2012,South Carolina,2,0,2,1.0
vs. FBS Power 5,2012,South Carolina,8,2,10,0.8
vs. FBS non-Power 5,2012,South Carolina,2,0,2,1.0
in August/September,2012,South Carolina,5,0,5,1.0
in October,2012,South Carolina,2,2,4,0.5
in November,2012,South Carolina,3,0,3,1.0
in December/January,2012,South Carolina,1,0,1,1.0
All Games,2013,South Carolina,11,2,13,0.8461538461538461
at Home,2013,South Carolina,7,0,7,1.0
on Road/Neutral Site,2013,South Carolina,4,2,6,0.6666666666666666
vs. Conference,2013,South Carolina,6,2,8,0.75
vs. Non-Conference,2013,South Carolina,5,0,5,1.0
vs. Ranked (AP),2013,South Carolina,5,0,5,1.0
vs. Unranked (AP),2013,South Carolina,6,2,8,0.75
vs. FBS (I-A),2013,South Carolina,10,2,12,0.8333333333333334
vs. FCS (I-AA),2013,South Carolina,1,0,1,1.0
vs. FBS Winning,2013,South Carolina,7,1,8,0.875
vs. FBS Non-Winning,2013,South Carolina,3,1,4,0.75
vs. BCS AQ,2013,South Carolina,10,2,12,0.8333333333333334
vs. BCS non-AQ,2013,South Carolina,0,0,0,
vs. FBS Power 5,2013,South Carolina,9,2,11,0.8181818181818182
vs. FBS non-Power 5,2013,South Carolina,1,0,1,1.0
in August/September,2013,South Carolina,3,1,4,0.75
in October,2013,South Carolina,3,1,4,0.75
in November,2013,South Carolina,4,0,4,1.0
in December/January,2013,South Carolina,1,0,1,1.0
All Games,2014,South Carolina,7,6,13,0.5384615384615384
at Home,2014,South Carolina,4,3,7,0.5714285714285714
on Road/Neutral Site,2014,South Carolina,3,3,6,0.5
vs. Conference,2014,South Carolina,3,5,8,0.375
vs. Non-Conference,2014,South Carolina,4,1,5,0.8
vs. Ranked (AP),2014,South Carolina,1,3,4,0.25
vs. Unranked (AP),2014,South Carolina,6,3,9,0.6666666666666666
vs. FBS (I-A),2014,South Carolina,6,6,12,0.5
vs. FCS (I-AA),2014,South Carolina,1,0,1,1.0
vs. FBS Winning,2014,South Carolina,3,5,8,0.375
vs. FBS Non-Winning,2014,South Carolina,3,1,4,0.75
vs. BCS AQ,2014,South Carolina,5,6,11,0.45454545454545453
vs. BCS non-AQ,2014,South Carolina,1,0,1,1.0
vs. FBS Power 5,2014,South Carolina,4,6,10,0.4
vs. FBS non-Power 5,2014,South Carolina,2,0,2,1.0
in August/September,2014,South Carolina,3,2,5,0.6
in October,2014,South Carolina,1,2,3,0.3333333333333333
in November,2014,South Carolina,2,2,4,0.5
in December/January,2014,South Carolina,1,0,1,1.0
All Games,2015,South Carolina,3,9,12,0.25
at Home,2015,South Carolina,2,4,6,0.3333333333333333
on Road/Neutral Site,2015,South Carolina,1,5,6,0.16666666666666666
vs. Conference,2015,South Carolina,1,7,8,0.125
vs. Non-Conference,2015,South Carolina,2,2,4,0.5
vs. Ranked (AP),2015,South Carolina,1,4,5,0.2
vs. Unranked (AP),2015,South Carolina,2,5,7,0.2857142857142857
vs. FBS (I-A),2015,South Carolina,3,8,11,0.2727272727272727
vs. FCS (I-AA),2015,South Carolina,0,1,1,0.0
vs. FBS Winning,2015,South Carolina,1,6,7,0.14285714285714285
vs. FBS Non-Winning,2015,South Carolina,2,2,4,0.5
vs. BCS AQ,2015,South Carolina,3,8,11,0.2727272727272727
vs. BCS non-AQ,2015,South Carolina,0,0,0,
vs. FBS Power 5,2015,South Carolina,2,8,10,0.2
vs. FBS non-Power 5,2015,South Carolina,1,0,1,1.0
in August/September,2015,South Carolina,2,2,4,0.5
in October,2015,South Carolina,1,3,4,0.25
in November,2015,South Carolina,0,4,4,0.0
in December/January,2015,South Carolina,0,0,0,
All Games,2016,South Carolina,6,7,13,0.46153846153846156
at Home,2016,South Carolina,5,2,7,0.7142857142857143
on Road/Neutral Site,2016,South Carolina,1,5,6,0.16666666666666666
vs. Conference,2016,South Carolina,3,5,8,0.375
vs. Non-Conference,2016,South Carolina,3,2,5,0.6
vs. Ranked (AP),2016,South Carolina,0,3,3,0.0
vs. Unranked (AP),2016,South Carolina,6,4,10,0.6
vs. FBS (I-A),2016,South Carolina,5,7,12,0.4166666666666667
vs. FCS (I-AA),2016,South Carolina,1,0,1,1.0
vs. FBS Winning,2016,South Carolina,1,6,7,0.14285714285714285
vs. FBS Non-Winning,2016,South Carolina,4,1,5,0.8
vs. BCS AQ,2016,South Carolina,4,7,11,0.36363636363636365
vs. BCS non-AQ,2016,South Carolina,1,0,1,1.0
vs. FBS Power 5,2016,South Carolina,3,6,9,0.3333333333333333
vs. FBS non-Power 5,2016,South Carolina,2,1,3,0.6666666666666666
in August/September,2016,South Carolina,2,2,4,0.5
in October,2016,South Carolina,2,2,4,0.5
in November,2016,South Carolina,2,2,4,0.5
in December/January,2016,South Carolina,0,1,1,0.0
All Games,2017,South Carolina,9,4,13,0.6923076923076923
at Home,2017,South Carolina,5,2,7,0.7142857142857143
on Road/Neutral Site,2017,South Carolina,4,2,6,0.6666666666666666
vs. Conference,2017,South Carolina,5,3,8,0.625
vs. Non-Conference,2017,South Carolina,4,1,5,0.8
vs. Ranked (AP),2017,South Carolina,1,2,3,0.3333333333333333
vs. Unranked (AP),2017,South Carolina,8,2,10,0.8
vs. FBS (I-A),2017,South Carolina,8,4,12,0.6666666666666666
vs. FCS (I-AA),2017,South Carolina,1,0,1,1.0
vs. FBS Winning,2017,South Carolina,4,4,8,0.5
vs. FBS Non-Winning,2017,South Carolina,4,0,4,1.0
vs. BCS AQ,2017,South Carolina,7,4,11,0.6363636363636364
vs. BCS non-AQ,2017,South Carolina,1,0,1,1.0
vs. FBS Power 5,2017,South Carolina,7,4,11,0.6363636363636364
vs. FBS non-Power 5,2017,South Carolina,1,0,1,1.0
in August/September,2017,South Carolina,3,2,5,0.6
in October,2017,South Carolina,3,0,3,1.0
in November,2017,South Carolina,2,2,4,0.5
in December/January,2017,South Carolina,1,0,1,1.0
All Games,2018,South Carolina,7,6,13,0.5384615384615384
at Home,2018,South Carolina,5,2,7,0.7142857142857143
on Road/Neutral Site,2018,South Carolina,2,4,6,0.3333333333333333
vs. Conference,2018,South Carolina,4,4,8,0.5
vs. Non-Conference,2018,South Carolina,3,2,5,0.6
vs. Ranked (AP),2018,South Carolina,0,5,5,0.0
vs. Unranked (AP),2018,South Carolina,7,1,8,0.875
vs. FBS (I-A),2018,South Carolina,6,6,12,0.5
vs. FCS (I-AA),2018,South Carolina,1,0,1,1.0
vs. FBS Winning,2018,South Carolina,1,6,7,0.14285714285714285
vs. FBS Non-Winning,2018,South Carolina,5,0,5,1.0
vs. BCS AQ,2018,South Carolina,4,6,10,0.4
vs. BCS non-AQ,2018,South Carolina,2,0,2,1.0
vs. FBS Power 5,2018,South Carolina,4,6,10,0.4
vs. FBS non-Power 5,2018,South Carolina,2,0,2,1.0
in August/September,2018,South Carolina,2,2,4,0.5
in October,2018,South Carolina,2,1,3,0.6666666666666666
in November,2018,South Carolina,2,2,4,0.5
in December/January,2018,South Carolina,1,1,2,0.5
All Games,2019,South Carolina,4,8,12,0.3333333333333333
at Home,2019,South Carolina,3,4,7,0.42857142857142855
on Road/Neutral Site,2019,South Carolina,1,4,5,0.2
vs. Conference,2019,South Carolina,3,5,8,0.375
vs. Non-Conference,2019,South Carolina,1,3,4,0.25
vs. Ranked (AP),2019,South Carolina,1,4,5,0.2
vs. Unranked (AP),2019,South Carolina,3,4,7,0.42857142857142855
vs. FBS (I-A),2019,South Carolina,3,8,11,0.2727272727272727
vs. FCS (I-AA),2019,South Carolina,1,0,1,1.0
vs. FBS Winning,2019,South Carolina,2,7,9,0.2222222222222222
vs. FBS Non-Winning,2019,South Carolina,1,1,2,0.5
vs. BCS AQ,2019,South Carolina,3,7,10,0.3
vs. BCS non-AQ,2019,South Carolina,0,1,1,0.0
vs. FBS Power 5,2019,South Carolina,3,7,10,0.3
vs. FBS non-Power 5,2019,South Carolina,0,1,1,0.0
in August/September,2019,South Carolina,2,3,5,0.4
in October,2019,South Carolina,1,2,3,0.3333333333333333
in November,2019,South Carolina,1,3,4,0.25
in December/January,2019,South Carolina,0,0,0,
All Games,2020,South Carolina,2,8,10,0.2
at Home,2020,South Carolina,1,4,5,0.2
on Road/Neutral Site,2020,South Carolina,1,4,5,0.2
vs. Conference,2020,South Carolina,2,8,10,0.2
vs. Non-Conference,2020,South Carolina,0,0,0,
vs. Ranked (AP),2020,South Carolina,0,3,3,0.0
vs. Unranked (AP),2020,South Carolina,2,5,7,0.2857142857142857
vs. FBS (I-A),2020,South Carolina,2,8,10,0.2
vs. FCS (I-AA),2020,South Carolina,0,0,0,
vs. FBS Winning,2020,South Carolina,1,3,4,0.25
vs. FBS Non-Winning,2020,South Carolina,1,5,6,0.16666666666666666
vs. BCS AQ,2020,South Carolina,2,8,10,0.2
vs. BCS non-AQ,2020,South Carolina,0,0,0,
vs. FBS Power 5,2020,South Carolina,2,8,10,0.2
vs. FBS non-Power 5,2020,South Carolina,0,0,0,
in August/September,2020,South Carolina,0,1,1,0.0
in October,2020,South Carolina,2,2,4,0.5
in November,2020,South Carolina,0,4,4,0.0
in December/January,2020,South Carolina,0,1,1,0.0
All Games,2021,South Carolina,7,6,13,0.5384615384615384
at Home,2021,South Carolina,5,2,7,0.7142857142857143
on Road/Neutral Site,2021,South Carolina,2,4,6,0.3333333333333333
vs. Conference,2021,South Carolina,3,5,8,0.375
vs. Non-Conference,2021,South Carolina,4,1,5,0.8
vs. Ranked (AP),2021,South Carolina,0,3,3,0.0
vs. Unranked (AP),2021,South Carolina,7,3,10,0.7
vs. FBS (I-A),2021,South Carolina,6,6,12,0.5
vs. FCS (I-AA),2021,South Carolina,1,0,1,1.0
vs. FBS Winning,2021,South Carolina,1,5,6,0.16666666666666666
vs. FBS Non-Winning,2021,South Carolina,5,1,6,0.8333333333333334
vs. BCS AQ,2021,South Carolina,5,6,11,0.45454545454545453
vs. BCS non-AQ,2021,South Carolina,1,0,1,1.0
vs. FBS Power 5,2021,South Carolina,4,6,10,0.4
vs. FBS non-Power 5,2021,South Carolina,2,0,2,1.0
in August/September,2021,South Carolina,2,2,4,0.5
in October,2021,South Carolina,2,2,4,0.5
in November,2021,South Carolina,2,2,4,0.5
in December/January,2021,South Carolina,1,0,1,1.0
All Games,2022,South Carolina,8,5,13,0.6153846153846154
at Home,2022,South Carolina,5,2,7,0.7142857142857143
on Road/Neutral Site,2022,South Carolina,3,3,6,0.5
vs. Conference,2022,South Carolina,4,4,8,0.5
vs. Non-Conference,2022,South Carolina,4,1,5,0.8
vs. Ranked (AP),2022,South Carolina,2,2,4,0.5
vs. Unranked (AP),2022,South Carolina,6,3,9,0.6666666666666666
vs. FBS (I-A),2022,South Carolina,7,5,12,0.5833333333333334
vs. FCS (I-AA),2022,South Carolina,1,0,1,1.0
vs. FBS Winning,2022,South Carolina,3,3,6,0.5
vs. FBS Non-Winning,2022,South Carolina,4,2,6,0.6666666666666666
vs. BCS AQ,2022,South Carolina,5,5,10,0.5
vs. BCS non-AQ,2022,South Carolina,2,0,2,1.0
vs. FBS Power 5,2022,South Carolina,5,4,9,0.5555555555555556
vs. FBS non-Power 5,2022,South Carolina,2,1,3,0.6666666666666666
in August/September,2022,South Carolina,3,2,5,0.6
in October,2022,South Carolina,2,1,3,0.6666666666666666
in November,2022,South Carolina,3,1,4,0.75
in December/January,2022,South Carolina,0,1,1,0.0
All Games,2009,South Florida,8,5,13,0.6153846153846154
at Home,2009,South Florida,4,2,6,0.6666666666666666
on Road/Neutral Site,2009,South Florida,4,3,7,0.5714285714285714
vs. Conference,2009,South Florida,3,4,7,0.42857142857142855
vs. Non-Conference,2009,South Florida,5,1,6,0.8333333333333334
vs. Ranked (AP),2009,South Florida,1,3,4,0.25
vs. Unranked (AP),2009,South Florida,7,2,9,0.7777777777777778
vs. FBS (I-A),2009,South Florida,6,5,11,0.5454545454545454
vs. FCS (I-AA),2009,South Florida,2,0,2,1.0
vs. FBS Winning,2009,South Florida,3,5,8,0.375
vs. FBS Non-Winning,2009,South Florida,3,0,3,1.0
vs. BCS AQ,2009,South Florida,4,5,9,0.4444444444444444
vs. BCS non-AQ,2009,South Florida,2,0,2,1.0
vs. FBS Power 5,2009,South Florida,1,1,2,0.5
vs. FBS non-Power 5,2009,South Florida,5,4,9,0.5555555555555556
in August/September,2009,South Florida,4,0,4,1.0
in October,2009,South Florida,2,2,4,0.5
in November,2009,South Florida,1,2,3,0.3333333333333333
in December/January,2009,South Florida,1,1,2,0.5
All Games,2010,South Florida,8,5,13,0.6153846153846154
at Home,2010,South Florida,4,3,7,0.5714285714285714
on Road/Neutral Site,2010,South Florida,4,2,6,0.6666666666666666
vs. Conference,2010,South Florida,3,4,7,0.42857142857142855
vs. Non-Conference,2010,South Florida,5,1,6,0.8333333333333334
vs. Ranked (AP),2010,South Florida,0,0,0,
vs. Unranked (AP),2010,South Florida,8,5,13,0.6153846153846154
vs. FBS (I-A),2010,South Florida,7,5,12,0.5833333333333334
vs. FCS (I-AA),2010,South Florida,1,0,1,1.0
vs. FBS Winning,2010,South Florida,2,5,7,0.2857142857142857
vs. FBS Non-Winning,2010,South Florida,5,0,5,1.0
vs. BCS AQ,2010,South Florida,5,5,10,0.5
vs. BCS non-AQ,2010,South Florida,2,0,2,1.0
vs. FBS Power 5,2010,South Florida,2,1,3,0.6666666666666666
vs. FBS non-Power 5,2010,South Florida,5,4,9,0.5555555555555556
in August/September,2010,South Florida,2,1,3,0.6666666666666666
in October,2010,South Florida,2,2,4,0.5
in November,2010,South Florida,3,1,4,0.75
in December/January,2010,South Florida,1,1,2,0.5
All Games,2011,South Florida,5,7,12,0.4166666666666667
at Home,2011,South Florida,3,4,7,0.42857142857142855
on Road/Neutral Site,2011,South Florida,2,3,5,0.4
vs. Conference,2011,South Florida,1,6,7,0.14285714285714285
vs. Non-Conference,2011,South Florida,4,1,5,0.8
vs. Ranked (AP),2011,South Florida,0,2,2,0.0
vs. Unranked (AP),2011,South Florida,5,5,10,0.5
vs. FBS (I-A),2011,South Florida,4,7,11,0.36363636363636365
vs. FCS (I-AA),2011,South Florida,1,0,1,1.0
vs. FBS Winning,2011,South Florida,1,4,5,0.2
vs. FBS Non-Winning,2011,South Florida,3,3,6,0.5
vs. BCS AQ,2011,South Florida,2,7,9,0.2222222222222222
vs. BCS non-AQ,2011,South Florida,2,0,2,1.0
vs. FBS Power 5,2011,South Florida,0,1,1,0.0
vs. FBS non-Power 5,2011,South Florida,4,6,10,0.4
in August/September,2011,South Florida,4,1,5,0.8
in October,2011,South Florida,0,2,2,0.0
in November,2011,South Florida,1,3,4,0.25
in December/January,2011,South Florida,0,1,1,0.0
All Games,2012,South Florida,3,9,12,0.25
at Home,2012,South Florida,2,4,6,0.3333333333333333
on Road/Neutral Site,2012,South Florida,1,5,6,0.16666666666666666
vs. Conference,2012,South Florida,1,6,7,0.14285714285714285
vs. Non-Conference,2012,South Florida,2,3,5,0.4
vs. Ranked (AP),2012,South Florida,0,2,2,0.0
vs. Unranked (AP),2012,South Florida,3,7,10,0.3
vs. FBS (I-A),2012,South Florida,2,9,11,0.18181818181818182
vs. FCS (I-AA),2012,South Florida,1,0,1,1.0
vs. FBS Winning,2012,South Florida,1,7,8,0.125
vs. FBS Non-Winning,2012,South Florida,1,2,3,0.3333333333333333
vs. BCS AQ,2012,South Florida,1,8,9,0.1111111111111111
vs. BCS non-AQ,2012,South Florida,1,1,2,0.5
vs. FBS Power 5,2012,South Florida,0,2,2,0.0
vs. FBS non-Power 5,2012,South Florida,2,7,9,0.2222222222222222
in August/September,2012,South Florida,2,3,5,0.4
in October,2012,South Florida,0,3,3,0.0
in November,2012,South Florida,1,2,3,0.3333333333333333
in December/January,2012,South Florida,0,1,1,0.0
All Games,2013,South Florida,2,10,12,0.16666666666666666
at Home,2013,South Florida,1,6,7,0.14285714285714285
on Road/Neutral Site,2013,South Florida,1,4,5,0.2
vs. Conference,2013,South Florida,2,6,8,0.25
vs. Non-Conference,2013,South Florida,0,4,4,0.0
vs. Ranked (AP),2013,South Florida,0,3,3,0.0
vs. Unranked (AP),2013,South Florida,2,7,9,0.2222222222222222
vs. FBS (I-A),2013,South Florida,2,9,11,0.18181818181818182
vs. FCS (I-AA),2013,South Florida,0,1,1,0.0
vs. FBS Winning,2013,South Florida,1,5,6,0.16666666666666666
vs. FBS Non-Winning,2013,South Florida,1,4,5,0.2
vs. BCS AQ,2013,South Florida,2,8,10,0.2
vs. BCS non-AQ,2013,South Florida,0,1,1,0.0
vs. FBS Power 5,2013,South Florida,0,2,2,0.0
vs. FBS non-Power 5,2013,South Florida,2,7,9,0.2222222222222222
in August/September,2013,South Florida,0,4,4,0.0
in October,2013,South Florida,2,2,4,0.5
in November,2013,South Florida,0,3,3,0.0
in December/January,2013,South Florida,0,1,1,0.0
All Games,2014,South Florida,4,8,12,0.3333333333333333
at Home,2014,South Florida,2,5,7,0.2857142857142857
on Road/Neutral Site,2014,South Florida,2,3,5,0.4
vs. Conference,2014,South Florida,3,5,8,0.375
vs. Non-Conference,2014,South Florida,1,3,4,0.25
vs. Ranked (AP),2014,South Florida,0,2,2,0.0
vs. Unranked (AP),2014,South Florida,4,6,10,0.4
vs. FBS (I-A),2014,South Florida,3,8,11,0.2727272727272727
vs. FCS (I-AA),2014,South Florida,1,0,1,1.0
vs. FBS Winning,2014,South Florida,0,8,8,0.0
vs. FBS Non-Winning,2014,South Florida,3,0,3,1.0
vs. BCS AQ,2014,South Florida,3,8,11,0.2727272727272727
vs. BCS non-AQ,2014,South Florida,0,0,0,
vs. FBS Power 5,2014,South Florida,0,3,3,0.0
vs. FBS non-Power 5,2014,South Florida,3,5,8,0.375
in August/September,2014,South Florida,2,3,5,0.4
in October,2014,South Florida,1,2,3,0.3333333333333333
in November,2014,South Florida,1,3,4,0.25
in December/January,2014,South Florida,0,0,0,
All Games,2015,South Florida,8,5,13,0.6153846153846154
at Home,2015,South Florida,5,1,6,0.8333333333333334
on Road/Neutral Site,2015,South Florida,3,4,7,0.42857142857142855
vs. Conference,2015,South Florida,6,2,8,0.75
vs. Non-Conference,2015,South Florida,2,3,5,0.4
vs. Ranked (AP),2015,South Florida,0,3,3,0.0
vs. Unranked (AP),2015,South Florida,8,2,10,0.8
vs. FBS (I-A),2015,South Florida,7,5,12,0.5833333333333334
vs. FCS (I-AA),2015,South Florida,1,0,1,1.0
vs. FBS Winning,2015,South Florida,2,4,6,0.3333333333333333
vs. FBS Non-Winning,2015,South Florida,5,1,6,0.8333333333333334
vs. BCS AQ,2015,South Florida,7,4,11,0.6363636363636364
vs. BCS non-AQ,2015,South Florida,0,1,1,0.0
vs. FBS Power 5,2015,South Florida,1,2,3,0.3333333333333333
vs. FBS non-Power 5,2015,South Florida,6,3,9,0.6666666666666666
in August/September,2015,South Florida,1,2,3,0.3333333333333333
in October,2015,South Florida,3,2,5,0.6
in November,2015,South Florida,4,0,4,1.0
in December/January,2015,South Florida,0,1,1,0.0
All Games,2016,South Florida,11,2,13,0.8461538461538461
at Home,2016,South Florida,6,1,7,0.8571428571428571
on Road/Neutral Site,2016,South Florida,5,1,6,0.8333333333333334
vs. Conference,2016,South Florida,7,1,8,0.875
vs. Non-Conference,2016,South Florida,4,1,5,0.8
vs. Ranked (AP),2016,South Florida,0,2,2,0.0
vs. Unranked (AP),2016,South Florida,11,0,11,1.0
vs. FBS (I-A),2016,South Florida,10,2,12,0.8333333333333334
vs. FCS (I-AA),2016,South Florida,1,0,1,1.0
vs. FBS Winning,2016,South Florida,2,2,4,0.5
vs. FBS Non-Winning,2016,South Florida,8,0,8,1.0
vs. BCS AQ,2016,South Florida,9,2,11,0.8181818181818182
vs. BCS non-AQ,2016,South Florida,1,0,1,1.0
vs. FBS Power 5,2016,South Florida,2,1,3,0.6666666666666666
vs. FBS non-Power 5,2016,South Florida,8,1,9,0.8888888888888888
in August/September,2016,South Florida,3,1,4,0.75
in October,2016,South Florida,4,1,5,0.8
in November,2016,South Florida,3,0,3,1.0
in December/January,2016,South Florida,1,0,1,1.0
All Games,2017,South Florida,10,2,12,0.8333333333333334
at Home,2017,South Florida,5,1,6,0.8333333333333334
on Road/Neutral Site,2017,South Florida,5,1,6,0.8333333333333334
vs. Conference,2017,South Florida,6,2,8,0.75
vs. Non-Conference,2017,South Florida,4,0,4,1.0
vs. Ranked (AP),2017,South Florida,0,1,1,0.0
vs. Unranked (AP),2017,South Florida,10,1,11,0.9090909090909091
vs. FBS (I-A),2017,South Florida,9,2,11,0.8181818181818182
vs. FCS (I-AA),2017,South Florida,1,0,1,1.0
vs. FBS Winning,2017,South Florida,1,2,3,0.3333333333333333
vs. FBS Non-Winning,2017,South Florida,8,0,8,1.0
vs. BCS AQ,2017,South Florida,8,2,10,0.8
vs. BCS non-AQ,2017,South Florida,1,0,1,1.0
vs. FBS Power 5,2017,South Florida,2,0,2,1.0
vs. FBS non-Power 5,2017,South Florida,7,2,9,0.7777777777777778
in August/September,2017,South Florida,5,0,5,1.0
in October,2017,South Florida,2,1,3,0.6666666666666666
in November,2017,South Florida,2,1,3,0.6666666666666666
in December/January,2017,South Florida,1,0,1,1.0
All Games,2018,South Florida,7,6,13,0.5384615384615384
at Home,2018,South Florida,4,3,7,0.5714285714285714
on Road/Neutral Site,2018,South Florida,3,3,6,0.5
vs. Conference,2018,South Florida,3,5,8,0.375
vs. Non-Conference,2018,South Florida,4,1,5,0.8
vs. Ranked (AP),2018,South Florida,0,2,2,0.0
vs. Unranked (AP),2018,South Florida,7,4,11,0.6363636363636364
vs. FBS (I-A),2018,South Florida,6,6,12,0.5
vs. FCS (I-AA),2018,South Florida,1,0,1,1.0
vs. FBS Winning,2018,South Florida,1,6,7,0.14285714285714285
vs. FBS Non-Winning,2018,South Florida,5,0,5,1.0
vs. BCS AQ,2018,South Florida,5,5,10,0.5
vs. BCS non-AQ,2018,South Florida,1,1,2,0.5
vs. FBS Power 5,2018,South Florida,2,0,2,1.0
vs. FBS non-Power 5,2018,South Florida,4,6,10,0.4
in August/September,2018,South Florida,4,0,4,1.0
in October,2018,South Florida,3,1,4,0.75
in November,2018,South Florida,0,4,4,0.0
in December/January,2018,South Florida,0,1,1,0.0
All Games,2019,South Florida,4,8,12,0.3333333333333333
at Home,2019,South Florida,2,5,7,0.2857142857142857
on Road/Neutral Site,2019,South Florida,2,3,5,0.4
vs. Conference,2019,South Florida,2,6,8,0.25
vs. Non-Conference,2019,South Florida,2,2,4,0.5
vs. Ranked (AP),2019,South Florida,0,5,5,0.0
vs. Unranked (AP),2019,South Florida,4,3,7,0.5714285714285714
vs. FBS (I-A),2019,South Florida,3,8,11,0.2727272727272727
vs. FCS (I-AA),2019,South Florida,1,0,1,1.0
vs. FBS Winning,2019,South Florida,1,7,8,0.125
vs. FBS Non-Winning,2019,South Florida,2,1,3,0.6666666666666666
vs. BCS AQ,2019,South Florida,2,8,10,0.2
vs. BCS non-AQ,2019,South Florida,1,0,1,1.0
vs. FBS Power 5,2019,South Florida,0,2,2,0.0
vs. FBS non-Power 5,2019,South Florida,3,6,9,0.3333333333333333
in August/September,2019,South Florida,1,3,4,0.25
in October,2019,South Florida,3,1,4,0.75
in November,2019,South Florida,0,4,4,0.0
in December/January,2019,South Florida,0,0,0,
All Games,2020,South Florida,1,8,9,0.1111111111111111
at Home,2020,South Florida,1,3,4,0.25
on Road/Neutral Site,2020,South Florida,0,5,5,0.0
vs. Conference,2020,South Florida,0,7,7,0.0
vs. Non-Conference,2020,South Florida,1,1,2,0.5
vs. Ranked (AP),2020,South Florida,0,3,3,0.0
vs. Unranked (AP),2020,South Florida,1,5,6,0.16666666666666666
vs. FBS (I-A),2020,South Florida,0,8,8,0.0
vs. FCS (I-AA),2020,South Florida,1,0,1,1.0
vs. FBS Winning,2020,South Florida,0,5,5,0.0
vs. FBS Non-Winning,2020,South Florida,0,3,3,0.0
vs. BCS AQ,2020,South Florida,0,8,8,0.0
vs. BCS non-AQ,2020,South Florida,0,0,0,
vs. FBS Power 5,2020,South Florida,0,1,1,0.0
vs. FBS non-Power 5,2020,South Florida,0,7,7,0.0
in August/September,2020,South Florida,1,1,2,0.5
in October,2020,South Florida,0,4,4,0.0
in November,2020,South Florida,0,3,3,0.0
in December/January,2020,South Florida,0,0,0,
All Games,2021,South Florida,2,10,12,0.16666666666666666
at Home,2021,South Florida,2,4,6,0.3333333333333333
on Road/Neutral Site,2021,South Florida,0,6,6,0.0
vs. Conference,2021,South Florida,1,7,8,0.125
vs. Non-Conference,2021,South Florida,1,3,4,0.25
vs. Ranked (AP),2021,South Florida,0,4,4,0.0
vs. Unranked (AP),2021,South Florida,2,6,8,0.25
vs. FBS (I-A),2021,South Florida,1,10,11,0.09090909090909091
vs. FCS (I-AA),2021,South Florida,1,0,1,1.0
vs. FBS Winning,2021,South Florida,0,8,8,0.0
vs. FBS Non-Winning,2021,South Florida,1,2,3,0.3333333333333333
vs. BCS AQ,2021,South Florida,1,9,10,0.1
vs. BCS non-AQ,2021,South Florida,0,1,1,0.0
vs. FBS Power 5,2021,South Florida,0,2,2,0.0
vs. FBS non-Power 5,2021,South Florida,1,8,9,0.1111111111111111
in August/September,2021,South Florida,1,3,4,0.25
in October,2021,South Florida,1,3,4,0.25
in November,2021,South Florida,0,4,4,0.0
in December/January,2021,South Florida,0,0,0,
All Games,2022,South Florida,1,11,12,0.08333333333333333
at Home,2022,South Florida,1,5,6,0.16666666666666666
on Road/Neutral Site,2022,South Florida,0,6,6,0.0
vs. Conference,2022,South Florida,0,8,8,0.0
vs. Non-Conference,2022,South Florida,1,3,4,0.25
vs. Ranked (AP),2022,South Florida,0,1,1,0.0
vs. Unranked (AP),2022,South Florida,1,10,11,0.09090909090909091
vs. FBS (I-A),2022,South Florida,0,11,11,0.0
vs. FCS (I-AA),2022,South Florida,1,0,1,1.0
vs. FBS Winning,2022,South Florida,0,8,8,0.0
vs. FBS Non-Winning,2022,South Florida,0,3,3,0.0
vs. BCS AQ,2022,South Florida,0,10,10,0.0
vs. BCS non-AQ,2022,South Florida,0,1,1,0.0
vs. FBS Power 5,2022,South Florida,0,2,2,0.0
vs. FBS non-Power 5,2022,South Florida,0,9,9,0.0
in August/September,2022,South Florida,1,3,4,0.25
in October,2022,South Florida,0,4,4,0.0
in November,2022,South Florida,0,4,4,0.0
in December/January,2022,South Florida,0,0,0,
All Games,2009,Southern Mississippi,7,6,13,0.5384615384615384
at Home,2009,Southern Mississippi,6,0,6,1.0
on Road/Neutral Site,2009,Southern Mississippi,1,6,7,0.14285714285714285
vs. Conference,2009,Southern Mississippi,5,3,8,0.625
vs. Non-Conference,2009,Southern Mississippi,2,3,5,0.4
vs. Ranked (AP),2009,Southern Mississippi,0,0,0,
vs. Unranked (AP),2009,Southern Mississippi,7,6,13,0.5384615384615384
vs. FBS (I-A),2009,Southern Mississippi,6,6,12,0.5
vs. FCS (I-AA),2009,Southern Mississippi,1,0,1,1.0
vs. FBS Winning,2009,Southern Mississippi,2,3,5,0.4
vs. FBS Non-Winning,2009,Southern Mississippi,4,3,7,0.5714285714285714
vs. BCS AQ,2009,Southern Mississippi,1,2,3,0.3333333333333333
vs. BCS non-AQ,2009,Southern Mississippi,5,4,9,0.5555555555555556
vs. FBS Power 5,2009,Southern Mississippi,1,1,2,0.5
vs. FBS non-Power 5,2009,Southern Mississippi,5,5,10,0.5
in August/September,2009,Southern Mississippi,3,1,4,0.75
in October,2009,Southern Mississippi,2,3,5,0.4
in November,2009,Southern Mississippi,2,1,3,0.6666666666666666
in December/January,2009,Southern Mississippi,0,1,1,0.0
All Games,2010,Southern Mississippi,8,5,13,0.6153846153846154
at Home,2010,Southern Mississippi,4,2,6,0.6666666666666666
on Road/Neutral Site,2010,Southern Mississippi,4,3,7,0.5714285714285714
vs. Conference,2010,Southern Mississippi,5,3,8,0.625
vs. Non-Conference,2010,Southern Mississippi,3,2,5,0.6
vs. Ranked (AP),2010,Southern Mississippi,1,2,3,0.3333333333333333
vs. Unranked (AP),2010,Southern Mississippi,7,3,10,0.7
vs. FBS (I-A),2010,Southern Mississippi,7,5,12,0.5833333333333334
vs. FCS (I-AA),2010,Southern Mississippi,1,0,1,1.0
vs. FBS Winning,2010,Southern Mississippi,1,3,4,0.25
vs. FBS Non-Winning,2010,Southern Mississippi,6,2,8,0.75
vs. BCS AQ,2010,Southern Mississippi,1,2,3,0.3333333333333333
vs. BCS non-AQ,2010,Southern Mississippi,6,3,9,0.6666666666666666
vs. FBS Power 5,2010,Southern Mississippi,1,1,2,0.5
vs. FBS non-Power 5,2010,Southern Mississippi,6,4,10,0.6
in August/September,2010,Southern Mississippi,3,1,4,0.75
in October,2010,Southern Mississippi,2,2,4,0.5
in November,2010,Southern Mississippi,3,1,4,0.75
in December/January,2010,Southern Mississippi,0,1,1,0.0
All Games,2011,Southern Mississippi,12,2,14,0.8571428571428571
at Home,2011,Southern Mississippi,6,0,6,1.0
on Road/Neutral Site,2011,Southern Mississippi,6,2,8,0.75
vs. Conference,2011,Southern Mississippi,7,2,9,0.7777777777777778
vs. Non-Conference,2011,Southern Mississippi,5,0,5,1.0
vs. Ranked (AP),2011,Southern Mississippi,1,0,1,1.0
vs. Unranked (AP),2011,Southern Mississippi,11,2,13,0.8461538461538461
vs. FBS (I-A),2011,Southern Mississippi,11,2,13,0.8461538461538461
vs. FCS (I-AA),2011,Southern Mississippi,1,0,1,1.0
vs. FBS Winning,2011,Southern Mississippi,5,1,6,0.8333333333333334
vs. FBS Non-Winning,2011,Southern Mississippi,6,1,7,0.8571428571428571
vs. BCS AQ,2011,Southern Mississippi,1,0,1,1.0
vs. BCS non-AQ,2011,Southern Mississippi,10,2,12,0.8333333333333334
vs. FBS Power 5,2011,Southern Mississippi,1,0,1,1.0
vs. FBS non-Power 5,2011,Southern Mississippi,10,2,12,0.8333333333333334
in August/September,2011,Southern Mississippi,3,1,4,0.75
in October,2011,Southern Mississippi,4,0,4,1.0
in November,2011,Southern Mississippi,3,1,4,0.75
in December/January,2011,Southern Mississippi,2,0,2,1.0
All Games,2012,Southern Mississippi,0,12,12,0.0
at Home,2012,Southern Mississippi,0,6,6,0.0
on Road/Neutral Site,2012,Southern Mississippi,0,6,6,0.0
vs. Conference,2012,Southern Mississippi,0,8,8,0.0
vs. Non-Conference,2012,Southern Mississippi,0,4,4,0.0
vs. Ranked (AP),2012,Southern Mississippi,0,3,3,0.0
vs. Unranked (AP),2012,Southern Mississippi,0,9,9,0.0
vs. FBS (I-A),2012,Southern Mississippi,0,12,12,0.0
vs. FCS (I-AA),2012,Southern Mississippi,0,0,0,
vs. FBS Winning,2012,Southern Mississippi,0,8,8,0.0
vs. FBS Non-Winning,2012,Southern Mississippi,0,4,4,0.0
vs. BCS AQ,2012,Southern Mississippi,0,2,2,0.0
vs. BCS non-AQ,2012,Southern Mississippi,0,10,10,0.0
vs. FBS Power 5,2012,Southern Mississippi,0,1,1,0.0
vs. FBS non-Power 5,2012,Southern Mississippi,0,11,11,0.0
in August/September,2012,Southern Mississippi,0,4,4,0.0
in October,2012,Southern Mississippi,0,4,4,0.0
in November,2012,Southern Mississippi,0,4,4,0.0
in December/January,2012,Southern Mississippi,0,0,0,
All Games,2013,Southern Mississippi,1,11,12,0.08333333333333333
at Home,2013,Southern Mississippi,0,5,5,0.0
on Road/Neutral Site,2013,Southern Mississippi,1,6,7,0.14285714285714285
vs. Conference,2013,Southern Mississippi,1,7,8,0.125
vs. Non-Conference,2013,Southern Mississippi,0,4,4,0.0
vs. Ranked (AP),2013,Southern Mississippi,0,0,0,
vs. Unranked (AP),2013,Southern Mississippi,1,11,12,0.08333333333333333
vs. FBS (I-A),2013,Southern Mississippi,1,11,12,0.08333333333333333
vs. FCS (I-AA),2013,Southern Mississippi,0,0,0,
vs. FBS Winning,2013,Southern Mississippi,0,6,6,0.0
vs. FBS Non-Winning,2013,Southern Mississippi,1,5,6,0.16666666666666666
vs. BCS AQ,2013,Southern Mississippi,0,2,2,0.0
vs. BCS non-AQ,2013,Southern Mississippi,1,9,10,0.1
vs. FBS Power 5,2013,Southern Mississippi,0,2,2,0.0
vs. FBS non-Power 5,2013,Southern Mississippi,1,9,10,0.1
in August/September,2013,Southern Mississippi,0,4,4,0.0
in October,2013,Southern Mississippi,0,3,3,0.0
in November,2013,Southern Mississippi,1,4,5,0.2
in December/January,2013,Southern Mississippi,0,0,0,
All Games,2014,Southern Mississippi,3,9,12,0.25
at Home,2014,Southern Mississippi,2,4,6,0.3333333333333333
on Road/Neutral Site,2014,Southern Mississippi,1,5,6,0.16666666666666666
vs. Conference,2014,Southern Mississippi,1,7,8,0.125
vs. Non-Conference,2014,Southern Mississippi,2,2,4,0.5
vs. Ranked (AP),2014,Southern Mississippi,0,3,3,0.0
vs. Unranked (AP),2014,Southern Mississippi,3,6,9,0.3333333333333333
vs. FBS (I-A),2014,Southern Mississippi,2,9,11,0.18181818181818182
vs. FCS (I-AA),2014,Southern Mississippi,1,0,1,1.0
vs. FBS Winning,2014,Southern Mississippi,1,6,7,0.14285714285714285
vs. FBS Non-Winning,2014,Southern Mississippi,1,3,4,0.25
vs. BCS AQ,2014,Southern Mississippi,0,2,2,0.0
vs. BCS non-AQ,2014,Southern Mississippi,2,7,9,0.2222222222222222
vs. FBS Power 5,2014,Southern Mississippi,0,2,2,0.0
vs. FBS non-Power 5,2014,Southern Mississippi,2,7,9,0.2222222222222222
in August/September,2014,Southern Mississippi,2,3,5,0.4
in October,2014,Southern Mississippi,1,2,3,0.3333333333333333
in November,2014,Southern Mississippi,0,4,4,0.0
in December/January,2014,Southern Mississippi,0,0,0,
All Games,2015,Southern Mississippi,9,5,14,0.6428571428571429
at Home,2015,Southern Mississippi,5,1,6,0.8333333333333334
on Road/Neutral Site,2015,Southern Mississippi,4,4,8,0.5
vs. Conference,2015,Southern Mississippi,7,2,9,0.7777777777777778
vs. Non-Conference,2015,Southern Mississippi,2,3,5,0.4
vs. Ranked (AP),2015,Southern Mississippi,0,1,1,0.0
vs. Unranked (AP),2015,Southern Mississippi,9,4,13,0.6923076923076923
vs. FBS (I-A),2015,Southern Mississippi,8,5,13,0.6153846153846154
vs. FCS (I-AA),2015,Southern Mississippi,1,0,1,1.0
vs. FBS Winning,2015,Southern Mississippi,1,4,5,0.2
vs. FBS Non-Winning,2015,Southern Mississippi,7,1,8,0.875
vs. BCS AQ,2015,Southern Mississippi,0,3,3,0.0
vs. BCS non-AQ,2015,Southern Mississippi,8,2,10,0.8
vs. FBS Power 5,2015,Southern Mississippi,0,3,3,0.0
vs. FBS non-Power 5,2015,Southern Mississippi,8,2,10,0.8
in August/September,2015,Southern Mississippi,2,2,4,0.5
in October,2015,Southern Mississippi,4,1,5,0.8
in November,2015,Southern Mississippi,3,0,3,1.0
in December/January,2015,Southern Mississippi,0,2,2,0.0
All Games,2016,Southern Mississippi,7,6,13,0.5384615384615384
at Home,2016,Southern Mississippi,4,2,6,0.6666666666666666
on Road/Neutral Site,2016,Southern Mississippi,3,4,7,0.42857142857142855
vs. Conference,2016,Southern Mississippi,4,4,8,0.5
vs. Non-Conference,2016,Southern Mississippi,3,2,5,0.6
vs. Ranked (AP),2016,Southern Mississippi,0,1,1,0.0
vs. Unranked (AP),2016,Southern Mississippi,7,5,12,0.5833333333333334
vs. FBS (I-A),2016,Southern Mississippi,6,6,12,0.5
vs. FCS (I-AA),2016,Southern Mississippi,1,0,1,1.0
vs. FBS Winning,2016,Southern Mississippi,2,3,5,0.4
vs. FBS Non-Winning,2016,Southern Mississippi,4,3,7,0.5714285714285714
vs. BCS AQ,2016,Southern Mississippi,1,1,2,0.5
vs. BCS non-AQ,2016,Southern Mississippi,5,5,10,0.5
vs. FBS Power 5,2016,Southern Mississippi,1,1,2,0.5
vs. FBS non-Power 5,2016,Southern Mississippi,5,5,10,0.5
in August/September,2016,Southern Mississippi,3,1,4,0.75
in October,2016,Southern Mississippi,2,2,4,0.5
in November,2016,Southern Mississippi,1,3,4,0.25
in December/January,2016,Southern Mississippi,1,0,1,1.0
All Games,2017,Southern Mississippi,8,5,13,0.6153846153846154
at Home,2017,Southern Mississippi,3,3,6,0.5
on Road/Neutral Site,2017,Southern Mississippi,5,2,7,0.7142857142857143
vs. Conference,2017,Southern Mississippi,6,2,8,0.75
vs. Non-Conference,2017,Southern Mississippi,2,3,5,0.4
vs. Ranked (AP),2017,Southern Mississippi,0,0,0,
vs. Unranked (AP),2017,Southern Mississippi,8,5,13,0.6153846153846154
vs. FBS (I-A),2017,Southern Mississippi,7,5,12,0.5833333333333334
vs. FCS (I-AA),2017,Southern Mississippi,1,0,1,1.0
vs. FBS Winning,2017,Southern Mississippi,3,4,7,0.42857142857142855
vs. FBS Non-Winning,2017,Southern Mississippi,4,1,5,0.8
vs. BCS AQ,2017,Southern Mississippi,0,3,3,0.0
vs. BCS non-AQ,2017,Southern Mississippi,7,2,9,0.7777777777777778
vs. FBS Power 5,2017,Southern Mississippi,0,3,3,0.0
vs. FBS non-Power 5,2017,Southern Mississippi,7,2,9,0.7777777777777778
in August/September,2017,Southern Mississippi,2,2,4,0.5
in October,2017,Southern Mississippi,3,1,4,0.75
in November,2017,Southern Mississippi,3,1,4,0.75
in December/January,2017,Southern Mississippi,0,1,1,0.0
All Games,2018,Southern Mississippi,6,5,11,0.5454545454545454
at Home,2018,Southern Mississippi,5,1,6,0.8333333333333334
on Road/Neutral Site,2018,Southern Mississippi,1,4,5,0.2
vs. Conference,2018,Southern Mississippi,5,3,8,0.625
vs. Non-Conference,2018,Southern Mississippi,1,2,3,0.3333333333333333
vs. Ranked (AP),2018,Southern Mississippi,0,0,0,
vs. Unranked (AP),2018,Southern Mississippi,6,5,11,0.5454545454545454
vs. FBS (I-A),2018,Southern Mississippi,5,5,10,0.5
vs. FCS (I-AA),2018,Southern Mississippi,1,0,1,1.0
vs. FBS Winning,2018,Southern Mississippi,2,3,5,0.4
vs. FBS Non-Winning,2018,Southern Mississippi,3,2,5,0.6
vs. BCS AQ,2018,Southern Mississippi,0,1,1,0.0
vs. BCS non-AQ,2018,Southern Mississippi,5,4,9,0.5555555555555556
vs. FBS Power 5,2018,Southern Mississippi,0,1,1,0.0
vs. FBS non-Power 5,2018,Southern Mississippi,5,4,9,0.5555555555555556
in August/September,2018,Southern Mississippi,2,2,4,0.5
in October,2018,Southern Mississippi,1,2,3,0.3333333333333333
in November,2018,Southern Mississippi,3,1,4,0.75
in December/January,2018,Southern Mississippi,0,0,0,
All Games,2019,Southern Mississippi,7,6,13,0.5384615384615384
at Home,2019,Southern Mississippi,4,1,5,0.8
on Road/Neutral Site,2019,Southern Mississippi,3,5,8,0.375
vs. Conference,2019,Southern Mississippi,5,3,8,0.625
vs. Non-Conference,2019,Southern Mississippi,2,3,5,0.4
vs. Ranked (AP),2019,Southern Mississippi,0,1,1,0.0
vs. Unranked (AP),2019,Southern Mississippi,7,5,12,0.5833333333333334
vs. FBS (I-A),2019,Southern Mississippi,6,6,12,0.5
vs. FCS (I-AA),2019,Southern Mississippi,1,0,1,1.0
vs. FBS Winning,2019,Southern Mississippi,1,5,6,0.16666666666666666
vs. FBS Non-Winning,2019,Southern Mississippi,5,1,6,0.8333333333333334
vs. BCS AQ,2019,Southern Mississippi,0,3,3,0.0
vs. BCS non-AQ,2019,Southern Mississippi,6,3,9,0.6666666666666666
vs. FBS Power 5,2019,Southern Mississippi,0,2,2,0.0
vs. FBS non-Power 5,2019,Southern Mississippi,6,4,10,0.6
in August/September,2019,Southern Mississippi,3,2,5,0.6
in October,2019,Southern Mississippi,2,1,3,0.6666666666666666
in November,2019,Southern Mississippi,2,2,4,0.5
in December/January,2019,Southern Mississippi,0,1,1,0.0
All Games,2020,Southern Mississippi,3,7,10,0.3
at Home,2020,Southern Mississippi,2,5,7,0.2857142857142857
on Road/Neutral Site,2020,Southern Mississippi,1,2,3,0.3333333333333333
vs. Conference,2020,Southern Mississippi,2,4,6,0.3333333333333333
vs. Non-Conference,2020,Southern Mississippi,1,3,4,0.25
vs. Ranked (AP),2020,Southern Mississippi,0,1,1,0.0
vs. Unranked (AP),2020,Southern Mississippi,3,6,9,0.3333333333333333
vs. FBS (I-A),2020,Southern Mississippi,2,7,9,0.2222222222222222
vs. FCS (I-AA),2020,Southern Mississippi,1,0,1,1.0
vs. FBS Winning,2020,Southern Mississippi,1,2,3,0.3333333333333333
vs. FBS Non-Winning,2020,Southern Mississippi,1,5,6,0.16666666666666666
vs. BCS AQ,2020,Southern Mississippi,0,1,1,0.0
vs. BCS non-AQ,2020,Southern Mississippi,2,6,8,0.25
vs. FBS Power 5,2020,Southern Mississippi,0,0,0,
vs. FBS non-Power 5,2020,Southern Mississippi,2,7,9,0.2222222222222222
in August/September,2020,Southern Mississippi,0,3,3,0.0
in October,2020,Southern Mississippi,1,2,3,0.3333333333333333
in November,2020,Southern Mississippi,1,2,3,0.3333333333333333
in December/January,2020,Southern Mississippi,1,0,1,1.0
All Games,2021,Southern Mississippi,3,9,12,0.25
at Home,2021,Southern Mississippi,2,4,6,0.3333333333333333
on Road/Neutral Site,2021,Southern Mississippi,1,5,6,0.16666666666666666
vs. Conference,2021,Southern Mississippi,2,6,8,0.25
vs. Non-Conference,2021,Southern Mississippi,1,3,4,0.25
vs. Ranked (AP),2021,Southern Mississippi,0,1,1,0.0
vs. Unranked (AP),2021,Southern Mississippi,3,8,11,0.2727272727272727
vs. FBS (I-A),2021,Southern Mississippi,2,9,11,0.18181818181818182
vs. FCS (I-AA),2021,Southern Mississippi,1,0,1,1.0
vs. FBS Winning,2021,Southern Mississippi,0,5,5,0.0
vs. FBS Non-Winning,2021,Southern Mississippi,2,4,6,0.3333333333333333
vs. BCS AQ,2021,Southern Mississippi,0,1,1,0.0
vs. BCS non-AQ,2021,Southern Mississippi,2,8,10,0.2
vs. FBS Power 5,2021,Southern Mississippi,0,1,1,0.0
vs. FBS non-Power 5,2021,Southern Mississippi,2,8,10,0.2
in August/September,2021,Southern Mississippi,1,3,4,0.25
in October,2021,Southern Mississippi,0,4,4,0.0
in November,2021,Southern Mississippi,2,2,4,0.5
in December/January,2021,Southern Mississippi,0,0,0,
All Games,2022,Southern Mississippi,7,6,13,0.5384615384615384
at Home,2022,Southern Mississippi,3,3,6,0.5
on Road/Neutral Site,2022,Southern Mississippi,4,3,7,0.5714285714285714
vs. Conference,2022,Southern Mississippi,4,4,8,0.5
vs. Non-Conference,2022,Southern Mississippi,3,2,5,0.6
vs. Ranked (AP),2022,Southern Mississippi,1,1,2,0.5
vs. Unranked (AP),2022,Southern Mississippi,6,5,11,0.5454545454545454
vs. FBS (I-A),2022,Southern Mississippi,6,6,12,0.5
vs. FCS (I-AA),2022,Southern Mississippi,1,0,1,1.0
vs. FBS Winning,2022,Southern Mississippi,1,4,5,0.2
vs. FBS Non-Winning,2022,Southern Mississippi,5,2,7,0.7142857142857143
vs. BCS AQ,2022,Southern Mississippi,1,1,2,0.5
vs. BCS non-AQ,2022,Southern Mississippi,5,5,10,0.5
vs. FBS Power 5,2022,Southern Mississippi,0,1,1,0.0
vs. FBS non-Power 5,2022,Southern Mississippi,6,5,11,0.5454545454545454
in August/September,2022,Southern Mississippi,2,2,4,0.5
in October,2022,Southern Mississippi,3,1,4,0.75
in November,2022,Southern Mississippi,1,3,4,0.25
in December/January,2022,Southern Mississippi,1,0,1,1.0
All Games,2009,Stanford,8,5,13,0.6153846153846154
at Home,2009,Stanford,6,1,7,0.8571428571428571
on Road/Neutral Site,2009,Stanford,2,4,6,0.3333333333333333
vs. Conference,2009,Stanford,6,3,9,0.6666666666666666
vs. Non-Conference,2009,Stanford,2,2,4,0.5
vs. Ranked (AP),2009,Stanford,2,0,2,1.0
vs. Unranked (AP),2009,Stanford,6,5,11,0.5454545454545454
vs. FBS (I-A),2009,Stanford,8,5,13,0.6153846153846154
vs. FCS (I-AA),2009,Stanford,0,0,0,
vs. FBS Winning,2009,Stanford,3,4,7,0.42857142857142855
vs. FBS Non-Winning,2009,Stanford,5,1,6,0.8333333333333334
vs. BCS AQ,2009,Stanford,7,5,12,0.5833333333333334
vs. BCS non-AQ,2009,Stanford,1,0,1,1.0
vs. FBS Power 5,2009,Stanford,6,5,11,0.5454545454545454
vs. FBS non-Power 5,2009,Stanford,2,0,2,1.0
in August/September,2009,Stanford,3,1,4,0.75
in October,2009,Stanford,2,2,4,0.5
in November,2009,Stanford,3,1,4,0.75
in December/January,2009,Stanford,0,1,1,0.0
All Games,2010,Stanford,12,1,13,0.9230769230769231
at Home,2010,Stanford,6,0,6,1.0
on Road/Neutral Site,2010,Stanford,6,1,7,0.8571428571428571
vs. Conference,2010,Stanford,8,1,9,0.8888888888888888
vs. Non-Conference,2010,Stanford,4,0,4,1.0
vs. Ranked (AP),2010,Stanford,1,1,2,0.5
vs. Unranked (AP),2010,Stanford,11,0,11,1.0
vs. FBS (I-A),2010,Stanford,11,1,12,0.9166666666666666
vs. FCS (I-AA),2010,Stanford,1,0,1,1.0
vs. FBS Winning,2010,Stanford,5,1,6,0.8333333333333334
vs. FBS Non-Winning,2010,Stanford,6,0,6,1.0
vs. BCS AQ,2010,Stanford,11,1,12,0.9166666666666666
vs. BCS non-AQ,2010,Stanford,0,0,0,
vs. FBS Power 5,2010,Stanford,10,1,11,0.9090909090909091
vs. FBS non-Power 5,2010,Stanford,1,0,1,1.0
in August/September,2010,Stanford,4,0,4,1.0
in October,2010,Stanford,3,1,4,0.75
in November,2010,Stanford,4,0,4,1.0
in December/January,2010,Stanford,1,0,1,1.0
All Games,2011,Stanford,11,2,13,0.8461538461538461
at Home,2011,Stanford,6,1,7,0.8571428571428571
on Road/Neutral Site,2011,Stanford,5,1,6,0.8333333333333334
vs. Conference,2011,Stanford,8,1,9,0.8888888888888888
vs. Non-Conference,2011,Stanford,3,1,4,0.75
vs. Ranked (AP),2011,Stanford,1,2,3,0.3333333333333333
vs. Unranked (AP),2011,Stanford,10,0,10,1.0
vs. FBS (I-A),2011,Stanford,11,2,13,0.8461538461538461
vs. FCS (I-AA),2011,Stanford,0,0,0,
vs. FBS Winning,2011,Stanford,4,2,6,0.6666666666666666
vs. FBS Non-Winning,2011,Stanford,7,0,7,1.0
vs. BCS AQ,2011,Stanford,10,2,12,0.8333333333333334
vs. BCS non-AQ,2011,Stanford,1,0,1,1.0
vs. FBS Power 5,2011,Stanford,9,2,11,0.8181818181818182
vs. FBS non-Power 5,2011,Stanford,2,0,2,1.0
in August/September,2011,Stanford,3,0,3,1.0
in October,2011,Stanford,5,0,5,1.0
in November,2011,Stanford,3,1,4,0.75
in December/January,2011,Stanford,0,1,1,0.0
All Games,2012,Stanford,12,2,14,0.8571428571428571
at Home,2012,Stanford,7,0,7,1.0
on Road/Neutral Site,2012,Stanford,5,2,7,0.7142857142857143
vs. Conference,2012,Stanford,9,1,10,0.9
vs. Non-Conference,2012,Stanford,3,1,4,0.75
vs. Ranked (AP),2012,Stanford,3,1,4,0.75
vs. Unranked (AP),2012,Stanford,9,1,10,0.9
vs. FBS (I-A),2012,Stanford,12,2,14,0.8571428571428571
vs. FCS (I-AA),2012,Stanford,0,0,0,
vs. FBS Winning,2012,Stanford,8,2,10,0.8
vs. FBS Non-Winning,2012,Stanford,4,0,4,1.0
vs. BCS AQ,2012,Stanford,11,2,13,0.8461538461538461
vs. BCS non-AQ,2012,Stanford,1,0,1,1.0
vs. FBS Power 5,2012,Stanford,11,1,12,0.9166666666666666
vs. FBS non-Power 5,2012,Stanford,1,1,2,0.5
in August/September,2012,Stanford,3,1,4,0.75
in October,2012,Stanford,3,1,4,0.75
in November,2012,Stanford,5,0,5,1.0
in December/January,2012,Stanford,1,0,1,1.0
All Games,2013,Stanford,11,3,14,0.7857142857142857
at Home,2013,Stanford,7,0,7,1.0
on Road/Neutral Site,2013,Stanford,4,3,7,0.5714285714285714
vs. Conference,2013,Stanford,8,2,10,0.8
vs. Non-Conference,2013,Stanford,3,1,4,0.75
vs. Ranked (AP),2013,Stanford,6,2,8,0.75
vs. Unranked (AP),2013,Stanford,5,1,6,0.8333333333333334
vs. FBS (I-A),2013,Stanford,11,3,14,0.7857142857142857
vs. FCS (I-AA),2013,Stanford,0,0,0,
vs. FBS Winning,2013,Stanford,7,2,9,0.7777777777777778
vs. FBS Non-Winning,2013,Stanford,4,1,5,0.8
vs. BCS AQ,2013,Stanford,9,3,12,0.75
vs. BCS non-AQ,2013,Stanford,2,0,2,1.0
vs. FBS Power 5,2013,Stanford,8,3,11,0.7272727272727273
vs. FBS non-Power 5,2013,Stanford,3,0,3,1.0
in August/September,2013,Stanford,4,0,4,1.0
in October,2013,Stanford,3,1,4,0.75
in November,2013,Stanford,3,1,4,0.75
in December/January,2013,Stanford,1,1,2,0.5
All Games,2014,Stanford,8,5,13,0.6153846153846154
at Home,2014,Stanford,4,2,6,0.6666666666666666
on Road/Neutral Site,2014,Stanford,4,3,7,0.5714285714285714
vs. Conference,2014,Stanford,5,4,9,0.5555555555555556
vs. Non-Conference,2014,Stanford,3,1,4,0.75
vs. Ranked (AP),2014,Stanford,1,4,5,0.2
vs. Unranked (AP),2014,Stanford,7,1,8,0.875
vs. FBS (I-A),2014,Stanford,7,5,12,0.5833333333333334
vs. FCS (I-AA),2014,Stanford,1,0,1,1.0
vs. FBS Winning,2014,Stanford,3,5,8,0.375
vs. FBS Non-Winning,2014,Stanford,4,0,4,1.0
vs. BCS AQ,2014,Stanford,6,5,11,0.5454545454545454
vs. BCS non-AQ,2014,Stanford,1,0,1,1.0
vs. FBS Power 5,2014,Stanford,6,4,10,0.6
vs. FBS non-Power 5,2014,Stanford,1,1,2,0.5
in August/September,2014,Stanford,3,1,4,0.75
in October,2014,Stanford,2,2,4,0.5
in November,2014,Stanford,2,2,4,0.5
in December/January,2014,Stanford,1,0,1,1.0
All Games,2015,Stanford,12,2,14,0.8571428571428571
at Home,2015,Stanford,6,1,7,0.8571428571428571
on Road/Neutral Site,2015,Stanford,6,1,7,0.8571428571428571
vs. Conference,2015,Stanford,9,1,10,0.9
vs. Non-Conference,2015,Stanford,3,1,4,0.75
vs. Ranked (AP),2015,Stanford,2,2,4,0.5
vs. Unranked (AP),2015,Stanford,10,0,10,1.0
vs. FBS (I-A),2015,Stanford,12,2,14,0.8571428571428571
vs. FCS (I-AA),2015,Stanford,0,0,0,
vs. FBS Winning,2015,Stanford,9,2,11,0.8181818181818182
vs. FBS Non-Winning,2015,Stanford,3,0,3,1.0
vs. BCS AQ,2015,Stanford,12,2,14,0.8571428571428571
vs. BCS non-AQ,2015,Stanford,0,0,0,
vs. FBS Power 5,2015,Stanford,10,2,12,0.8333333333333334
vs. FBS non-Power 5,2015,Stanford,2,0,2,1.0
in August/September,2015,Stanford,3,1,4,0.75
in October,2015,Stanford,4,0,4,1.0
in November,2015,Stanford,3,1,4,0.75
in December/January,2015,Stanford,2,0,2,1.0
All Games,2016,Stanford,10,3,13,0.7692307692307693
at Home,2016,Stanford,4,2,6,0.6666666666666666
on Road/Neutral Site,2016,Stanford,6,1,7,0.8571428571428571
vs. Conference,2016,Stanford,6,3,9,0.6666666666666666
vs. Non-Conference,2016,Stanford,4,0,4,1.0
vs. Ranked (AP),2016,Stanford,1,2,3,0.3333333333333333
vs. Unranked (AP),2016,Stanford,9,1,10,0.9
vs. FBS (I-A),2016,Stanford,10,3,13,0.7692307692307693
vs. FCS (I-AA),2016,Stanford,0,0,0,
vs. FBS Winning,2016,Stanford,3,3,6,0.5
vs. FBS Non-Winning,2016,Stanford,7,0,7,1.0
vs. BCS AQ,2016,Stanford,9,3,12,0.75
vs. BCS non-AQ,2016,Stanford,1,0,1,1.0
vs. FBS Power 5,2016,Stanford,8,3,11,0.7272727272727273
vs. FBS non-Power 5,2016,Stanford,2,0,2,1.0
in August/September,2016,Stanford,3,1,4,0.75
in October,2016,Stanford,2,2,4,0.5
in November,2016,Stanford,4,0,4,1.0
in December/January,2016,Stanford,1,0,1,1.0
All Games,2017,Stanford,9,5,14,0.6428571428571429
at Home,2017,Stanford,6,0,6,1.0
on Road/Neutral Site,2017,Stanford,3,5,8,0.375
vs. Conference,2017,Stanford,7,3,10,0.7
vs. Non-Conference,2017,Stanford,2,2,4,0.5
vs. Ranked (AP),2017,Stanford,2,3,5,0.4
vs. Unranked (AP),2017,Stanford,7,2,9,0.7777777777777778
vs. FBS (I-A),2017,Stanford,9,5,14,0.6428571428571429
vs. FCS (I-AA),2017,Stanford,0,0,0,
vs. FBS Winning,2017,Stanford,5,5,10,0.5
vs. FBS Non-Winning,2017,Stanford,4,0,4,1.0
vs. BCS AQ,2017,Stanford,8,4,12,0.6666666666666666
vs. BCS non-AQ,2017,Stanford,1,1,2,0.5
vs. FBS Power 5,2017,Stanford,7,4,11,0.6363636363636364
vs. FBS non-Power 5,2017,Stanford,2,1,3,0.6666666666666666
in August/September,2017,Stanford,3,2,5,0.6
in October,2017,Stanford,3,0,3,1.0
in November,2017,Stanford,3,1,4,0.75
in December/January,2017,Stanford,0,2,2,0.0
All Games,2018,Stanford,9,4,13,0.6923076923076923
at Home,2018,Stanford,4,2,6,0.6666666666666666
on Road/Neutral Site,2018,Stanford,5,2,7,0.7142857142857143
vs. Conference,2018,Stanford,6,3,9,0.6666666666666666
vs. Non-Conference,2018,Stanford,3,1,4,0.75
vs. Ranked (AP),2018,Stanford,0,3,3,0.0
vs. Unranked (AP),2018,Stanford,9,1,10,0.9
vs. FBS (I-A),2018,Stanford,8,4,12,0.6666666666666666
vs. FCS (I-AA),2018,Stanford,1,0,1,1.0
vs. FBS Winning,2018,Stanford,4,4,8,0.5
vs. FBS Non-Winning,2018,Stanford,4,0,4,1.0
vs. BCS AQ,2018,Stanford,7,4,11,0.6363636363636364
vs. BCS non-AQ,2018,Stanford,1,0,1,1.0
vs. FBS Power 5,2018,Stanford,7,3,10,0.7
vs. FBS non-Power 5,2018,Stanford,1,1,2,0.5
in August/September,2018,Stanford,4,1,5,0.8
in October,2018,Stanford,1,2,3,0.3333333333333333
in November,2018,Stanford,2,1,3,0.6666666666666666
in December/January,2018,Stanford,2,0,2,1.0
All Games,2019,Stanford,4,8,12,0.3333333333333333
at Home,2019,Stanford,3,4,7,0.42857142857142855
on Road/Neutral Site,2019,Stanford,1,4,5,0.2
vs. Conference,2019,Stanford,3,6,9,0.3333333333333333
vs. Non-Conference,2019,Stanford,1,2,3,0.3333333333333333
vs. Ranked (AP),2019,Stanford,0,3,3,0.0
vs. Unranked (AP),2019,Stanford,4,5,9,0.4444444444444444
vs. FBS (I-A),2019,Stanford,4,8,12,0.3333333333333333
vs. FCS (I-AA),2019,Stanford,0,0,0,
vs. FBS Winning,2019,Stanford,1,5,6,0.16666666666666666
vs. FBS Non-Winning,2019,Stanford,3,3,6,0.5
vs. BCS AQ,2019,Stanford,4,8,12,0.3333333333333333
vs. BCS non-AQ,2019,Stanford,0,0,0,
vs. FBS Power 5,2019,Stanford,4,6,10,0.4
vs. FBS non-Power 5,2019,Stanford,0,2,2,0.0
in August/September,2019,Stanford,2,3,5,0.4
in October,2019,Stanford,2,1,3,0.6666666666666666
in November,2019,Stanford,0,4,4,0.0
in December/January,2019,Stanford,0,0,0,
All Games,2020,Stanford,4,2,6,0.6666666666666666
at Home,2020,Stanford,0,1,1,0.0
on Road/Neutral Site,2020,Stanford,4,1,5,0.8
vs. Conference,2020,Stanford,4,2,6,0.6666666666666666
vs. Non-Conference,2020,Stanford,0,0,0,
vs. Ranked (AP),2020,Stanford,0,1,1,0.0
vs. Unranked (AP),2020,Stanford,4,1,5,0.8
vs. FBS (I-A),2020,Stanford,4,2,6,0.6666666666666666
vs. FCS (I-AA),2020,Stanford,0,0,0,
vs. FBS Winning,2020,Stanford,1,2,3,0.3333333333333333
vs. FBS Non-Winning,2020,Stanford,3,0,3,1.0
vs. BCS AQ,2020,Stanford,4,2,6,0.6666666666666666
vs. BCS non-AQ,2020,Stanford,0,0,0,
vs. FBS Power 5,2020,Stanford,4,2,6,0.6666666666666666
vs. FBS non-Power 5,2020,Stanford,0,0,0,
in August/September,2020,Stanford,0,0,0,
in October,2020,Stanford,0,0,0,
in November,2020,Stanford,1,2,3,0.3333333333333333
in December/January,2020,Stanford,3,0,3,1.0
All Games,2021,Stanford,3,9,12,0.25
at Home,2021,Stanford,1,5,6,0.16666666666666666
on Road/Neutral Site,2021,Stanford,2,4,6,0.3333333333333333
vs. Conference,2021,Stanford,2,7,9,0.2222222222222222
vs. Non-Conference,2021,Stanford,1,2,3,0.3333333333333333
vs. Ranked (AP),2021,Stanford,1,2,3,0.3333333333333333
vs. Unranked (AP),2021,Stanford,2,7,9,0.2222222222222222
vs. FBS (I-A),2021,Stanford,3,9,12,0.25
vs. FCS (I-AA),2021,Stanford,0,0,0,
vs. FBS Winning,2021,Stanford,1,7,8,0.125
vs. FBS Non-Winning,2021,Stanford,2,2,4,0.5
vs. BCS AQ,2021,Stanford,3,9,12,0.25
vs. BCS non-AQ,2021,Stanford,0,0,0,
vs. FBS Power 5,2021,Stanford,3,8,11,0.2727272727272727
vs. FBS non-Power 5,2021,Stanford,0,1,1,0.0
in August/September,2021,Stanford,2,2,4,0.5
in October,2021,Stanford,1,3,4,0.25
in November,2021,Stanford,0,4,4,0.0
in December/January,2021,Stanford,0,0,0,
All Games,2022,Stanford,3,9,12,0.25
at Home,2022,Stanford,2,4,6,0.3333333333333333
on Road/Neutral Site,2022,Stanford,1,5,6,0.16666666666666666
vs. Conference,2022,Stanford,1,8,9,0.1111111111111111
vs. Non-Conference,2022,Stanford,2,1,3,0.6666666666666666
vs. Ranked (AP),2022,Stanford,1,6,7,0.14285714285714285
vs. Unranked (AP),2022,Stanford,2,3,5,0.4
vs. FBS (I-A),2022,Stanford,2,9,11,0.18181818181818182
vs. FCS (I-AA),2022,Stanford,1,0,1,1.0
vs. FBS Winning,2022,Stanford,1,8,9,0.1111111111111111
vs. FBS Non-Winning,2022,Stanford,1,1,2,0.5
vs. BCS AQ,2022,Stanford,2,8,10,0.2
vs. BCS non-AQ,2022,Stanford,0,1,1,0.0
vs. FBS Power 5,2022,Stanford,1,8,9,0.1111111111111111
vs. FBS non-Power 5,2022,Stanford,1,1,2,0.5
in August/September,2022,Stanford,1,2,3,0.3333333333333333
in October,2022,Stanford,2,3,5,0.4
in November,2022,Stanford,0,4,4,0.0
in December/January,2022,Stanford,0,0,0,
All Games,2009,Syracuse,4,8,12,0.3333333333333333
at Home,2009,Syracuse,4,4,8,0.5
on Road/Neutral Site,2009,Syracuse,0,4,4,0.0
vs. Conference,2009,Syracuse,1,6,7,0.14285714285714285
vs. Non-Conference,2009,Syracuse,3,2,5,0.6
vs. Ranked (AP),2009,Syracuse,0,4,4,0.0
vs. Unranked (AP),2009,Syracuse,4,4,8,0.5
vs. FBS (I-A),2009,Syracuse,3,8,11,0.2727272727272727
vs. FCS (I-AA),2009,Syracuse,1,0,1,1.0
vs. FBS Winning,2009,Syracuse,2,6,8,0.25
vs. FBS Non-Winning,2009,Syracuse,1,2,3,0.3333333333333333
vs. BCS AQ,2009,Syracuse,2,8,10,0.2
vs. BCS non-AQ,2009,Syracuse,1,0,1,1.0
vs. FBS Power 5,2009,Syracuse,1,2,3,0.3333333333333333
vs. FBS non-Power 5,2009,Syracuse,2,6,8,0.25
in August/September,2009,Syracuse,2,2,4,0.5
in October,2009,Syracuse,1,3,4,0.25
in November,2009,Syracuse,1,3,4,0.25
in December/January,2009,Syracuse,0,0,0,
All Games,2010,Syracuse,8,5,13,0.6153846153846154
at Home,2010,Syracuse,2,4,6,0.3333333333333333
on Road/Neutral Site,2010,Syracuse,6,1,7,0.8571428571428571
vs. Conference,2010,Syracuse,4,3,7,0.5714285714285714
vs. Non-Conference,2010,Syracuse,4,2,6,0.6666666666666666
vs. Ranked (AP),2010,Syracuse,0,0,0,
vs. Unranked (AP),2010,Syracuse,8,5,13,0.6153846153846154
vs. FBS (I-A),2010,Syracuse,6,5,11,0.5454545454545454
vs. FCS (I-AA),2010,Syracuse,2,0,2,1.0
vs. FBS Winning,2010,Syracuse,3,5,8,0.375
vs. FBS Non-Winning,2010,Syracuse,3,0,3,1.0
vs. BCS AQ,2010,Syracuse,5,5,10,0.5
vs. BCS non-AQ,2010,Syracuse,1,0,1,1.0
vs. FBS Power 5,2010,Syracuse,1,2,3,0.3333333333333333
vs. FBS non-Power 5,2010,Syracuse,5,3,8,0.625
in August/September,2010,Syracuse,3,1,4,0.75
in October,2010,Syracuse,3,1,4,0.75
in November,2010,Syracuse,1,3,4,0.25
in December/January,2010,Syracuse,1,0,1,1.0
All Games,2011,Syracuse,5,7,12,0.4166666666666667
at Home,2011,Syracuse,4,3,7,0.5714285714285714
on Road/Neutral Site,2011,Syracuse,1,4,5,0.2
vs. Conference,2011,Syracuse,1,6,7,0.14285714285714285
vs. Non-Conference,2011,Syracuse,4,1,5,0.8
vs. Ranked (AP),2011,Syracuse,1,2,3,0.3333333333333333
vs. Unranked (AP),2011,Syracuse,4,5,9,0.4444444444444444
vs. FBS (I-A),2011,Syracuse,4,7,11,0.36363636363636365
vs. FCS (I-AA),2011,Syracuse,1,0,1,1.0
vs. FBS Winning,2011,Syracuse,2,4,6,0.3333333333333333
vs. FBS Non-Winning,2011,Syracuse,2,3,5,0.4
vs. BCS AQ,2011,Syracuse,2,7,9,0.2222222222222222
vs. BCS non-AQ,2011,Syracuse,2,0,2,1.0
vs. FBS Power 5,2011,Syracuse,1,1,2,0.5
vs. FBS non-Power 5,2011,Syracuse,3,6,9,0.3333333333333333
in August/September,2011,Syracuse,3,1,4,0.75
in October,2011,Syracuse,2,2,4,0.5
in November,2011,Syracuse,0,3,3,0.0
in December/January,2011,Syracuse,0,1,1,0.0
All Games,2012,Syracuse,8,5,13,0.6153846153846154
at Home,2012,Syracuse,4,1,5,0.8
on Road/Neutral Site,2012,Syracuse,4,4,8,0.5
vs. Conference,2012,Syracuse,5,2,7,0.7142857142857143
vs. Non-Conference,2012,Syracuse,3,3,6,0.5
vs. Ranked (AP),2012,Syracuse,1,1,2,0.5
vs. Unranked (AP),2012,Syracuse,7,4,11,0.6363636363636364
vs. FBS (I-A),2012,Syracuse,7,5,12,0.5833333333333334
vs. FCS (I-AA),2012,Syracuse,1,0,1,1.0
vs. FBS Winning,2012,Syracuse,2,4,6,0.3333333333333333
vs. FBS Non-Winning,2012,Syracuse,5,1,6,0.8333333333333334
vs. BCS AQ,2012,Syracuse,7,5,12,0.5833333333333334
vs. BCS non-AQ,2012,Syracuse,0,0,0,
vs. FBS Power 5,2012,Syracuse,2,3,5,0.4
vs. FBS non-Power 5,2012,Syracuse,5,2,7,0.7142857142857143
in August/September,2012,Syracuse,1,3,4,0.25
in October,2012,Syracuse,3,1,4,0.75
in November,2012,Syracuse,3,1,4,0.75
in December/January,2012,Syracuse,1,0,1,1.0
All Games,2013,Syracuse,7,6,13,0.5384615384615384
at Home,2013,Syracuse,4,2,6,0.6666666666666666
on Road/Neutral Site,2013,Syracuse,3,4,7,0.42857142857142855
vs. Conference,2013,Syracuse,4,4,8,0.5
vs. Non-Conference,2013,Syracuse,3,2,5,0.6
vs. Ranked (AP),2013,Syracuse,0,2,2,0.0
vs. Unranked (AP),2013,Syracuse,7,4,11,0.6363636363636364
vs. FBS (I-A),2013,Syracuse,6,6,12,0.5
vs. FCS (I-AA),2013,Syracuse,1,0,1,1.0
vs. FBS Winning,2013,Syracuse,4,5,9,0.4444444444444444
vs. FBS Non-Winning,2013,Syracuse,2,1,3,0.6666666666666666
vs. BCS AQ,2013,Syracuse,5,6,11,0.45454545454545453
vs. BCS non-AQ,2013,Syracuse,1,0,1,1.0
vs. FBS Power 5,2013,Syracuse,5,6,11,0.45454545454545453
vs. FBS non-Power 5,2013,Syracuse,1,0,1,1.0
in August/September,2013,Syracuse,2,2,4,0.5
in October,2013,Syracuse,1,2,3,0.3333333333333333
in November,2013,Syracuse,3,2,5,0.6
in December/January,2013,Syracuse,1,0,1,1.0
All Games,2014,Syracuse,3,9,12,0.25
at Home,2014,Syracuse,1,5,6,0.16666666666666666
on Road/Neutral Site,2014,Syracuse,2,4,6,0.3333333333333333
vs. Conference,2014,Syracuse,1,7,8,0.125
vs. Non-Conference,2014,Syracuse,2,2,4,0.5
vs. Ranked (AP),2014,Syracuse,0,3,3,0.0
vs. Unranked (AP),2014,Syracuse,3,6,9,0.3333333333333333
vs. FBS (I-A),2014,Syracuse,2,9,11,0.18181818181818182
vs. FCS (I-AA),2014,Syracuse,1,0,1,1.0
vs. FBS Winning,2014,Syracuse,1,8,9,0.1111111111111111
vs. FBS Non-Winning,2014,Syracuse,1,1,2,0.5
vs. BCS AQ,2014,Syracuse,1,9,10,0.1
vs. BCS non-AQ,2014,Syracuse,1,0,1,1.0
vs. FBS Power 5,2014,Syracuse,1,8,9,0.1111111111111111
vs. FBS non-Power 5,2014,Syracuse,1,1,2,0.5
in August/September,2014,Syracuse,2,2,4,0.5
in October,2014,Syracuse,1,3,4,0.25
in November,2014,Syracuse,0,4,4,0.0
in December/January,2014,Syracuse,0,0,0,
All Games,2015,Syracuse,4,8,12,0.3333333333333333
at Home,2015,Syracuse,4,3,7,0.5714285714285714
on Road/Neutral Site,2015,Syracuse,0,5,5,0.0
vs. Conference,2015,Syracuse,2,6,8,0.25
vs. Non-Conference,2015,Syracuse,2,2,4,0.5
vs. Ranked (AP),2015,Syracuse,0,3,3,0.0
vs. Unranked (AP),2015,Syracuse,4,5,9,0.4444444444444444
vs. FBS (I-A),2015,Syracuse,3,8,11,0.2727272727272727
vs. FCS (I-AA),2015,Syracuse,1,0,1,1.0
vs. FBS Winning,2015,Syracuse,1,7,8,0.125
vs. FBS Non-Winning,2015,Syracuse,2,1,3,0.6666666666666666
vs. BCS AQ,2015,Syracuse,2,8,10,0.2
vs. BCS non-AQ,2015,Syracuse,1,0,1,1.0
vs. FBS Power 5,2015,Syracuse,2,7,9,0.2222222222222222
vs. FBS non-Power 5,2015,Syracuse,1,1,2,0.5
in August/September,2015,Syracuse,3,1,4,0.75
in October,2015,Syracuse,0,4,4,0.0
in November,2015,Syracuse,1,3,4,0.25
in December/January,2015,Syracuse,0,0,0,
All Games,2016,Syracuse,4,8,12,0.3333333333333333
at Home,2016,Syracuse,2,4,6,0.3333333333333333
on Road/Neutral Site,2016,Syracuse,2,4,6,0.3333333333333333
vs. Conference,2016,Syracuse,2,6,8,0.25
vs. Non-Conference,2016,Syracuse,2,2,4,0.5
vs. Ranked (AP),2016,Syracuse,1,5,6,0.16666666666666666
vs. Unranked (AP),2016,Syracuse,3,3,6,0.5
vs. FBS (I-A),2016,Syracuse,3,8,11,0.2727272727272727
vs. FCS (I-AA),2016,Syracuse,1,0,1,1.0
vs. FBS Winning,2016,Syracuse,2,7,9,0.2222222222222222
vs. FBS Non-Winning,2016,Syracuse,1,1,2,0.5
vs. BCS AQ,2016,Syracuse,3,8,11,0.2727272727272727
vs. BCS non-AQ,2016,Syracuse,0,0,0,
vs. FBS Power 5,2016,Syracuse,2,6,8,0.25
vs. FBS non-Power 5,2016,Syracuse,1,2,3,0.3333333333333333
in August/September,2016,Syracuse,2,2,4,0.5
in October,2016,Syracuse,2,2,4,0.5
in November,2016,Syracuse,0,4,4,0.0
in December/January,2016,Syracuse,0,0,0,
All Games,2017,Syracuse,4,8,12,0.3333333333333333
at Home,2017,Syracuse,4,3,7,0.5714285714285714
on Road/Neutral Site,2017,Syracuse,0,5,5,0.0
vs. Conference,2017,Syracuse,2,6,8,0.25
vs. Non-Conference,2017,Syracuse,2,2,4,0.5
vs. Ranked (AP),2017,Syracuse,1,3,4,0.25
vs. Unranked (AP),2017,Syracuse,3,5,8,0.375
vs. FBS (I-A),2017,Syracuse,3,8,11,0.2727272727272727
vs. FCS (I-AA),2017,Syracuse,1,0,1,1.0
vs. FBS Winning,2017,Syracuse,2,8,10,0.2
vs. FBS Non-Winning,2017,Syracuse,1,0,1,1.0
vs. BCS AQ,2017,Syracuse,2,7,9,0.2222222222222222
vs. BCS non-AQ,2017,Syracuse,1,1,2,0.5
vs. FBS Power 5,2017,Syracuse,2,7,9,0.2222222222222222
vs. FBS non-Power 5,2017,Syracuse,1,1,2,0.5
in August/September,2017,Syracuse,2,3,5,0.4
in October,2017,Syracuse,2,1,3,0.6666666666666666
in November,2017,Syracuse,0,4,4,0.0
in December/January,2017,Syracuse,0,0,0,
All Games,2018,Syracuse,10,3,13,0.7692307692307693
at Home,2018,Syracuse,6,0,6,1.0
on Road/Neutral Site,2018,Syracuse,4,3,7,0.5714285714285714
vs. Conference,2018,Syracuse,6,2,8,0.75
vs. Non-Conference,2018,Syracuse,4,1,5,0.8
vs. Ranked (AP),2018,Syracuse,1,2,3,0.3333333333333333
vs. Unranked (AP),2018,Syracuse,9,1,10,0.9
vs. FBS (I-A),2018,Syracuse,9,3,12,0.75
vs. FCS (I-AA),2018,Syracuse,1,0,1,1.0
vs. FBS Winning,2018,Syracuse,5,2,7,0.7142857142857143
vs. FBS Non-Winning,2018,Syracuse,4,1,5,0.8
vs. BCS AQ,2018,Syracuse,8,3,11,0.7272727272727273
vs. BCS non-AQ,2018,Syracuse,1,0,1,1.0
vs. FBS Power 5,2018,Syracuse,7,2,9,0.7777777777777778
vs. FBS non-Power 5,2018,Syracuse,2,1,3,0.6666666666666666
in August/September,2018,Syracuse,4,1,5,0.8
in October,2018,Syracuse,2,1,3,0.6666666666666666
in November,2018,Syracuse,3,1,4,0.75
in December/January,2018,Syracuse,1,0,1,1.0
All Games,2019,Syracuse,5,7,12,0.4166666666666667
at Home,2019,Syracuse,3,3,6,0.5
on Road/Neutral Site,2019,Syracuse,2,4,6,0.3333333333333333
vs. Conference,2019,Syracuse,2,6,8,0.25
vs. Non-Conference,2019,Syracuse,3,1,4,0.75
vs. Ranked (AP),2019,Syracuse,0,1,1,0.0
vs. Unranked (AP),2019,Syracuse,5,6,11,0.45454545454545453
vs. FBS (I-A),2019,Syracuse,4,7,11,0.36363636363636365
vs. FCS (I-AA),2019,Syracuse,1,0,1,1.0
vs. FBS Winning,2019,Syracuse,3,3,6,0.5
vs. FBS Non-Winning,2019,Syracuse,1,4,5,0.2
vs. BCS AQ,2019,Syracuse,2,7,9,0.2222222222222222
vs. BCS non-AQ,2019,Syracuse,2,0,2,1.0
vs. FBS Power 5,2019,Syracuse,2,7,9,0.2222222222222222
vs. FBS non-Power 5,2019,Syracuse,2,0,2,1.0
in August/September,2019,Syracuse,3,2,5,0.6
in October,2019,Syracuse,0,3,3,0.0
in November,2019,Syracuse,2,2,4,0.5
in December/January,2019,Syracuse,0,0,0,
All Games,2020,Syracuse,1,10,11,0.09090909090909091
at Home,2020,Syracuse,1,5,6,0.16666666666666666
on Road/Neutral Site,2020,Syracuse,0,5,5,0.0
vs. Conference,2020,Syracuse,1,9,10,0.1
vs. Non-Conference,2020,Syracuse,0,1,1,0.0
vs. Ranked (AP),2020,Syracuse,0,5,5,0.0
vs. Unranked (AP),2020,Syracuse,1,5,6,0.16666666666666666
vs. FBS (I-A),2020,Syracuse,1,10,11,0.09090909090909091
vs. FCS (I-AA),2020,Syracuse,0,0,0,
vs. FBS Winning,2020,Syracuse,0,7,7,0.0
vs. FBS Non-Winning,2020,Syracuse,1,3,4,0.25
vs. BCS AQ,2020,Syracuse,1,9,10,0.1
vs. BCS non-AQ,2020,Syracuse,0,1,1,0.0
vs. FBS Power 5,2020,Syracuse,1,9,10,0.1
vs. FBS non-Power 5,2020,Syracuse,0,1,1,0.0
in August/September,2020,Syracuse,1,2,3,0.3333333333333333
in October,2020,Syracuse,0,4,4,0.0
in November,2020,Syracuse,0,3,3,0.0
in December/January,2020,Syracuse,0,1,1,0.0
All Games,2021,Syracuse,5,7,12,0.4166666666666667
at Home,2021,Syracuse,3,4,7,0.42857142857142855
on Road/Neutral Site,2021,Syracuse,2,3,5,0.4
vs. Conference,2021,Syracuse,2,6,8,0.25
vs. Non-Conference,2021,Syracuse,3,1,4,0.75
vs. Ranked (AP),2021,Syracuse,0,4,4,0.0
vs. Unranked (AP),2021,Syracuse,5,3,8,0.625
vs. FBS (I-A),2021,Syracuse,4,7,11,0.36363636363636365
vs. FCS (I-AA),2021,Syracuse,1,0,1,1.0
vs. FBS Winning,2021,Syracuse,1,4,5,0.2
vs. FBS Non-Winning,2021,Syracuse,3,3,6,0.5
vs. BCS AQ,2021,Syracuse,2,7,9,0.2222222222222222
vs. BCS non-AQ,2021,Syracuse,2,0,2,1.0
vs. FBS Power 5,2021,Syracuse,2,7,9,0.2222222222222222
vs. FBS non-Power 5,2021,Syracuse,2,0,2,1.0
in August/September,2021,Syracuse,3,1,4,0.75
in October,2021,Syracuse,2,3,5,0.4
in November,2021,Syracuse,0,3,3,0.0
in December/January,2021,Syracuse,0,0,0,
All Games,2022,Syracuse,7,6,13,0.5384615384615384
at Home,2022,Syracuse,5,2,7,0.7142857142857143
on Road/Neutral Site,2022,Syracuse,2,4,6,0.3333333333333333
vs. Conference,2022,Syracuse,4,4,8,0.5
vs. Non-Conference,2022,Syracuse,3,2,5,0.6
vs. Ranked (AP),2022,Syracuse,0,4,4,0.0
vs. Unranked (AP),2022,Syracuse,7,2,9,0.7777777777777778
vs. FBS (I-A),2022,Syracuse,6,6,12,0.5
vs. FCS (I-AA),2022,Syracuse,1,0,1,1.0
vs. FBS Winning,2022,Syracuse,3,6,9,0.3333333333333333
vs. FBS Non-Winning,2022,Syracuse,3,0,3,1.0
vs. BCS AQ,2022,Syracuse,5,6,11,0.45454545454545453
vs. BCS non-AQ,2022,Syracuse,1,0,1,1.0
vs. FBS Power 5,2022,Syracuse,5,5,10,0.5
vs. FBS non-Power 5,2022,Syracuse,1,1,2,0.5
in August/September,2022,Syracuse,4,0,4,1.0
in October,2022,Syracuse,2,2,4,0.5
in November,2022,Syracuse,1,3,4,0.25
in December/January,2022,Syracuse,0,1,1,0.0
All Games,2009,TCU,12,1,13,0.9230769230769231
at Home,2009,TCU,6,0,6,1.0
on Road/Neutral Site,2009,TCU,6,1,7,0.8571428571428571
vs. Conference,2009,TCU,8,0,8,1.0
vs. Non-Conference,2009,TCU,4,1,5,0.8
vs. Ranked (AP),2009,TCU,3,1,4,0.75
vs. Unranked (AP),2009,TCU,9,0,9,1.0
vs. FBS (I-A),2009,TCU,11,1,12,0.9166666666666666
vs. FCS (I-AA),2009,TCU,1,0,1,1.0
vs. FBS Winning,2009,TCU,6,1,7,0.8571428571428571
vs. FBS Non-Winning,2009,TCU,5,0,5,1.0
vs. BCS AQ,2009,TCU,2,0,2,1.0
vs. BCS non-AQ,2009,TCU,9,1,10,0.9
vs. FBS Power 5,2009,TCU,2,0,2,1.0
vs. FBS non-Power 5,2009,TCU,9,1,10,0.9
in August/September,2009,TCU,3,0,3,1.0
in October,2009,TCU,5,0,5,1.0
in November,2009,TCU,4,0,4,1.0
in December/January,2009,TCU,0,1,1,0.0
All Games,2010,TCU,13,0,13,1.0
at Home,2010,TCU,6,0,6,1.0
on Road/Neutral Site,2010,TCU,7,0,7,1.0
vs. Conference,2010,TCU,8,0,8,1.0
vs. Non-Conference,2010,TCU,5,0,5,1.0
vs. Ranked (AP),2010,TCU,1,0,1,1.0
vs. Unranked (AP),2010,TCU,12,0,12,1.0
vs. FBS (I-A),2010,TCU,12,0,12,1.0
vs. FCS (I-AA),2010,TCU,1,0,1,1.0
vs. FBS Winning,2010,TCU,6,0,6,1.0
vs. FBS Non-Winning,2010,TCU,6,0,6,1.0
vs. BCS AQ,2010,TCU,3,0,3,1.0
vs. BCS non-AQ,2010,TCU,9,0,9,1.0
vs. FBS Power 5,2010,TCU,3,0,3,1.0
vs. FBS non-Power 5,2010,TCU,9,0,9,1.0
in August/September,2010,TCU,4,0,4,1.0
in October,2010,TCU,5,0,5,1.0
in November,2010,TCU,3,0,3,1.0
in December/January,2010,TCU,1,0,1,1.0
All Games,2011,TCU,11,2,13,0.8461538461538461
at Home,2011,TCU,5,1,6,0.8333333333333334
on Road/Neutral Site,2011,TCU,6,1,7,0.8571428571428571
vs. Conference,2011,TCU,7,0,7,1.0
vs. Non-Conference,2011,TCU,4,2,6,0.6666666666666666
vs. Ranked (AP),2011,TCU,1,1,2,0.5
vs. Unranked (AP),2011,TCU,10,1,11,0.9090909090909091
vs. FBS (I-A),2011,TCU,10,2,12,0.8333333333333334
vs. FCS (I-AA),2011,TCU,1,0,1,1.0
vs. FBS Winning,2011,TCU,6,2,8,0.75
vs. FBS Non-Winning,2011,TCU,4,0,4,1.0
vs. BCS AQ,2011,TCU,0,1,1,0.0
vs. BCS non-AQ,2011,TCU,10,1,11,0.9090909090909091
vs. FBS Power 5,2011,TCU,0,1,1,0.0
vs. FBS non-Power 5,2011,TCU,10,1,11,0.9090909090909091
in August/September,2011,TCU,3,1,4,0.75
in October,2011,TCU,3,1,4,0.75
in November,2011,TCU,3,0,3,1.0
in December/January,2011,TCU,2,0,2,1.0
All Games,2012,TCU,7,6,13,0.5384615384615384
at Home,2012,TCU,2,4,6,0.3333333333333333
on Road/Neutral Site,2012,TCU,5,2,7,0.7142857142857143
vs. Conference,2012,TCU,4,5,9,0.4444444444444444
vs. Non-Conference,2012,TCU,3,1,4,0.75
vs. Ranked (AP),2012,TCU,1,2,3,0.3333333333333333
vs. Unranked (AP),2012,TCU,6,4,10,0.6
vs. FBS (I-A),2012,TCU,6,6,12,0.5
vs. FCS (I-AA),2012,TCU,1,0,1,1.0
vs. FBS Winning,2012,TCU,4,5,9,0.4444444444444444
vs. FBS Non-Winning,2012,TCU,2,1,3,0.6666666666666666
vs. BCS AQ,2012,TCU,5,6,11,0.45454545454545453
vs. BCS non-AQ,2012,TCU,1,0,1,1.0
vs. FBS Power 5,2012,TCU,5,6,11,0.45454545454545453
vs. FBS non-Power 5,2012,TCU,1,0,1,1.0
in August/September,2012,TCU,4,0,4,1.0
in October,2012,TCU,1,3,4,0.25
in November,2012,TCU,2,1,3,0.6666666666666666
in December/January,2012,TCU,0,2,2,0.0
All Games,2013,TCU,4,8,12,0.3333333333333333
at Home,2013,TCU,3,3,6,0.5
on Road/Neutral Site,2013,TCU,1,5,6,0.16666666666666666
vs. Conference,2013,TCU,2,7,9,0.2222222222222222
vs. Non-Conference,2013,TCU,2,1,3,0.6666666666666666
vs. Ranked (AP),2013,TCU,0,4,4,0.0
vs. Unranked (AP),2013,TCU,4,4,8,0.5
vs. FBS (I-A),2013,TCU,3,8,11,0.2727272727272727
vs. FCS (I-AA),2013,TCU,1,0,1,1.0
vs. FBS Winning,2013,TCU,0,7,7,0.0
vs. FBS Non-Winning,2013,TCU,3,1,4,0.75
vs. BCS AQ,2013,TCU,3,8,11,0.2727272727272727
vs. BCS non-AQ,2013,TCU,0,0,0,
vs. FBS Power 5,2013,TCU,2,8,10,0.2
vs. FBS non-Power 5,2013,TCU,1,0,1,1.0
in August/September,2013,TCU,2,2,4,0.5
in October,2013,TCU,1,3,4,0.25
in November,2013,TCU,1,3,4,0.25
in December/January,2013,TCU,0,0,0,
All Games,2014,TCU,12,1,13,0.9230769230769231
at Home,2014,TCU,7,0,7,1.0
on Road/Neutral Site,2014,TCU,5,1,6,0.8333333333333334
vs. Conference,2014,TCU,8,1,9,0.8888888888888888
vs. Non-Conference,2014,TCU,4,0,4,1.0
vs. Ranked (AP),2014,TCU,2,1,3,0.6666666666666666
vs. Unranked (AP),2014,TCU,10,0,10,1.0
vs. FBS (I-A),2014,TCU,11,1,12,0.9166666666666666
vs. FCS (I-AA),2014,TCU,1,0,1,1.0
vs. FBS Winning,2014,TCU,6,1,7,0.8571428571428571
vs. FBS Non-Winning,2014,TCU,5,0,5,1.0
vs. BCS AQ,2014,TCU,11,1,12,0.9166666666666666
vs. BCS non-AQ,2014,TCU,0,0,0,
vs. FBS Power 5,2014,TCU,10,1,11,0.9090909090909091
vs. FBS non-Power 5,2014,TCU,1,0,1,1.0
in August/September,2014,TCU,3,0,3,1.0
in October,2014,TCU,3,1,4,0.75
in November,2014,TCU,4,0,4,1.0
in December/January,2014,TCU,2,0,2,1.0
All Games,2015,TCU,11,2,13,0.8461538461538461
at Home,2015,TCU,6,0,6,1.0
on Road/Neutral Site,2015,TCU,5,2,7,0.7142857142857143
vs. Conference,2015,TCU,7,2,9,0.7777777777777778
vs. Non-Conference,2015,TCU,4,0,4,1.0
vs. Ranked (AP),2015,TCU,2,2,4,0.5
vs. Unranked (AP),2015,TCU,9,0,9,1.0
vs. FBS (I-A),2015,TCU,10,2,12,0.8333333333333334
vs. FCS (I-AA),2015,TCU,1,0,1,1.0
vs. FBS Winning,2015,TCU,4,2,6,0.6666666666666666
vs. FBS Non-Winning,2015,TCU,6,0,6,1.0
vs. BCS AQ,2015,TCU,10,2,12,0.8333333333333334
vs. BCS non-AQ,2015,TCU,0,0,0,
vs. FBS Power 5,2015,TCU,9,2,11,0.8181818181818182
vs. FBS non-Power 5,2015,TCU,1,0,1,1.0
in August/September,2015,TCU,4,0,4,1.0
in October,2015,TCU,4,0,4,1.0
in November,2015,TCU,2,2,4,0.5
in December/January,2015,TCU,1,0,1,1.0
All Games,2016,TCU,6,7,13,0.46153846153846156
at Home,2016,TCU,2,5,7,0.2857142857142857
on Road/Neutral Site,2016,TCU,4,2,6,0.6666666666666666
vs. Conference,2016,TCU,4,5,9,0.4444444444444444
vs. Non-Conference,2016,TCU,2,2,4,0.5
vs. Ranked (AP),2016,TCU,0,3,3,0.0
vs. Unranked (AP),2016,TCU,6,4,10,0.6
vs. FBS (I-A),2016,TCU,5,7,12,0.4166666666666667
vs. FCS (I-AA),2016,TCU,1,0,1,1.0
vs. FBS Winning,2016,TCU,1,6,7,0.14285714285714285
vs. FBS Non-Winning,2016,TCU,4,1,5,0.8
vs. BCS AQ,2016,TCU,5,7,12,0.4166666666666667
vs. BCS non-AQ,2016,TCU,0,0,0,
vs. FBS Power 5,2016,TCU,4,7,11,0.36363636363636365
vs. FBS non-Power 5,2016,TCU,1,0,1,1.0
in August/September,2016,TCU,3,1,4,0.75
in October,2016,TCU,1,3,4,0.25
in November,2016,TCU,2,1,3,0.6666666666666666
in December/January,2016,TCU,0,2,2,0.0
All Games,2017,TCU,11,3,14,0.7857142857142857
at Home,2017,TCU,6,0,6,1.0
on Road/Neutral Site,2017,TCU,5,3,8,0.625
vs. Conference,2017,TCU,7,3,10,0.7
vs. Non-Conference,2017,TCU,4,0,4,1.0
vs. Ranked (AP),2017,TCU,2,2,4,0.5
vs. Unranked (AP),2017,TCU,9,1,10,0.9
vs. FBS (I-A),2017,TCU,10,3,13,0.7692307692307693
vs. FCS (I-AA),2017,TCU,1,0,1,1.0
vs. FBS Winning,2017,TCU,6,3,9,0.6666666666666666
vs. FBS Non-Winning,2017,TCU,4,0,4,1.0
vs. BCS AQ,2017,TCU,10,3,13,0.7692307692307693
vs. BCS non-AQ,2017,TCU,0,0,0,
vs. FBS Power 5,2017,TCU,9,3,12,0.75
vs. FBS non-Power 5,2017,TCU,1,0,1,1.0
in August/September,2017,TCU,4,0,4,1.0
in October,2017,TCU,3,1,4,0.75
in November,2017,TCU,3,1,4,0.75
in December/January,2017,TCU,1,1,2,0.5
All Games,2018,TCU,7,6,13,0.5384615384615384
at Home,2018,TCU,4,2,6,0.6666666666666666
on Road/Neutral Site,2018,TCU,3,4,7,0.42857142857142855
vs. Conference,2018,TCU,4,5,9,0.4444444444444444
vs. Non-Conference,2018,TCU,3,1,4,0.75
vs. Ranked (AP),2018,TCU,0,4,4,0.0
vs. Unranked (AP),2018,TCU,7,2,9,0.7777777777777778
vs. FBS (I-A),2018,TCU,6,6,12,0.5
vs. FCS (I-AA),2018,TCU,1,0,1,1.0
vs. FBS Winning,2018,TCU,4,4,8,0.5
vs. FBS Non-Winning,2018,TCU,2,2,4,0.5
vs. BCS AQ,2018,TCU,6,6,12,0.5
vs. BCS non-AQ,2018,TCU,0,0,0,
vs. FBS Power 5,2018,TCU,5,6,11,0.45454545454545453
vs. FBS non-Power 5,2018,TCU,1,0,1,1.0
in August/September,2018,TCU,3,2,5,0.6
in October,2018,TCU,0,3,3,0.0
in November,2018,TCU,3,1,4,0.75
in December/January,2018,TCU,1,0,1,1.0
All Games,2019,TCU,5,7,12,0.4166666666666667
at Home,2019,TCU,3,3,6,0.5
on Road/Neutral Site,2019,TCU,2,4,6,0.3333333333333333
vs. Conference,2019,TCU,3,6,9,0.3333333333333333
vs. Non-Conference,2019,TCU,2,1,3,0.6666666666666666
vs. Ranked (AP),2019,TCU,1,2,3,0.3333333333333333
vs. Unranked (AP),2019,TCU,4,5,9,0.4444444444444444
vs. FBS (I-A),2019,TCU,4,7,11,0.36363636363636365
vs. FCS (I-AA),2019,TCU,1,0,1,1.0
vs. FBS Winning,2019,TCU,1,6,7,0.14285714285714285
vs. FBS Non-Winning,2019,TCU,3,1,4,0.75
vs. BCS AQ,2019,TCU,4,7,11,0.36363636363636365
vs. BCS non-AQ,2019,TCU,0,0,0,
vs. FBS Power 5,2019,TCU,4,6,10,0.4
vs. FBS non-Power 5,2019,TCU,0,1,1,0.0
in August/September,2019,TCU,3,1,4,0.75
in October,2019,TCU,1,2,3,0.3333333333333333
in November,2019,TCU,1,4,5,0.2
in December/January,2019,TCU,0,0,0,
All Games,2020,TCU,6,4,10,0.6
at Home,2020,TCU,3,3,6,0.5
on Road/Neutral Site,2020,TCU,3,1,4,0.75
vs. Conference,2020,TCU,5,4,9,0.5555555555555556
vs. Non-Conference,2020,TCU,1,0,1,1.0
vs. Ranked (AP),2020,TCU,1,2,3,0.3333333333333333
vs. Unranked (AP),2020,TCU,5,2,7,0.7142857142857143
vs. FBS (I-A),2020,TCU,6,4,10,0.6
vs. FCS (I-AA),2020,TCU,0,0,0,
vs. FBS Winning,2020,TCU,2,3,5,0.4
vs. FBS Non-Winning,2020,TCU,4,1,5,0.8
vs. BCS AQ,2020,TCU,5,4,9,0.5555555555555556
vs. BCS non-AQ,2020,TCU,1,0,1,1.0
vs. FBS Power 5,2020,TCU,5,4,9,0.5555555555555556
vs. FBS non-Power 5,2020,TCU,1,0,1,1.0
in August/September,2020,TCU,0,1,1,0.0
in October,2020,TCU,2,2,4,0.5
in November,2020,TCU,2,1,3,0.6666666666666666
in December/January,2020,TCU,2,0,2,1.0
All Games,2021,TCU,5,7,12,0.4166666666666667
at Home,2021,TCU,4,3,7,0.5714285714285714
on Road/Neutral Site,2021,TCU,1,4,5,0.2
vs. Conference,2021,TCU,3,6,9,0.3333333333333333
vs. Non-Conference,2021,TCU,2,1,3,0.6666666666666666
vs. Ranked (AP),2021,TCU,1,2,3,0.3333333333333333
vs. Unranked (AP),2021,TCU,4,5,9,0.4444444444444444
vs. FBS (I-A),2021,TCU,4,7,11,0.36363636363636365
vs. FCS (I-AA),2021,TCU,1,0,1,1.0
vs. FBS Winning,2021,TCU,2,5,7,0.2857142857142857
vs. FBS Non-Winning,2021,TCU,2,2,4,0.5
vs. BCS AQ,2021,TCU,4,7,11,0.36363636363636365
vs. BCS non-AQ,2021,TCU,0,0,0,
vs. FBS Power 5,2021,TCU,4,6,10,0.4
vs. FBS non-Power 5,2021,TCU,0,1,1,0.0
in August/September,2021,TCU,2,1,3,0.6666666666666666
in October,2021,TCU,1,4,5,0.2
in November,2021,TCU,2,2,4,0.5
in December/January,2021,TCU,0,0,0,
All Games,2022,TCU,13,2,15,0.8666666666666667
at Home,2022,TCU,6,0,6,1.0
on Road/Neutral Site,2022,TCU,7,2,9,0.7777777777777778
vs. Conference,2022,TCU,9,1,10,0.9
vs. Non-Conference,2022,TCU,4,1,5,0.8
vs. Ranked (AP),2022,TCU,3,2,5,0.6
vs. Unranked (AP),2022,TCU,10,0,10,1.0
vs. FBS (I-A),2022,TCU,12,2,14,0.8571428571428571
vs. FCS (I-AA),2022,TCU,1,0,1,1.0
vs. FBS Winning,2022,TCU,6,2,8,0.75
vs. FBS Non-Winning,2022,TCU,6,0,6,1.0
vs. BCS AQ,2022,TCU,12,2,14,0.8571428571428571
vs. BCS non-AQ,2022,TCU,0,0,0,
vs. FBS Power 5,2022,TCU,11,2,13,0.8461538461538461
vs. FBS non-Power 5,2022,TCU,1,0,1,1.0
in August/September,2022,TCU,3,0,3,1.0
in October,2022,TCU,5,0,5,1.0
in November,2022,TCU,4,0,4,1.0
in December/January,2022,TCU,1,2,3,0.3333333333333333
All Games,2009,Temple,9,4,13,0.6923076923076923
at Home,2009,Temple,5,1,6,0.8333333333333334
on Road/Neutral Site,2009,Temple,4,3,7,0.5714285714285714
vs. Conference,2009,Temple,7,1,8,0.875
vs. Non-Conference,2009,Temple,2,3,5,0.4
vs. Ranked (AP),2009,Temple,0,1,1,0.0
vs. Unranked (AP),2009,Temple,9,3,12,0.75
vs. FBS (I-A),2009,Temple,9,3,12,0.75
vs. FCS (I-AA),2009,Temple,0,1,1,0.0
vs. FBS Winning,2009,Temple,1,3,4,0.25
vs. FBS Non-Winning,2009,Temple,8,0,8,1.0
vs. BCS AQ,2009,Temple,0,2,2,0.0
vs. BCS non-AQ,2009,Temple,9,1,10,0.9
vs. FBS Power 5,2009,Temple,0,2,2,0.0
vs. FBS non-Power 5,2009,Temple,9,1,10,0.9
in August/September,2009,Temple,1,2,3,0.3333333333333333
in October,2009,Temple,5,0,5,1.0
in November,2009,Temple,3,1,4,0.75
in December/January,2009,Temple,0,1,1,0.0
All Games,2010,Temple,8,4,12,0.6666666666666666
at Home,2010,Temple,5,1,6,0.8333333333333334
on Road/Neutral Site,2010,Temple,3,3,6,0.5
vs. Conference,2010,Temple,5,3,8,0.625
vs. Non-Conference,2010,Temple,3,1,4,0.75
vs. Ranked (AP),2010,Temple,0,0,0,
vs. Unranked (AP),2010,Temple,8,4,12,0.6666666666666666
vs. FBS (I-A),2010,Temple,7,4,11,0.6363636363636364
vs. FCS (I-AA),2010,Temple,1,0,1,1.0
vs. FBS Winning,2010,Temple,2,4,6,0.3333333333333333
vs. FBS Non-Winning,2010,Temple,5,0,5,1.0
vs. BCS AQ,2010,Temple,1,1,2,0.5
vs. BCS non-AQ,2010,Temple,6,3,9,0.6666666666666666
vs. FBS Power 5,2010,Temple,0,1,1,0.0
vs. FBS non-Power 5,2010,Temple,7,3,10,0.7
in August/September,2010,Temple,3,1,4,0.75
in October,2010,Temple,4,1,5,0.8
in November,2010,Temple,1,2,3,0.3333333333333333
in December/January,2010,Temple,0,0,0,
All Games,2011,Temple,9,4,13,0.6923076923076923
at Home,2011,Temple,5,2,7,0.7142857142857143
on Road/Neutral Site,2011,Temple,4,2,6,0.6666666666666666
vs. Conference,2011,Temple,5,3,8,0.625
vs. Non-Conference,2011,Temple,4,1,5,0.8
vs. Ranked (AP),2011,Temple,0,0,0,
vs. Unranked (AP),2011,Temple,9,4,13,0.6923076923076923
vs. FBS (I-A),2011,Temple,8,4,12,0.6666666666666666
vs. FCS (I-AA),2011,Temple,1,0,1,1.0
vs. FBS Winning,2011,Temple,1,3,4,0.25
vs. FBS Non-Winning,2011,Temple,7,1,8,0.875
vs. BCS AQ,2011,Temple,1,1,2,0.5
vs. BCS non-AQ,2011,Temple,7,3,10,0.7
vs. FBS Power 5,2011,Temple,1,1,2,0.5
vs. FBS non-Power 5,2011,Temple,7,3,10,0.7
in August/September,2011,Temple,3,1,4,0.75
in October,2011,Temple,2,2,4,0.5
in November,2011,Temple,3,1,4,0.75
in December/January,2011,Temple,1,0,1,1.0
All Games,2012,Temple,4,7,11,0.36363636363636365
at Home,2012,Temple,2,4,6,0.3333333333333333
on Road/Neutral Site,2012,Temple,2,3,5,0.4
vs. Conference,2012,Temple,2,5,7,0.2857142857142857
vs. Non-Conference,2012,Temple,2,2,4,0.5
vs. Ranked (AP),2012,Temple,0,1,1,0.0
vs. Unranked (AP),2012,Temple,4,6,10,0.4
vs. FBS (I-A),2012,Temple,3,7,10,0.3
vs. FCS (I-AA),2012,Temple,1,0,1,1.0
vs. FBS Winning,2012,Temple,0,5,5,0.0
vs. FBS Non-Winning,2012,Temple,3,2,5,0.6
vs. BCS AQ,2012,Temple,2,7,9,0.2222222222222222
vs. BCS non-AQ,2012,Temple,1,0,1,1.0
vs. FBS Power 5,2012,Temple,0,2,2,0.0
vs. FBS non-Power 5,2012,Temple,3,5,8,0.375
in August/September,2012,Temple,1,2,3,0.3333333333333333
in October,2012,Temple,2,2,4,0.5
in November,2012,Temple,1,3,4,0.25
in December/January,2012,Temple,0,0,0,
All Games,2013,Temple,2,10,12,0.16666666666666666
at Home,2013,Temple,1,5,6,0.16666666666666666
on Road/Neutral Site,2013,Temple,1,5,6,0.16666666666666666
vs. Conference,2013,Temple,1,7,8,0.125
vs. Non-Conference,2013,Temple,1,3,4,0.25
vs. Ranked (AP),2013,Temple,0,3,3,0.0
vs. Unranked (AP),2013,Temple,2,7,9,0.2222222222222222
vs. FBS (I-A),2013,Temple,2,9,11,0.18181818181818182
vs. FCS (I-AA),2013,Temple,0,1,1,0.0
vs. FBS Winning,2013,Temple,0,5,5,0.0
vs. FBS Non-Winning,2013,Temple,2,4,6,0.3333333333333333
vs. BCS AQ,2013,Temple,1,8,9,0.1111111111111111
vs. BCS non-AQ,2013,Temple,1,1,2,0.5
vs. FBS Power 5,2013,Temple,0,0,0,
vs. FBS non-Power 5,2013,Temple,2,9,11,0.18181818181818182
in August/September,2013,Temple,0,4,4,0.0
in October,2013,Temple,1,3,4,0.25
in November,2013,Temple,1,3,4,0.25
in December/January,2013,Temple,0,0,0,
All Games,2014,Temple,6,6,12,0.5
at Home,2014,Temple,3,3,6,0.5
on Road/Neutral Site,2014,Temple,3,3,6,0.5
vs. Conference,2014,Temple,4,4,8,0.5
vs. Non-Conference,2014,Temple,2,2,4,0.5
vs. Ranked (AP),2014,Temple,0,1,1,0.0
vs. Unranked (AP),2014,Temple,6,5,11,0.5454545454545454
vs. FBS (I-A),2014,Temple,5,6,11,0.45454545454545453
vs. FCS (I-AA),2014,Temple,1,0,1,1.0
vs. FBS Winning,2014,Temple,1,6,7,0.14285714285714285
vs. FBS Non-Winning,2014,Temple,4,0,4,1.0
vs. BCS AQ,2014,Temple,5,5,10,0.5
vs. BCS non-AQ,2014,Temple,0,1,1,0.0
vs. FBS Power 5,2014,Temple,1,1,2,0.5
vs. FBS non-Power 5,2014,Temple,4,5,9,0.4444444444444444
in August/September,2014,Temple,3,1,4,0.75
in October,2014,Temple,1,2,3,0.3333333333333333
in November,2014,Temple,1,3,4,0.25
in December/January,2014,Temple,1,0,1,1.0
All Games,2015,Temple,10,4,14,0.7142857142857143
at Home,2015,Temple,5,1,6,0.8333333333333334
on Road/Neutral Site,2015,Temple,5,3,8,0.625
vs. Conference,2015,Temple,7,2,9,0.7777777777777778
vs. Non-Conference,2015,Temple,3,2,5,0.6
vs. Ranked (AP),2015,Temple,0,2,2,0.0
vs. Unranked (AP),2015,Temple,10,2,12,0.8333333333333334
vs. FBS (I-A),2015,Temple,10,4,14,0.7142857142857143
vs. FCS (I-AA),2015,Temple,0,0,0,
vs. FBS Winning,2015,Temple,3,4,7,0.42857142857142855
vs. FBS Non-Winning,2015,Temple,7,0,7,1.0
vs. BCS AQ,2015,Temple,8,3,11,0.7272727272727273
vs. BCS non-AQ,2015,Temple,2,1,3,0.6666666666666666
vs. FBS Power 5,2015,Temple,1,0,1,1.0
vs. FBS non-Power 5,2015,Temple,9,4,13,0.6923076923076923
in August/September,2015,Temple,3,0,3,1.0
in October,2015,Temple,4,1,5,0.8
in November,2015,Temple,3,1,4,0.75
in December/January,2015,Temple,0,2,2,0.0
All Games,2016,Temple,10,4,14,0.7142857142857143
at Home,2016,Temple,6,1,7,0.8571428571428571
on Road/Neutral Site,2016,Temple,4,3,7,0.5714285714285714
vs. Conference,2016,Temple,8,1,9,0.8888888888888888
vs. Non-Conference,2016,Temple,2,3,5,0.4
vs. Ranked (AP),2016,Temple,1,1,2,0.5
vs. Unranked (AP),2016,Temple,9,3,12,0.75
vs. FBS (I-A),2016,Temple,9,4,13,0.6923076923076923
vs. FCS (I-AA),2016,Temple,1,0,1,1.0
vs. FBS Winning,2016,Temple,2,4,6,0.3333333333333333
vs. FBS Non-Winning,2016,Temple,7,0,7,1.0
vs. BCS AQ,2016,Temple,8,3,11,0.7272727272727273
vs. BCS non-AQ,2016,Temple,1,1,2,0.5
vs. FBS Power 5,2016,Temple,0,2,2,0.0
vs. FBS non-Power 5,2016,Temple,9,2,11,0.8181818181818182
in August/September,2016,Temple,2,2,4,0.5
in October,2016,Temple,4,1,5,0.8
in November,2016,Temple,3,0,3,1.0
in December/January,2016,Temple,1,1,2,0.5
All Games,2017,Temple,7,6,13,0.5384615384615384
at Home,2017,Temple,3,3,6,0.5
on Road/Neutral Site,2017,Temple,4,3,7,0.5714285714285714
vs. Conference,2017,Temple,4,4,8,0.5
vs. Non-Conference,2017,Temple,3,2,5,0.6
vs. Ranked (AP),2017,Temple,0,3,3,0.0
vs. Unranked (AP),2017,Temple,7,3,10,0.7
vs. FBS (I-A),2017,Temple,6,6,12,0.5
vs. FCS (I-AA),2017,Temple,1,0,1,1.0
vs. FBS Winning,2017,Temple,2,5,7,0.2857142857142857
vs. FBS Non-Winning,2017,Temple,4,1,5,0.8
vs. BCS AQ,2017,Temple,4,5,9,0.4444444444444444
vs. BCS non-AQ,2017,Temple,2,1,3,0.6666666666666666
vs. FBS Power 5,2017,Temple,0,0,0,
vs. FBS non-Power 5,2017,Temple,6,6,12,0.5
in August/September,2017,Temple,2,3,5,0.4
in October,2017,Temple,1,2,3,0.3333333333333333
in November,2017,Temple,3,1,4,0.75
in December/January,2017,Temple,1,0,1,1.0
All Games,2018,Temple,8,5,13,0.6153846153846154
at Home,2018,Temple,4,2,6,0.6666666666666666
on Road/Neutral Site,2018,Temple,4,3,7,0.5714285714285714
vs. Conference,2018,Temple,7,1,8,0.875
vs. Non-Conference,2018,Temple,1,4,5,0.2
vs. Ranked (AP),2018,Temple,1,1,2,0.5
vs. Unranked (AP),2018,Temple,7,4,11,0.6363636363636364
vs. FBS (I-A),2018,Temple,8,4,12,0.6666666666666666
vs. FCS (I-AA),2018,Temple,0,1,1,0.0
vs. FBS Winning,2018,Temple,3,4,7,0.42857142857142855
vs. FBS Non-Winning,2018,Temple,5,0,5,1.0
vs. BCS AQ,2018,Temple,8,3,11,0.7272727272727273
vs. BCS non-AQ,2018,Temple,0,1,1,0.0
vs. FBS Power 5,2018,Temple,1,2,3,0.3333333333333333
vs. FBS non-Power 5,2018,Temple,7,2,9,0.7777777777777778
in August/September,2018,Temple,2,3,5,0.4
in October,2018,Temple,3,0,3,1.0
in November,2018,Temple,3,1,4,0.75
in December/January,2018,Temple,0,1,1,0.0
All Games,2019,Temple,8,5,13,0.6153846153846154
at Home,2019,Temple,6,1,7,0.8571428571428571
on Road/Neutral Site,2019,Temple,2,4,6,0.3333333333333333
vs. Conference,2019,Temple,5,3,8,0.625
vs. Non-Conference,2019,Temple,3,2,5,0.6
vs. Ranked (AP),2019,Temple,1,2,3,0.3333333333333333
vs. Unranked (AP),2019,Temple,7,3,10,0.7
vs. FBS (I-A),2019,Temple,7,5,12,0.5833333333333334
vs. FCS (I-AA),2019,Temple,1,0,1,1.0
vs. FBS Winning,2019,Temple,2,5,7,0.2857142857142857
vs. FBS Non-Winning,2019,Temple,5,0,5,1.0
vs. BCS AQ,2019,Temple,7,4,11,0.6363636363636364
vs. BCS non-AQ,2019,Temple,0,1,1,0.0
vs. FBS Power 5,2019,Temple,2,1,3,0.6666666666666666
vs. FBS non-Power 5,2019,Temple,5,4,9,0.5555555555555556
in August/September,2019,Temple,3,1,4,0.75
in October,2019,Temple,2,2,4,0.5
in November,2019,Temple,3,1,4,0.75
in December/January,2019,Temple,0,1,1,0.0
All Games,2020,Temple,1,6,7,0.14285714285714285
at Home,2020,Temple,1,2,3,0.3333333333333333
on Road/Neutral Site,2020,Temple,0,4,4,0.0
vs. Conference,2020,Temple,1,6,7,0.14285714285714285
vs. Non-Conference,2020,Temple,0,0,0,
vs. Ranked (AP),2020,Temple,0,0,0,
vs. Unranked (AP),2020,Temple,1,6,7,0.14285714285714285
vs. FBS (I-A),2020,Temple,1,6,7,0.14285714285714285
vs. FCS (I-AA),2020,Temple,0,0,0,
vs. FBS Winning,2020,Temple,0,3,3,0.0
vs. FBS Non-Winning,2020,Temple,1,3,4,0.25
vs. BCS AQ,2020,Temple,1,6,7,0.14285714285714285
vs. BCS non-AQ,2020,Temple,0,0,0,
vs. FBS Power 5,2020,Temple,0,0,0,
vs. FBS non-Power 5,2020,Temple,1,6,7,0.14285714285714285
in August/September,2020,Temple,0,0,0,
in October,2020,Temple,1,3,4,0.25
in November,2020,Temple,0,3,3,0.0
in December/January,2020,Temple,0,0,0,
All Games,2021,Temple,3,9,12,0.25
at Home,2021,Temple,2,4,6,0.3333333333333333
on Road/Neutral Site,2021,Temple,1,5,6,0.16666666666666666
vs. Conference,2021,Temple,1,7,8,0.125
vs. Non-Conference,2021,Temple,2,2,4,0.5
vs. Ranked (AP),2021,Temple,0,2,2,0.0
vs. Unranked (AP),2021,Temple,3,7,10,0.3
vs. FBS (I-A),2021,Temple,2,9,11,0.18181818181818182
vs. FCS (I-AA),2021,Temple,1,0,1,1.0
vs. FBS Winning,2021,Temple,0,5,5,0.0
vs. FBS Non-Winning,2021,Temple,2,4,6,0.3333333333333333
vs. BCS AQ,2021,Temple,1,9,10,0.1
vs. BCS non-AQ,2021,Temple,1,0,1,1.0
vs. FBS Power 5,2021,Temple,0,2,2,0.0
vs. FBS non-Power 5,2021,Temple,2,7,9,0.2222222222222222
in August/September,2021,Temple,2,2,4,0.5
in October,2021,Temple,1,3,4,0.25
in November,2021,Temple,0,4,4,0.0
in December/January,2021,Temple,0,0,0,
All Games,2022,Temple,3,9,12,0.25
at Home,2022,Temple,3,4,7,0.42857142857142855
on Road/Neutral Site,2022,Temple,0,5,5,0.0
vs. Conference,2022,Temple,1,7,8,0.125
vs. Non-Conference,2022,Temple,2,2,4,0.5
vs. Ranked (AP),2022,Temple,0,0,0,
vs. Unranked (AP),2022,Temple,3,9,12,0.25
vs. FBS (I-A),2022,Temple,2,9,11,0.18181818181818182
vs. FCS (I-AA),2022,Temple,1,0,1,1.0
vs. FBS Winning,2022,Temple,0,6,6,0.0
vs. FBS Non-Winning,2022,Temple,2,3,5,0.4
vs. BCS AQ,2022,Temple,1,9,10,0.1
vs. BCS non-AQ,2022,Temple,1,0,1,1.0
vs. FBS Power 5,2022,Temple,0,2,2,0.0
vs. FBS non-Power 5,2022,Temple,2,7,9,0.2222222222222222
in August/September,2022,Temple,2,2,4,0.5
in October,2022,Temple,0,4,4,0.0
in November,2022,Temple,1,3,4,0.25
in December/January,2022,Temple,0,0,0,
All Games,2009,Tennessee,7,6,13,0.5384615384615384
at Home,2009,Tennessee,6,2,8,0.75
on Road/Neutral Site,2009,Tennessee,1,4,5,0.2
vs. Conference,2009,Tennessee,4,4,8,0.5
vs. Non-Conference,2009,Tennessee,3,2,5,0.6
vs. Ranked (AP),2009,Tennessee,0,4,4,0.0
vs. Unranked (AP),2009,Tennessee,7,2,9,0.7777777777777778
vs. FBS (I-A),2009,Tennessee,7,6,13,0.5384615384615384
vs. FCS (I-AA),2009,Tennessee,0,0,0,
vs. FBS Winning,2009,Tennessee,4,6,10,0.4
vs. FBS Non-Winning,2009,Tennessee,3,0,3,1.0
vs. BCS AQ,2009,Tennessee,4,6,10,0.4
vs. BCS non-AQ,2009,Tennessee,3,0,3,1.0
vs. FBS Power 5,2009,Tennessee,4,6,10,0.4
vs. FBS non-Power 5,2009,Tennessee,3,0,3,1.0
in August/September,2009,Tennessee,2,2,4,0.5
in October,2009,Tennessee,2,2,4,0.5
in November,2009,Tennessee,3,1,4,0.75
in December/January,2009,Tennessee,0,1,1,0.0
All Games,2010,Tennessee,6,7,13,0.46153846153846156
at Home,2010,Tennessee,4,3,7,0.5714285714285714
on Road/Neutral Site,2010,Tennessee,2,4,6,0.3333333333333333
vs. Conference,2010,Tennessee,3,5,8,0.375
vs. Non-Conference,2010,Tennessee,3,2,5,0.6
vs. Ranked (AP),2010,Tennessee,0,4,4,0.0
vs. Unranked (AP),2010,Tennessee,6,3,9,0.6666666666666666
vs. FBS (I-A),2010,Tennessee,5,7,12,0.4166666666666667
vs. FCS (I-AA),2010,Tennessee,1,0,1,1.0
vs. FBS Winning,2010,Tennessee,0,6,6,0.0
vs. FBS Non-Winning,2010,Tennessee,5,1,6,0.8333333333333334
vs. BCS AQ,2010,Tennessee,3,7,10,0.3
vs. BCS non-AQ,2010,Tennessee,2,0,2,1.0
vs. FBS Power 5,2010,Tennessee,3,7,10,0.3
vs. FBS non-Power 5,2010,Tennessee,2,0,2,1.0
in August/September,2010,Tennessee,2,2,4,0.5
in October,2010,Tennessee,0,4,4,0.0
in November,2010,Tennessee,4,0,4,1.0
in December/January,2010,Tennessee,0,1,1,0.0
All Games,2011,Tennessee,5,7,12,0.4166666666666667
at Home,2011,Tennessee,5,3,8,0.625
on Road/Neutral Site,2011,Tennessee,0,4,4,0.0
vs. Conference,2011,Tennessee,1,7,8,0.125
vs. Non-Conference,2011,Tennessee,4,0,4,1.0
vs. Ranked (AP),2011,Tennessee,1,5,6,0.16666666666666666
vs. Unranked (AP),2011,Tennessee,4,2,6,0.6666666666666666
vs. FBS (I-A),2011,Tennessee,4,7,11,0.36363636363636365
vs. FCS (I-AA),2011,Tennessee,1,0,1,1.0
vs. FBS Winning,2011,Tennessee,1,6,7,0.14285714285714285
vs. FBS Non-Winning,2011,Tennessee,3,1,4,0.75
vs. BCS AQ,2011,Tennessee,2,7,9,0.2222222222222222
vs. BCS non-AQ,2011,Tennessee,2,0,2,1.0
vs. FBS Power 5,2011,Tennessee,1,7,8,0.125
vs. FBS non-Power 5,2011,Tennessee,3,0,3,1.0
in August/September,2011,Tennessee,2,1,3,0.6666666666666666
in October,2011,Tennessee,1,4,5,0.2
in November,2011,Tennessee,2,2,4,0.5
in December/January,2011,Tennessee,0,0,0,
All Games,2012,Tennessee,5,7,12,0.4166666666666667
at Home,2012,Tennessee,4,3,7,0.5714285714285714
on Road/Neutral Site,2012,Tennessee,1,4,5,0.2
vs. Conference,2012,Tennessee,1,7,8,0.125
vs. Non-Conference,2012,Tennessee,4,0,4,1.0
vs. Ranked (AP),2012,Tennessee,0,5,5,0.0
vs. Unranked (AP),2012,Tennessee,5,2,7,0.7142857142857143
vs. FBS (I-A),2012,Tennessee,4,7,11,0.36363636363636365
vs. FCS (I-AA),2012,Tennessee,1,0,1,1.0
vs. FBS Winning,2012,Tennessee,1,6,7,0.14285714285714285
vs. FBS Non-Winning,2012,Tennessee,3,1,4,0.75
vs. BCS AQ,2012,Tennessee,2,7,9,0.2222222222222222
vs. BCS non-AQ,2012,Tennessee,2,0,2,1.0
vs. FBS Power 5,2012,Tennessee,2,7,9,0.2222222222222222
vs. FBS non-Power 5,2012,Tennessee,2,0,2,1.0
in August/September,2012,Tennessee,3,2,5,0.6
in October,2012,Tennessee,0,3,3,0.0
in November,2012,Tennessee,2,2,4,0.5
in December/January,2012,Tennessee,0,0,0,
All Games,2013,Tennessee,5,7,12,0.4166666666666667
at Home,2013,Tennessee,4,3,7,0.5714285714285714
on Road/Neutral Site,2013,Tennessee,1,4,5,0.2
vs. Conference,2013,Tennessee,2,6,8,0.25
vs. Non-Conference,2013,Tennessee,3,1,4,0.75
vs. Ranked (AP),2013,Tennessee,1,5,6,0.16666666666666666
vs. Unranked (AP),2013,Tennessee,4,2,6,0.6666666666666666
vs. FBS (I-A),2013,Tennessee,4,7,11,0.36363636363636365
vs. FCS (I-AA),2013,Tennessee,1,0,1,1.0
vs. FBS Winning,2013,Tennessee,2,6,8,0.25
vs. FBS Non-Winning,2013,Tennessee,2,1,3,0.6666666666666666
vs. BCS AQ,2013,Tennessee,2,7,9,0.2222222222222222
vs. BCS non-AQ,2013,Tennessee,2,0,2,1.0
vs. FBS Power 5,2013,Tennessee,2,7,9,0.2222222222222222
vs. FBS non-Power 5,2013,Tennessee,2,0,2,1.0
in August/September,2013,Tennessee,3,2,5,0.6
in October,2013,Tennessee,1,2,3,0.3333333333333333
in November,2013,Tennessee,1,3,4,0.25
in December/January,2013,Tennessee,0,0,0,
All Games,2014,Tennessee,7,6,13,0.5384615384615384
at Home,2014,Tennessee,4,3,7,0.5714285714285714
on Road/Neutral Site,2014,Tennessee,3,3,6,0.5
vs. Conference,2014,Tennessee,3,5,8,0.375
vs. Non-Conference,2014,Tennessee,4,1,5,0.8
vs. Ranked (AP),2014,Tennessee,0,4,4,0.0
vs. Unranked (AP),2014,Tennessee,7,2,9,0.7777777777777778
vs. FBS (I-A),2014,Tennessee,6,6,12,0.5
vs. FCS (I-AA),2014,Tennessee,1,0,1,1.0
vs. FBS Winning,2014,Tennessee,4,6,10,0.4
vs. FBS Non-Winning,2014,Tennessee,2,0,2,1.0
vs. BCS AQ,2014,Tennessee,4,6,10,0.4
vs. BCS non-AQ,2014,Tennessee,2,0,2,1.0
vs. FBS Power 5,2014,Tennessee,4,6,10,0.4
vs. FBS non-Power 5,2014,Tennessee,2,0,2,1.0
in August/September,2014,Tennessee,2,2,4,0.5
in October,2014,Tennessee,1,3,4,0.25
in November,2014,Tennessee,3,1,4,0.75
in December/January,2014,Tennessee,1,0,1,1.0
All Games,2015,Tennessee,9,4,13,0.6923076923076923
at Home,2015,Tennessee,5,2,7,0.7142857142857143
on Road/Neutral Site,2015,Tennessee,4,2,6,0.6666666666666666
vs. Conference,2015,Tennessee,5,3,8,0.625
vs. Non-Conference,2015,Tennessee,4,1,5,0.8
vs. Ranked (AP),2015,Tennessee,1,3,4,0.25
vs. Unranked (AP),2015,Tennessee,8,1,9,0.8888888888888888
vs. FBS (I-A),2015,Tennessee,8,4,12,0.6666666666666666
vs. FCS (I-AA),2015,Tennessee,1,0,1,1.0
vs. FBS Winning,2015,Tennessee,3,4,7,0.42857142857142855
vs. FBS Non-Winning,2015,Tennessee,5,0,5,1.0
vs. BCS AQ,2015,Tennessee,6,4,10,0.6
vs. BCS non-AQ,2015,Tennessee,2,0,2,1.0
vs. FBS Power 5,2015,Tennessee,6,4,10,0.6
vs. FBS non-Power 5,2015,Tennessee,2,0,2,1.0
in August/September,2015,Tennessee,2,2,4,0.5
in October,2015,Tennessee,2,2,4,0.5
in November,2015,Tennessee,4,0,4,1.0
in December/January,2015,Tennessee,1,0,1,1.0
All Games,2016,Tennessee,9,4,13,0.6923076923076923
at Home,2016,Tennessee,6,1,7,0.8571428571428571
on Road/Neutral Site,2016,Tennessee,3,3,6,0.5
vs. Conference,2016,Tennessee,4,4,8,0.5
vs. Non-Conference,2016,Tennessee,5,0,5,1.0
vs. Ranked (AP),2016,Tennessee,3,1,4,0.75
vs. Unranked (AP),2016,Tennessee,6,3,9,0.6666666666666666
vs. FBS (I-A),2016,Tennessee,8,4,12,0.6666666666666666
vs. FCS (I-AA),2016,Tennessee,1,0,1,1.0
vs. FBS Winning,2016,Tennessee,7,2,9,0.7777777777777778
vs. FBS Non-Winning,2016,Tennessee,1,2,3,0.3333333333333333
vs. BCS AQ,2016,Tennessee,6,4,10,0.6
vs. BCS non-AQ,2016,Tennessee,2,0,2,1.0
vs. FBS Power 5,2016,Tennessee,6,4,10,0.6
vs. FBS non-Power 5,2016,Tennessee,2,0,2,1.0
in August/September,2016,Tennessee,4,0,4,1.0
in October,2016,Tennessee,1,3,4,0.25
in November,2016,Tennessee,3,1,4,0.75
in December/January,2016,Tennessee,1,0,1,1.0
All Games,2017,Tennessee,4,8,12,0.3333333333333333
at Home,2017,Tennessee,3,4,7,0.42857142857142855
on Road/Neutral Site,2017,Tennessee,1,4,5,0.2
vs. Conference,2017,Tennessee,0,8,8,0.0
vs. Non-Conference,2017,Tennessee,4,0,4,1.0
vs. Ranked (AP),2017,Tennessee,0,3,3,0.0
vs. Unranked (AP),2017,Tennessee,4,5,9,0.4444444444444444
vs. FBS (I-A),2017,Tennessee,3,8,11,0.2727272727272727
vs. FCS (I-AA),2017,Tennessee,1,0,1,1.0
vs. FBS Winning,2017,Tennessee,1,6,7,0.14285714285714285
vs. FBS Non-Winning,2017,Tennessee,2,2,4,0.5
vs. BCS AQ,2017,Tennessee,1,8,9,0.1111111111111111
vs. BCS non-AQ,2017,Tennessee,2,0,2,1.0
vs. FBS Power 5,2017,Tennessee,1,8,9,0.1111111111111111
vs. FBS non-Power 5,2017,Tennessee,2,0,2,1.0
in August/September,2017,Tennessee,3,2,5,0.6
in October,2017,Tennessee,0,3,3,0.0
in November,2017,Tennessee,1,3,4,0.25
in December/January,2017,Tennessee,0,0,0,
All Games,2018,Tennessee,5,7,12,0.4166666666666667
at Home,2018,Tennessee,4,3,7,0.5714285714285714
on Road/Neutral Site,2018,Tennessee,1,4,5,0.2
vs. Conference,2018,Tennessee,2,6,8,0.25
vs. Non-Conference,2018,Tennessee,3,1,4,0.75
vs. Ranked (AP),2018,Tennessee,1,4,5,0.2
vs. Unranked (AP),2018,Tennessee,4,3,7,0.5714285714285714
vs. FBS (I-A),2018,Tennessee,4,7,11,0.36363636363636365
vs. FCS (I-AA),2018,Tennessee,1,0,1,1.0
vs. FBS Winning,2018,Tennessee,2,6,8,0.25
vs. FBS Non-Winning,2018,Tennessee,2,1,3,0.6666666666666666
vs. BCS AQ,2018,Tennessee,2,7,9,0.2222222222222222
vs. BCS non-AQ,2018,Tennessee,2,0,2,1.0
vs. FBS Power 5,2018,Tennessee,2,7,9,0.2222222222222222
vs. FBS non-Power 5,2018,Tennessee,2,0,2,1.0
in August/September,2018,Tennessee,2,3,5,0.4
in October,2018,Tennessee,1,2,3,0.3333333333333333
in November,2018,Tennessee,2,2,4,0.5
in December/January,2018,Tennessee,0,0,0,
All Games,2019,Tennessee,8,5,13,0.6153846153846154
at Home,2019,Tennessee,5,3,8,0.625
on Road/Neutral Site,2019,Tennessee,3,2,5,0.6
vs. Conference,2019,Tennessee,5,3,8,0.625
vs. Non-Conference,2019,Tennessee,3,2,5,0.6
vs. Ranked (AP),2019,Tennessee,0,3,3,0.0
vs. Unranked (AP),2019,Tennessee,8,2,10,0.8
vs. FBS (I-A),2019,Tennessee,7,5,12,0.5833333333333334
vs. FCS (I-AA),2019,Tennessee,1,0,1,1.0
vs. FBS Winning,2019,Tennessee,3,5,8,0.375
vs. FBS Non-Winning,2019,Tennessee,4,0,4,1.0
vs. BCS AQ,2019,Tennessee,6,3,9,0.6666666666666666
vs. BCS non-AQ,2019,Tennessee,1,2,3,0.3333333333333333
vs. FBS Power 5,2019,Tennessee,6,3,9,0.6666666666666666
vs. FBS non-Power 5,2019,Tennessee,1,2,3,0.3333333333333333
in August/September,2019,Tennessee,1,3,4,0.25
in October,2019,Tennessee,2,2,4,0.5
in November,2019,Tennessee,4,0,4,1.0
in December/January,2019,Tennessee,1,0,1,1.0
All Games,2020,Tennessee,3,7,10,0.3
at Home,2020,Tennessee,1,4,5,0.2
on Road/Neutral Site,2020,Tennessee,2,3,5,0.4
vs. Conference,2020,Tennessee,3,7,10,0.3
vs. Non-Conference,2020,Tennessee,0,0,0,
vs. Ranked (AP),2020,Tennessee,0,4,4,0.0
vs. Unranked (AP),2020,Tennessee,3,3,6,0.5
vs. FBS (I-A),2020,Tennessee,3,7,10,0.3
vs. FCS (I-AA),2020,Tennessee,0,0,0,
vs. FBS Winning,2020,Tennessee,0,5,5,0.0
vs. FBS Non-Winning,2020,Tennessee,3,2,5,0.6
vs. BCS AQ,2020,Tennessee,3,7,10,0.3
vs. BCS non-AQ,2020,Tennessee,0,0,0,
vs. FBS Power 5,2020,Tennessee,3,7,10,0.3
vs. FBS non-Power 5,2020,Tennessee,0,0,0,
in August/September,2020,Tennessee,1,0,1,1.0
in October,2020,Tennessee,1,3,4,0.25
in November,2020,Tennessee,0,2,2,0.0
in December/January,2020,Tennessee,1,2,3,0.3333333333333333
All Games,2021,Tennessee,7,6,13,0.5384615384615384
at Home,2021,Tennessee,5,3,8,0.625
on Road/Neutral Site,2021,Tennessee,2,3,5,0.4
vs. Conference,2021,Tennessee,4,4,8,0.5
vs. Non-Conference,2021,Tennessee,3,2,5,0.6
vs. Ranked (AP),2021,Tennessee,1,4,5,0.2
vs. Unranked (AP),2021,Tennessee,6,2,8,0.75
vs. FBS (I-A),2021,Tennessee,6,6,12,0.5
vs. FCS (I-AA),2021,Tennessee,1,0,1,1.0
vs. FBS Winning,2021,Tennessee,2,5,7,0.2857142857142857
vs. FBS Non-Winning,2021,Tennessee,4,1,5,0.8
vs. BCS AQ,2021,Tennessee,4,6,10,0.4
vs. BCS non-AQ,2021,Tennessee,2,0,2,1.0
vs. FBS Power 5,2021,Tennessee,4,6,10,0.4
vs. FBS non-Power 5,2021,Tennessee,2,0,2,1.0
in August/September,2021,Tennessee,2,2,4,0.5
in October,2021,Tennessee,2,2,4,0.5
in November,2021,Tennessee,3,1,4,0.75
in December/January,2021,Tennessee,0,1,1,0.0
All Games,2022,Tennessee,11,2,13,0.8461538461538461
at Home,2022,Tennessee,7,0,7,1.0
on Road/Neutral Site,2022,Tennessee,4,2,6,0.6666666666666666
vs. Conference,2022,Tennessee,6,2,8,0.75
vs. Non-Conference,2022,Tennessee,5,0,5,1.0
vs. Ranked (AP),2022,Tennessee,4,2,6,0.6666666666666666
vs. Unranked (AP),2022,Tennessee,7,0,7,1.0
vs. FBS (I-A),2022,Tennessee,10,2,12,0.8333333333333334
vs. FCS (I-AA),2022,Tennessee,1,0,1,1.0
vs. FBS Winning,2022,Tennessee,5,2,7,0.7142857142857143
vs. FBS Non-Winning,2022,Tennessee,5,0,5,1.0
vs. BCS AQ,2022,Tennessee,8,2,10,0.8
vs. BCS non-AQ,2022,Tennessee,2,0,2,1.0
vs. FBS Power 5,2022,Tennessee,8,2,10,0.8
vs. FBS non-Power 5,2022,Tennessee,2,0,2,1.0
in August/September,2022,Tennessee,4,0,4,1.0
in October,2022,Tennessee,4,0,4,1.0
in November,2022,Tennessee,2,2,4,0.5
in December/January,2022,Tennessee,1,0,1,1.0
All Games,2009,Texas,13,1,14,0.9285714285714286
at Home,2009,Texas,6,0,6,1.0
on Road/Neutral Site,2009,Texas,7,1,8,0.875
vs. Conference,2009,Texas,9,0,9,1.0
vs. Non-Conference,2009,Texas,4,1,5,0.8
vs. Ranked (AP),2009,Texas,2,1,3,0.6666666666666666
vs. Unranked (AP),2009,Texas,11,0,11,1.0
vs. FBS (I-A),2009,Texas,13,1,14,0.9285714285714286
vs. FCS (I-AA),2009,Texas,0,0,0,
vs. FBS Winning,2009,Texas,7,1,8,0.875
vs. FBS Non-Winning,2009,Texas,6,0,6,1.0
vs. BCS AQ,2009,Texas,9,1,10,0.9
vs. BCS non-AQ,2009,Texas,4,0,4,1.0
vs. FBS Power 5,2009,Texas,9,1,10,0.9
vs. FBS non-Power 5,2009,Texas,4,0,4,1.0
in August/September,2009,Texas,4,0,4,1.0
in October,2009,Texas,4,0,4,1.0
in November,2009,Texas,4,0,4,1.0
in December/January,2009,Texas,1,1,2,0.5
All Games,2010,Texas,5,7,12,0.4166666666666667
at Home,2010,Texas,2,5,7,0.2857142857142857
on Road/Neutral Site,2010,Texas,3,2,5,0.6
vs. Conference,2010,Texas,2,6,8,0.25
vs. Non-Conference,2010,Texas,3,1,4,0.75
vs. Ranked (AP),2010,Texas,1,3,4,0.25
vs. Unranked (AP),2010,Texas,4,4,8,0.5
vs. FBS (I-A),2010,Texas,5,7,12,0.4166666666666667
vs. FCS (I-AA),2010,Texas,0,0,0,
vs. FBS Winning,2010,Texas,2,5,7,0.2857142857142857
vs. FBS Non-Winning,2010,Texas,3,2,5,0.6
vs. BCS AQ,2010,Texas,2,7,9,0.2222222222222222
vs. BCS non-AQ,2010,Texas,3,0,3,1.0
vs. FBS Power 5,2010,Texas,2,7,9,0.2222222222222222
vs. FBS non-Power 5,2010,Texas,3,0,3,1.0
in August/September,2010,Texas,3,1,4,0.75
in October,2010,Texas,1,3,4,0.25
in November,2010,Texas,1,3,4,0.25
in December/January,2010,Texas,0,0,0,
All Games,2011,Texas,8,5,13,0.6153846153846154
at Home,2011,Texas,4,2,6,0.6666666666666666
on Road/Neutral Site,2011,Texas,4,3,7,0.5714285714285714
vs. Conference,2011,Texas,4,5,9,0.4444444444444444
vs. Non-Conference,2011,Texas,4,0,4,1.0
vs. Ranked (AP),2011,Texas,0,4,4,0.0
vs. Unranked (AP),2011,Texas,8,1,9,0.8888888888888888
vs. FBS (I-A),2011,Texas,8,5,13,0.6153846153846154
vs. FCS (I-AA),2011,Texas,0,0,0,
vs. FBS Winning,2011,Texas,3,5,8,0.375
vs. FBS Non-Winning,2011,Texas,5,0,5,1.0
vs. BCS AQ,2011,Texas,6,5,11,0.5454545454545454
vs. BCS non-AQ,2011,Texas,2,0,2,1.0
vs. FBS Power 5,2011,Texas,6,5,11,0.5454545454545454
vs. FBS non-Power 5,2011,Texas,2,0,2,1.0
in August/September,2011,Texas,3,0,3,1.0
in October,2011,Texas,2,2,4,0.5
in November,2011,Texas,2,2,4,0.5
in December/January,2011,Texas,1,1,2,0.5
All Games,2012,Texas,9,4,13,0.6923076923076923
at Home,2012,Texas,4,2,6,0.6666666666666666
on Road/Neutral Site,2012,Texas,5,2,7,0.7142857142857143
vs. Conference,2012,Texas,5,4,9,0.5555555555555556
vs. Non-Conference,2012,Texas,4,0,4,1.0
vs. Ranked (AP),2012,Texas,1,2,3,0.3333333333333333
vs. Unranked (AP),2012,Texas,8,2,10,0.8
vs. FBS (I-A),2012,Texas,9,4,13,0.6923076923076923
vs. FCS (I-AA),2012,Texas,0,0,0,
vs. FBS Winning,2012,Texas,5,4,9,0.5555555555555556
vs. FBS Non-Winning,2012,Texas,4,0,4,1.0
vs. BCS AQ,2012,Texas,7,4,11,0.6363636363636364
vs. BCS non-AQ,2012,Texas,2,0,2,1.0
vs. FBS Power 5,2012,Texas,7,4,11,0.6363636363636364
vs. FBS non-Power 5,2012,Texas,2,0,2,1.0
in August/September,2012,Texas,4,0,4,1.0
in October,2012,Texas,2,2,4,0.5
in November,2012,Texas,2,1,3,0.6666666666666666
in December/January,2012,Texas,1,1,2,0.5
All Games,2013,Texas,8,5,13,0.6153846153846154
at Home,2013,Texas,4,2,6,0.6666666666666666
on Road/Neutral Site,2013,Texas,4,3,7,0.5714285714285714
vs. Conference,2013,Texas,7,2,9,0.7777777777777778
vs. Non-Conference,2013,Texas,1,3,4,0.25
vs. Ranked (AP),2013,Texas,1,3,4,0.25
vs. Unranked (AP),2013,Texas,7,2,9,0.7777777777777778
vs. FBS (I-A),2013,Texas,8,5,13,0.6153846153846154
vs. FCS (I-AA),2013,Texas,0,0,0,
vs. FBS Winning,2013,Texas,3,5,8,0.375
vs. FBS Non-Winning,2013,Texas,5,0,5,1.0
vs. BCS AQ,2013,Texas,7,4,11,0.6363636363636364
vs. BCS non-AQ,2013,Texas,1,1,2,0.5
vs. FBS Power 5,2013,Texas,7,4,11,0.6363636363636364
vs. FBS non-Power 5,2013,Texas,1,1,2,0.5
in August/September,2013,Texas,2,2,4,0.5
in October,2013,Texas,3,0,3,1.0
in November,2013,Texas,3,1,4,0.75
in December/January,2013,Texas,0,2,2,0.0
All Games,2014,Texas,6,7,13,0.46153846153846156
at Home,2014,Texas,3,3,6,0.5
on Road/Neutral Site,2014,Texas,3,4,7,0.42857142857142855
vs. Conference,2014,Texas,5,4,9,0.5555555555555556
vs. Non-Conference,2014,Texas,1,3,4,0.25
vs. Ranked (AP),2014,Texas,0,4,4,0.0
vs. Unranked (AP),2014,Texas,6,3,9,0.6666666666666666
vs. FBS (I-A),2014,Texas,6,7,13,0.46153846153846156
vs. FCS (I-AA),2014,Texas,0,0,0,
vs. FBS Winning,2014,Texas,2,7,9,0.2222222222222222
vs. FBS Non-Winning,2014,Texas,4,0,4,1.0
vs. BCS AQ,2014,Texas,5,6,11,0.45454545454545453
vs. BCS non-AQ,2014,Texas,1,1,2,0.5
vs. FBS Power 5,2014,Texas,5,6,11,0.45454545454545453
vs. FBS non-Power 5,2014,Texas,1,1,2,0.5
in August/September,2014,Texas,2,2,4,0.5
in October,2014,Texas,1,3,4,0.25
in November,2014,Texas,3,1,4,0.75
in December/January,2014,Texas,0,1,1,0.0
All Games,2015,Texas,5,7,12,0.4166666666666667
at Home,2015,Texas,3,3,6,0.5
on Road/Neutral Site,2015,Texas,2,4,6,0.3333333333333333
vs. Conference,2015,Texas,4,5,9,0.4444444444444444
vs. Non-Conference,2015,Texas,1,2,3,0.3333333333333333
vs. Ranked (AP),2015,Texas,2,3,5,0.4
vs. Unranked (AP),2015,Texas,3,4,7,0.42857142857142855
vs. FBS (I-A),2015,Texas,5,7,12,0.4166666666666667
vs. FCS (I-AA),2015,Texas,0,0,0,
vs. FBS Winning,2015,Texas,2,6,8,0.25
vs. FBS Non-Winning,2015,Texas,3,1,4,0.75
vs. BCS AQ,2015,Texas,4,7,11,0.36363636363636365
vs. BCS non-AQ,2015,Texas,1,0,1,1.0
vs. FBS Power 5,2015,Texas,4,6,10,0.4
vs. FBS non-Power 5,2015,Texas,1,1,2,0.5
in August/September,2015,Texas,1,3,4,0.25
in October,2015,Texas,2,2,4,0.5
in November,2015,Texas,1,2,3,0.3333333333333333
in December/January,2015,Texas,1,0,1,1.0
All Games,2016,Texas,5,7,12,0.4166666666666667
at Home,2016,Texas,4,2,6,0.6666666666666666
on Road/Neutral Site,2016,Texas,1,5,6,0.16666666666666666
vs. Conference,2016,Texas,3,6,9,0.3333333333333333
vs. Non-Conference,2016,Texas,2,1,3,0.6666666666666666
vs. Ranked (AP),2016,Texas,0,3,3,0.0
vs. Unranked (AP),2016,Texas,5,4,9,0.5555555555555556
vs. FBS (I-A),2016,Texas,5,7,12,0.4166666666666667
vs. FCS (I-AA),2016,Texas,0,0,0,
vs. FBS Winning,2016,Texas,1,4,5,0.2
vs. FBS Non-Winning,2016,Texas,4,3,7,0.5714285714285714
vs. BCS AQ,2016,Texas,4,7,11,0.36363636363636365
vs. BCS non-AQ,2016,Texas,1,0,1,1.0
vs. FBS Power 5,2016,Texas,3,7,10,0.3
vs. FBS non-Power 5,2016,Texas,2,0,2,1.0
in August/September,2016,Texas,2,1,3,0.6666666666666666
in October,2016,Texas,2,3,5,0.4
in November,2016,Texas,1,3,4,0.25
in December/January,2016,Texas,0,0,0,
All Games,2017,Texas,7,6,13,0.5384615384615384
at Home,2017,Texas,3,3,6,0.5
on Road/Neutral Site,2017,Texas,4,3,7,0.5714285714285714
vs. Conference,2017,Texas,5,4,9,0.5555555555555556
vs. Non-Conference,2017,Texas,2,2,4,0.5
vs. Ranked (AP),2017,Texas,0,4,4,0.0
vs. Unranked (AP),2017,Texas,7,2,9,0.7777777777777778
vs. FBS (I-A),2017,Texas,7,6,13,0.5384615384615384
vs. FCS (I-AA),2017,Texas,0,0,0,
vs. FBS Winning,2017,Texas,4,4,8,0.5
vs. FBS Non-Winning,2017,Texas,3,2,5,0.6
vs. BCS AQ,2017,Texas,6,6,12,0.5
vs. BCS non-AQ,2017,Texas,1,0,1,1.0
vs. FBS Power 5,2017,Texas,6,6,12,0.5
vs. FBS non-Power 5,2017,Texas,1,0,1,1.0
in August/September,2017,Texas,2,2,4,0.5
in October,2017,Texas,2,2,4,0.5
in November,2017,Texas,2,2,4,0.5
in December/January,2017,Texas,1,0,1,1.0
All Games,2018,Texas,10,4,14,0.7142857142857143
at Home,2018,Texas,5,1,6,0.8333333333333334
on Road/Neutral Site,2018,Texas,5,3,8,0.625
vs. Conference,2018,Texas,7,3,10,0.7
vs. Non-Conference,2018,Texas,3,1,4,0.75
vs. Ranked (AP),2018,Texas,2,2,4,0.5
vs. Unranked (AP),2018,Texas,8,2,10,0.8
vs. FBS (I-A),2018,Texas,10,4,14,0.7142857142857143
vs. FCS (I-AA),2018,Texas,0,0,0,
vs. FBS Winning,2018,Texas,5,3,8,0.625
vs. FBS Non-Winning,2018,Texas,5,1,6,0.8333333333333334
vs. BCS AQ,2018,Texas,10,4,14,0.7142857142857143
vs. BCS non-AQ,2018,Texas,0,0,0,
vs. FBS Power 5,2018,Texas,9,4,13,0.6923076923076923
vs. FBS non-Power 5,2018,Texas,1,0,1,1.0
in August/September,2018,Texas,4,1,5,0.8
in October,2018,Texas,2,1,3,0.6666666666666666
in November,2018,Texas,3,1,4,0.75
in December/January,2018,Texas,1,1,2,0.5
All Games,2019,Texas,8,5,13,0.6153846153846154
at Home,2019,Texas,5,1,6,0.8333333333333334
on Road/Neutral Site,2019,Texas,3,4,7,0.42857142857142855
vs. Conference,2019,Texas,5,4,9,0.5555555555555556
vs. Non-Conference,2019,Texas,3,1,4,0.75
vs. Ranked (AP),2019,Texas,1,3,4,0.25
vs. Unranked (AP),2019,Texas,7,2,9,0.7777777777777778
vs. FBS (I-A),2019,Texas,8,5,13,0.6153846153846154
vs. FCS (I-AA),2019,Texas,0,0,0,
vs. FBS Winning,2019,Texas,4,4,8,0.5
vs. FBS Non-Winning,2019,Texas,4,1,5,0.8
vs. BCS AQ,2019,Texas,6,5,11,0.5454545454545454
vs. BCS non-AQ,2019,Texas,2,0,2,1.0
vs. FBS Power 5,2019,Texas,6,5,11,0.5454545454545454
vs. FBS non-Power 5,2019,Texas,2,0,2,1.0
in August/September,2019,Texas,3,1,4,0.75
in October,2019,Texas,2,2,4,0.5
in November,2019,Texas,2,2,4,0.5
in December/January,2019,Texas,1,0,1,1.0
All Games,2020,Texas,7,3,10,0.7
at Home,2020,Texas,3,2,5,0.6
on Road/Neutral Site,2020,Texas,4,1,5,0.8
vs. Conference,2020,Texas,5,3,8,0.625
vs. Non-Conference,2020,Texas,2,0,2,1.0
vs. Ranked (AP),2020,Texas,0,2,2,0.0
vs. Unranked (AP),2020,Texas,7,1,8,0.875
vs. FBS (I-A),2020,Texas,7,3,10,0.7
vs. FCS (I-AA),2020,Texas,0,0,0,
vs. FBS Winning,2020,Texas,3,3,6,0.5
vs. FBS Non-Winning,2020,Texas,4,0,4,1.0
vs. BCS AQ,2020,Texas,6,3,9,0.6666666666666666
vs. BCS non-AQ,2020,Texas,1,0,1,1.0
vs. FBS Power 5,2020,Texas,6,3,9,0.6666666666666666
vs. FBS non-Power 5,2020,Texas,1,0,1,1.0
in August/September,2020,Texas,2,0,2,1.0
in October,2020,Texas,2,2,4,0.5
in November,2020,Texas,1,1,2,0.5
in December/January,2020,Texas,2,0,2,1.0
All Games,2021,Texas,5,7,12,0.4166666666666667
at Home,2021,Texas,4,2,6,0.6666666666666666
on Road/Neutral Site,2021,Texas,1,5,6,0.16666666666666666
vs. Conference,2021,Texas,3,6,9,0.3333333333333333
vs. Non-Conference,2021,Texas,2,1,3,0.6666666666666666
vs. Ranked (AP),2021,Texas,1,4,5,0.2
vs. Unranked (AP),2021,Texas,4,3,7,0.5714285714285714
vs. FBS (I-A),2021,Texas,5,7,12,0.4166666666666667
vs. FCS (I-AA),2021,Texas,0,0,0,
vs. FBS Winning,2021,Texas,3,5,8,0.375
vs. FBS Non-Winning,2021,Texas,2,2,4,0.5
vs. BCS AQ,2021,Texas,3,7,10,0.3
vs. BCS non-AQ,2021,Texas,2,0,2,1.0
vs. FBS Power 5,2021,Texas,3,7,10,0.3
vs. FBS non-Power 5,2021,Texas,2,0,2,1.0
in August/September,2021,Texas,3,1,4,0.75
in October,2021,Texas,1,3,4,0.25
in November,2021,Texas,1,3,4,0.25
in December/January,2021,Texas,0,0,0,
All Games,2022,Texas,8,5,13,0.6153846153846154
at Home,2022,Texas,5,2,7,0.7142857142857143
on Road/Neutral Site,2022,Texas,3,3,6,0.5
vs. Conference,2022,Texas,6,3,9,0.6666666666666666
vs. Non-Conference,2022,Texas,2,2,4,0.5
vs. Ranked (AP),2022,Texas,1,3,4,0.25
vs. Unranked (AP),2022,Texas,7,2,9,0.7777777777777778
vs. FBS (I-A),2022,Texas,8,5,13,0.6153846153846154
vs. FCS (I-AA),2022,Texas,0,0,0,
vs. FBS Winning,2022,Texas,2,5,7,0.2857142857142857
vs. FBS Non-Winning,2022,Texas,6,0,6,1.0
vs. BCS AQ,2022,Texas,6,5,11,0.5454545454545454
vs. BCS non-AQ,2022,Texas,2,0,2,1.0
vs. FBS Power 5,2022,Texas,6,5,11,0.5454545454545454
vs. FBS non-Power 5,2022,Texas,2,0,2,1.0
in August/September,2022,Texas,2,2,4,0.5
in October,2022,Texas,3,1,4,0.75
in November,2022,Texas,3,1,4,0.75
in December/January,2022,Texas,0,1,1,0.0
All Games,2009,Texas A&M,6,7,13,0.46153846153846156
at Home,2009,Texas A&M,5,2,7,0.7142857142857143
on Road/Neutral Site,2009,Texas A&M,1,5,6,0.16666666666666666
vs. Conference,2009,Texas A&M,3,5,8,0.375
vs. Non-Conference,2009,Texas A&M,3,2,5,0.6
vs. Ranked (AP),2009,Texas A&M,1,1,2,0.5
vs. Unranked (AP),2009,Texas A&M,5,6,11,0.45454545454545453
vs. FBS (I-A),2009,Texas A&M,6,7,13,0.46153846153846156
vs. FCS (I-AA),2009,Texas A&M,0,0,0,
vs. FBS Winning,2009,Texas A&M,2,5,7,0.2857142857142857
vs. FBS Non-Winning,2009,Texas A&M,4,2,6,0.6666666666666666
vs. BCS AQ,2009,Texas A&M,3,7,10,0.3
vs. BCS non-AQ,2009,Texas A&M,3,0,3,1.0
vs. FBS Power 5,2009,Texas A&M,3,7,10,0.3
vs. FBS non-Power 5,2009,Texas A&M,3,0,3,1.0
in August/September,2009,Texas A&M,3,0,3,1.0
in October,2009,Texas A&M,2,3,5,0.4
in November,2009,Texas A&M,1,3,4,0.25
in December/January,2009,Texas A&M,0,1,1,0.0
All Games,2010,Texas A&M,9,4,13,0.6923076923076923
at Home,2010,Texas A&M,6,1,7,0.8571428571428571
on Road/Neutral Site,2010,Texas A&M,3,3,6,0.5
vs. Conference,2010,Texas A&M,6,2,8,0.75
vs. Non-Conference,2010,Texas A&M,3,2,5,0.6
vs. Ranked (AP),2010,Texas A&M,2,4,6,0.3333333333333333
vs. Unranked (AP),2010,Texas A&M,7,0,7,1.0
vs. FBS (I-A),2010,Texas A&M,8,4,12,0.6666666666666666
vs. FCS (I-AA),2010,Texas A&M,1,0,1,1.0
vs. FBS Winning,2010,Texas A&M,5,4,9,0.5555555555555556
vs. FBS Non-Winning,2010,Texas A&M,3,0,3,1.0
vs. BCS AQ,2010,Texas A&M,6,4,10,0.6
vs. BCS non-AQ,2010,Texas A&M,2,0,2,1.0
vs. FBS Power 5,2010,Texas A&M,6,4,10,0.6
vs. FBS non-Power 5,2010,Texas A&M,2,0,2,1.0
in August/September,2010,Texas A&M,3,1,4,0.75
in October,2010,Texas A&M,2,2,4,0.5
in November,2010,Texas A&M,4,0,4,1.0
in December/January,2010,Texas A&M,0,1,1,0.0
All Games,2011,Texas A&M,7,6,13,0.5384615384615384
at Home,2011,Texas A&M,4,3,7,0.5714285714285714
on Road/Neutral Site,2011,Texas A&M,3,3,6,0.5
vs. Conference,2011,Texas A&M,4,5,9,0.4444444444444444
vs. Non-Conference,2011,Texas A&M,3,1,4,0.75
vs. Ranked (AP),2011,Texas A&M,1,4,5,0.2
vs. Unranked (AP),2011,Texas A&M,6,2,8,0.75
vs. FBS (I-A),2011,Texas A&M,7,6,13,0.5384615384615384
vs. FCS (I-AA),2011,Texas A&M,0,0,0,
vs. FBS Winning,2011,Texas A&M,2,6,8,0.25
vs. FBS Non-Winning,2011,Texas A&M,5,0,5,1.0
vs. BCS AQ,2011,Texas A&M,5,6,11,0.45454545454545453
vs. BCS non-AQ,2011,Texas A&M,2,0,2,1.0
vs. FBS Power 5,2011,Texas A&M,5,6,11,0.45454545454545453
vs. FBS non-Power 5,2011,Texas A&M,2,0,2,1.0
in August/September,2011,Texas A&M,2,1,3,0.6666666666666666
in October,2011,Texas A&M,3,2,5,0.6
in November,2011,Texas A&M,1,3,4,0.25
in December/January,2011,Texas A&M,1,0,1,1.0
All Games,2012,Texas A&M,11,2,13,0.8461538461538461
at Home,2012,Texas A&M,4,2,6,0.6666666666666666
on Road/Neutral Site,2012,Texas A&M,7,0,7,1.0
vs. Conference,2012,Texas A&M,6,2,8,0.75
vs. Non-Conference,2012,Texas A&M,5,0,5,1.0
vs. Ranked (AP),2012,Texas A&M,2,2,4,0.5
vs. Unranked (AP),2012,Texas A&M,9,0,9,1.0
vs. FBS (I-A),2012,Texas A&M,9,2,11,0.8181818181818182
vs. FCS (I-AA),2012,Texas A&M,2,0,2,1.0
vs. FBS Winning,2012,Texas A&M,6,2,8,0.75
vs. FBS Non-Winning,2012,Texas A&M,3,0,3,1.0
vs. BCS AQ,2012,Texas A&M,7,2,9,0.7777777777777778
vs. BCS non-AQ,2012,Texas A&M,2,0,2,1.0
vs. FBS Power 5,2012,Texas A&M,7,2,9,0.7777777777777778
vs. FBS non-Power 5,2012,Texas A&M,2,0,2,1.0
in August/September,2012,Texas A&M,3,1,4,0.75
in October,2012,Texas A&M,3,1,4,0.75
in November,2012,Texas A&M,4,0,4,1.0
in December/January,2012,Texas A&M,1,0,1,1.0
All Games,2013,Texas A&M,9,4,13,0.6923076923076923
at Home,2013,Texas A&M,6,2,8,0.75
on Road/Neutral Site,2013,Texas A&M,3,2,5,0.6
vs. Conference,2013,Texas A&M,4,4,8,0.5
vs. Non-Conference,2013,Texas A&M,5,0,5,1.0
vs. Ranked (AP),2013,Texas A&M,2,4,6,0.3333333333333333
vs. Unranked (AP),2013,Texas A&M,7,0,7,1.0
vs. FBS (I-A),2013,Texas A&M,8,4,12,0.6666666666666666
vs. FCS (I-AA),2013,Texas A&M,1,0,1,1.0
vs. FBS Winning,2013,Texas A&M,5,4,9,0.5555555555555556
vs. FBS Non-Winning,2013,Texas A&M,3,0,3,1.0
vs. BCS AQ,2013,Texas A&M,6,4,10,0.6
vs. BCS non-AQ,2013,Texas A&M,2,0,2,1.0
vs. FBS Power 5,2013,Texas A&M,5,4,9,0.5555555555555556
vs. FBS non-Power 5,2013,Texas A&M,3,0,3,1.0
in August/September,2013,Texas A&M,4,1,5,0.8
in October,2013,Texas A&M,2,1,3,0.6666666666666666
in November,2013,Texas A&M,2,2,4,0.5
in December/January,2013,Texas A&M,1,0,1,1.0
All Games,2014,Texas A&M,8,5,13,0.6153846153846154
at Home,2014,Texas A&M,3,3,6,0.5
on Road/Neutral Site,2014,Texas A&M,5,2,7,0.7142857142857143
vs. Conference,2014,Texas A&M,3,5,8,0.375
vs. Non-Conference,2014,Texas A&M,5,0,5,1.0
vs. Ranked (AP),2014,Texas A&M,1,4,5,0.2
vs. Unranked (AP),2014,Texas A&M,7,1,8,0.875
vs. FBS (I-A),2014,Texas A&M,7,5,12,0.5833333333333334
vs. FCS (I-AA),2014,Texas A&M,1,0,1,1.0
vs. FBS Winning,2014,Texas A&M,5,5,10,0.5
vs. FBS Non-Winning,2014,Texas A&M,2,0,2,1.0
vs. BCS AQ,2014,Texas A&M,5,5,10,0.5
vs. BCS non-AQ,2014,Texas A&M,2,0,2,1.0
vs. FBS Power 5,2014,Texas A&M,4,5,9,0.4444444444444444
vs. FBS non-Power 5,2014,Texas A&M,3,0,3,1.0
in August/September,2014,Texas A&M,5,0,5,1.0
in October,2014,Texas A&M,0,3,3,0.0
in November,2014,Texas A&M,2,2,4,0.5
in December/January,2014,Texas A&M,1,0,1,1.0
All Games,2015,Texas A&M,8,5,13,0.6153846153846154
at Home,2015,Texas A&M,5,2,7,0.7142857142857143
on Road/Neutral Site,2015,Texas A&M,3,3,6,0.5
vs. Conference,2015,Texas A&M,4,4,8,0.5
vs. Non-Conference,2015,Texas A&M,4,1,5,0.8
vs. Ranked (AP),2015,Texas A&M,0,3,3,0.0
vs. Unranked (AP),2015,Texas A&M,8,2,10,0.8
vs. FBS (I-A),2015,Texas A&M,7,5,12,0.5833333333333334
vs. FCS (I-AA),2015,Texas A&M,1,0,1,1.0
vs. FBS Winning,2015,Texas A&M,3,5,8,0.375
vs. FBS Non-Winning,2015,Texas A&M,4,0,4,1.0
vs. BCS AQ,2015,Texas A&M,5,5,10,0.5
vs. BCS non-AQ,2015,Texas A&M,2,0,2,1.0
vs. FBS Power 5,2015,Texas A&M,5,5,10,0.5
vs. FBS non-Power 5,2015,Texas A&M,2,0,2,1.0
in August/September,2015,Texas A&M,4,0,4,1.0
in October,2015,Texas A&M,2,2,4,0.5
in November,2015,Texas A&M,2,2,4,0.5
in December/January,2015,Texas A&M,0,1,1,0.0
All Games,2016,Texas A&M,8,5,13,0.6153846153846154
at Home,2016,Texas A&M,5,2,7,0.7142857142857143
on Road/Neutral Site,2016,Texas A&M,3,3,6,0.5
vs. Conference,2016,Texas A&M,4,4,8,0.5
vs. Non-Conference,2016,Texas A&M,4,1,5,0.8
vs. Ranked (AP),2016,Texas A&M,1,2,3,0.3333333333333333
vs. Unranked (AP),2016,Texas A&M,7,3,10,0.7
vs. FBS (I-A),2016,Texas A&M,7,5,12,0.5833333333333334
vs. FCS (I-AA),2016,Texas A&M,1,0,1,1.0
vs. FBS Winning,2016,Texas A&M,3,3,6,0.5
vs. FBS Non-Winning,2016,Texas A&M,4,2,6,0.6666666666666666
vs. BCS AQ,2016,Texas A&M,5,5,10,0.5
vs. BCS non-AQ,2016,Texas A&M,2,0,2,1.0
vs. FBS Power 5,2016,Texas A&M,5,5,10,0.5
vs. FBS non-Power 5,2016,Texas A&M,2,0,2,1.0
in August/September,2016,Texas A&M,4,0,4,1.0
in October,2016,Texas A&M,3,1,4,0.75
in November,2016,Texas A&M,1,3,4,0.25
in December/January,2016,Texas A&M,0,1,1,0.0
All Games,2017,Texas A&M,7,6,13,0.5384615384615384
at Home,2017,Texas A&M,4,3,7,0.5714285714285714
on Road/Neutral Site,2017,Texas A&M,3,3,6,0.5
vs. Conference,2017,Texas A&M,4,4,8,0.5
vs. Non-Conference,2017,Texas A&M,3,2,5,0.6
vs. Ranked (AP),2017,Texas A&M,0,4,4,0.0
vs. Unranked (AP),2017,Texas A&M,7,2,9,0.7777777777777778
vs. FBS (I-A),2017,Texas A&M,6,6,12,0.5
vs. FCS (I-AA),2017,Texas A&M,1,0,1,1.0
vs. FBS Winning,2017,Texas A&M,1,5,6,0.16666666666666666
vs. FBS Non-Winning,2017,Texas A&M,5,1,6,0.8333333333333334
vs. BCS AQ,2017,Texas A&M,4,6,10,0.4
vs. BCS non-AQ,2017,Texas A&M,2,0,2,1.0
vs. FBS Power 5,2017,Texas A&M,4,6,10,0.4
vs. FBS non-Power 5,2017,Texas A&M,2,0,2,1.0
in August/September,2017,Texas A&M,4,1,5,0.8
in October,2017,Texas A&M,1,2,3,0.3333333333333333
in November,2017,Texas A&M,2,2,4,0.5
in December/January,2017,Texas A&M,0,1,1,0.0
All Games,2018,Texas A&M,9,4,13,0.6923076923076923
at Home,2018,Texas A&M,6,1,7,0.8571428571428571
on Road/Neutral Site,2018,Texas A&M,3,3,6,0.5
vs. Conference,2018,Texas A&M,5,3,8,0.625
vs. Non-Conference,2018,Texas A&M,4,1,5,0.8
vs. Ranked (AP),2018,Texas A&M,2,2,4,0.5
vs. Unranked (AP),2018,Texas A&M,7,2,9,0.7777777777777778
vs. FBS (I-A),2018,Texas A&M,8,4,12,0.6666666666666666
vs. FCS (I-AA),2018,Texas A&M,1,0,1,1.0
vs. FBS Winning,2018,Texas A&M,5,4,9,0.5555555555555556
vs. FBS Non-Winning,2018,Texas A&M,3,0,3,1.0
vs. BCS AQ,2018,Texas A&M,6,4,10,0.6
vs. BCS non-AQ,2018,Texas A&M,2,0,2,1.0
vs. FBS Power 5,2018,Texas A&M,6,4,10,0.6
vs. FBS non-Power 5,2018,Texas A&M,2,0,2,1.0
in August/September,2018,Texas A&M,3,2,5,0.6
in October,2018,Texas A&M,2,1,3,0.6666666666666666
in November,2018,Texas A&M,3,1,4,0.75
in December/January,2018,Texas A&M,1,0,1,1.0
All Games,2019,Texas A&M,8,5,13,0.6153846153846154
at Home,2019,Texas A&M,5,2,7,0.7142857142857143
on Road/Neutral Site,2019,Texas A&M,3,3,6,0.5
vs. Conference,2019,Texas A&M,4,4,8,0.5
vs. Non-Conference,2019,Texas A&M,4,1,5,0.8
vs. Ranked (AP),2019,Texas A&M,0,5,5,0.0
vs. Unranked (AP),2019,Texas A&M,8,0,8,1.0
vs. FBS (I-A),2019,Texas A&M,7,5,12,0.5833333333333334
vs. FCS (I-AA),2019,Texas A&M,1,0,1,1.0
vs. FBS Winning,2019,Texas A&M,1,5,6,0.16666666666666666
vs. FBS Non-Winning,2019,Texas A&M,6,0,6,1.0
vs. BCS AQ,2019,Texas A&M,5,5,10,0.5
vs. BCS non-AQ,2019,Texas A&M,2,0,2,1.0
vs. FBS Power 5,2019,Texas A&M,5,5,10,0.5
vs. FBS non-Power 5,2019,Texas A&M,2,0,2,1.0
in August/September,2019,Texas A&M,3,2,5,0.6
in October,2019,Texas A&M,2,1,3,0.6666666666666666
in November,2019,Texas A&M,2,2,4,0.5
in December/January,2019,Texas A&M,1,0,1,1.0
All Games,2020,Texas A&M,9,1,10,0.9
at Home,2020,Texas A&M,4,0,4,1.0
on Road/Neutral Site,2020,Texas A&M,5,1,6,0.8333333333333334
vs. Conference,2020,Texas A&M,8,1,9,0.8888888888888888
vs. Non-Conference,2020,Texas A&M,1,0,1,1.0
vs. Ranked (AP),2020,Texas A&M,2,1,3,0.6666666666666666
vs. Unranked (AP),2020,Texas A&M,7,0,7,1.0
vs. FBS (I-A),2020,Texas A&M,9,1,10,0.9
vs. FCS (I-AA),2020,Texas A&M,0,0,0,
vs. FBS Winning,2020,Texas A&M,3,1,4,0.75
vs. FBS Non-Winning,2020,Texas A&M,6,0,6,1.0
vs. BCS AQ,2020,Texas A&M,9,1,10,0.9
vs. BCS non-AQ,2020,Texas A&M,0,0,0,
vs. FBS Power 5,2020,Texas A&M,9,1,10,0.9
vs. FBS non-Power 5,2020,Texas A&M,0,0,0,
in August/September,2020,Texas A&M,1,0,1,1.0
in October,2020,Texas A&M,3,1,4,0.75
in November,2020,Texas A&M,2,0,2,1.0
in December/January,2020,Texas A&M,3,0,3,1.0
All Games,2021,Texas A&M,8,4,12,0.6666666666666666
at Home,2021,Texas A&M,6,1,7,0.8571428571428571
on Road/Neutral Site,2021,Texas A&M,2,3,5,0.4
vs. Conference,2021,Texas A&M,4,4,8,0.5
vs. Non-Conference,2021,Texas A&M,4,0,4,1.0
vs. Ranked (AP),2021,Texas A&M,1,2,3,0.3333333333333333
vs. Unranked (AP),2021,Texas A&M,7,2,9,0.7777777777777778
vs. FBS (I-A),2021,Texas A&M,7,4,11,0.6363636363636364
vs. FCS (I-AA),2021,Texas A&M,1,0,1,1.0
vs. FBS Winning,2021,Texas A&M,2,3,5,0.4
vs. FBS Non-Winning,2021,Texas A&M,5,1,6,0.8333333333333334
vs. BCS AQ,2021,Texas A&M,5,4,9,0.5555555555555556
vs. BCS non-AQ,2021,Texas A&M,2,0,2,1.0
vs. FBS Power 5,2021,Texas A&M,5,4,9,0.5555555555555556
vs. FBS non-Power 5,2021,Texas A&M,2,0,2,1.0
in August/September,2021,Texas A&M,3,1,4,0.75
in October,2021,Texas A&M,3,1,4,0.75
in November,2021,Texas A&M,2,2,4,0.5
in December/January,2021,Texas A&M,0,0,0,
All Games,2022,Texas A&M,5,7,12,0.4166666666666667
at Home,2022,Texas A&M,4,3,7,0.5714285714285714
on Road/Neutral Site,2022,Texas A&M,1,4,5,0.2
vs. Conference,2022,Texas A&M,2,6,8,0.25
vs. Non-Conference,2022,Texas A&M,3,1,4,0.75
vs. Ranked (AP),2022,Texas A&M,1,3,4,0.25
vs. Unranked (AP),2022,Texas A&M,4,4,8,0.5
vs. FBS (I-A),2022,Texas A&M,4,7,11,0.36363636363636365
vs. FCS (I-AA),2022,Texas A&M,1,0,1,1.0
vs. FBS Winning,2022,Texas A&M,2,4,6,0.3333333333333333
vs. FBS Non-Winning,2022,Texas A&M,2,3,5,0.4
vs. BCS AQ,2022,Texas A&M,3,6,9,0.3333333333333333
vs. BCS non-AQ,2022,Texas A&M,1,1,2,0.5
vs. FBS Power 5,2022,Texas A&M,3,6,9,0.3333333333333333
vs. FBS non-Power 5,2022,Texas A&M,1,1,2,0.5
in August/September,2022,Texas A&M,3,1,4,0.75
in October,2022,Texas A&M,0,4,4,0.0
in November,2022,Texas A&M,2,2,4,0.5
in December/January,2022,Texas A&M,0,0,0,
All Games,2012,Texas State,4,8,12,0.3333333333333333
at Home,2012,Texas State,3,3,6,0.5
on Road/Neutral Site,2012,Texas State,1,5,6,0.16666666666666666
vs. Conference,2012,Texas State,2,4,6,0.3333333333333333
vs. Non-Conference,2012,Texas State,2,4,6,0.3333333333333333
vs. Ranked (AP),2012,Texas State,0,2,2,0.0
vs. Unranked (AP),2012,Texas State,4,6,10,0.4
vs. FBS (I-A),2012,Texas State,3,8,11,0.2727272727272727
vs. FCS (I-AA),2012,Texas State,1,0,1,1.0
vs. FBS Winning,2012,Texas State,0,7,7,0.0
vs. FBS Non-Winning,2012,Texas State,3,1,4,0.75
vs. BCS AQ,2012,Texas State,0,1,1,0.0
vs. BCS non-AQ,2012,Texas State,3,7,10,0.3
vs. FBS Power 5,2012,Texas State,0,1,1,0.0
vs. FBS non-Power 5,2012,Texas State,3,7,10,0.3
in August/September,2012,Texas State,2,2,4,0.5
in October,2012,Texas State,1,2,3,0.3333333333333333
in November,2012,Texas State,0,4,4,0.0
in December/January,2012,Texas State,1,0,1,1.0
All Games,2013,Texas State,6,6,12,0.5
at Home,2013,Texas State,4,2,6,0.6666666666666666
on Road/Neutral Site,2013,Texas State,2,4,6,0.3333333333333333
vs. Conference,2013,Texas State,2,5,7,0.2857142857142857
vs. Non-Conference,2013,Texas State,4,1,5,0.8
vs. Ranked (AP),2013,Texas State,0,0,0,
vs. Unranked (AP),2013,Texas State,6,6,12,0.5
vs. FBS (I-A),2013,Texas State,5,6,11,0.45454545454545453
vs. FCS (I-AA),2013,Texas State,1,0,1,1.0
vs. FBS Winning,2013,Texas State,0,4,4,0.0
vs. FBS Non-Winning,2013,Texas State,5,2,7,0.7142857142857143
vs. BCS AQ,2013,Texas State,0,1,1,0.0
vs. BCS non-AQ,2013,Texas State,5,5,10,0.5
vs. FBS Power 5,2013,Texas State,0,1,1,0.0
vs. FBS non-Power 5,2013,Texas State,5,5,10,0.5
in August/September,2013,Texas State,3,1,4,0.75
in October,2013,Texas State,2,2,4,0.5
in November,2013,Texas State,1,3,4,0.25
in December/January,2013,Texas State,0,0,0,
All Games,2014,Texas State,7,5,12,0.5833333333333334
at Home,2014,Texas State,3,3,6,0.5
on Road/Neutral Site,2014,Texas State,4,2,6,0.6666666666666666
vs. Conference,2014,Texas State,5,3,8,0.625
vs. Non-Conference,2014,Texas State,2,2,4,0.5
vs. Ranked (AP),2014,Texas State,0,0,0,
vs. Unranked (AP),2014,Texas State,7,5,12,0.5833333333333334
vs. FBS (I-A),2014,Texas State,6,5,11,0.5454545454545454
vs. FCS (I-AA),2014,Texas State,1,0,1,1.0
vs. FBS Winning,2014,Texas State,1,3,4,0.25
vs. FBS Non-Winning,2014,Texas State,5,2,7,0.7142857142857143
vs. BCS AQ,2014,Texas State,1,1,2,0.5
vs. BCS non-AQ,2014,Texas State,5,4,9,0.5555555555555556
vs. FBS Power 5,2014,Texas State,0,1,1,0.0
vs. FBS non-Power 5,2014,Texas State,6,4,10,0.6
in August/September,2014,Texas State,2,2,4,0.5
in October,2014,Texas State,2,1,3,0.6666666666666666
in November,2014,Texas State,3,2,5,0.6
in December/January,2014,Texas State,0,0,0,
All Games,2015,Texas State,3,9,12,0.25
at Home,2015,Texas State,3,3,6,0.5
on Road/Neutral Site,2015,Texas State,0,6,6,0.0
vs. Conference,2015,Texas State,2,6,8,0.25
vs. Non-Conference,2015,Texas State,1,3,4,0.25
vs. Ranked (AP),2015,Texas State,0,2,2,0.0
vs. Unranked (AP),2015,Texas State,3,7,10,0.3
vs. FBS (I-A),2015,Texas State,2,9,11,0.18181818181818182
vs. FCS (I-AA),2015,Texas State,1,0,1,1.0
vs. FBS Winning,2015,Texas State,0,5,5,0.0
vs. FBS Non-Winning,2015,Texas State,2,4,6,0.3333333333333333
vs. BCS AQ,2015,Texas State,0,2,2,0.0
vs. BCS non-AQ,2015,Texas State,2,7,9,0.2222222222222222
vs. FBS Power 5,2015,Texas State,0,1,1,0.0
vs. FBS non-Power 5,2015,Texas State,2,8,10,0.2
in August/September,2015,Texas State,1,3,4,0.25
in October,2015,Texas State,1,2,3,0.3333333333333333
in November,2015,Texas State,1,3,4,0.25
in December/January,2015,Texas State,0,1,1,0.0
All Games,2016,Texas State,2,10,12,0.16666666666666666
at Home,2016,Texas State,1,5,6,0.16666666666666666
on Road/Neutral Site,2016,Texas State,1,5,6,0.16666666666666666
vs. Conference,2016,Texas State,0,8,8,0.0
vs. Non-Conference,2016,Texas State,2,2,4,0.5
vs. Ranked (AP),2016,Texas State,0,0,0,
vs. Unranked (AP),2016,Texas State,2,10,12,0.16666666666666666
vs. FBS (I-A),2016,Texas State,1,10,11,0.09090909090909091
vs. FCS (I-AA),2016,Texas State,1,0,1,1.0
vs. FBS Winning,2016,Texas State,1,6,7,0.14285714285714285
vs. FBS Non-Winning,2016,Texas State,0,4,4,0.0
vs. BCS AQ,2016,Texas State,0,2,2,0.0
vs. BCS non-AQ,2016,Texas State,1,8,9,0.1111111111111111
vs. FBS Power 5,2016,Texas State,0,1,1,0.0
vs. FBS non-Power 5,2016,Texas State,1,9,10,0.1
in August/September,2016,Texas State,1,2,3,0.3333333333333333
in October,2016,Texas State,1,3,4,0.25
in November,2016,Texas State,0,4,4,0.0
in December/January,2016,Texas State,0,1,1,0.0
All Games,2017,Texas State,2,10,12,0.16666666666666666
at Home,2017,Texas State,1,5,6,0.16666666666666666
on Road/Neutral Site,2017,Texas State,1,5,6,0.16666666666666666
vs. Conference,2017,Texas State,1,7,8,0.125
vs. Non-Conference,2017,Texas State,1,3,4,0.25
vs. Ranked (AP),2017,Texas State,0,0,0,
vs. Unranked (AP),2017,Texas State,2,10,12,0.16666666666666666
vs. FBS (I-A),2017,Texas State,1,10,11,0.09090909090909091
vs. FCS (I-AA),2017,Texas State,1,0,1,1.0
vs. FBS Winning,2017,Texas State,0,7,7,0.0
vs. FBS Non-Winning,2017,Texas State,1,3,4,0.25
vs. BCS AQ,2017,Texas State,0,1,1,0.0
vs. BCS non-AQ,2017,Texas State,1,9,10,0.1
vs. FBS Power 5,2017,Texas State,0,1,1,0.0
vs. FBS non-Power 5,2017,Texas State,1,9,10,0.1
in August/September,2017,Texas State,1,4,5,0.2
in October,2017,Texas State,1,2,3,0.3333333333333333
in November,2017,Texas State,0,4,4,0.0
in December/January,2017,Texas State,0,0,0,
All Games,2018,Texas State,3,9,12,0.25
at Home,2018,Texas State,2,4,6,0.3333333333333333
on Road/Neutral Site,2018,Texas State,1,5,6,0.16666666666666666
vs. Conference,2018,Texas State,1,7,8,0.125
vs. Non-Conference,2018,Texas State,2,2,4,0.5
vs. Ranked (AP),2018,Texas State,0,0,0,
vs. Unranked (AP),2018,Texas State,3,9,12,0.25
vs. FBS (I-A),2018,Texas State,2,9,11,0.18181818181818182
vs. FCS (I-AA),2018,Texas State,1,0,1,1.0
vs. FBS Winning,2018,Texas State,0,4,4,0.0
vs. FBS Non-Winning,2018,Texas State,2,5,7,0.2857142857142857
vs. BCS AQ,2018,Texas State,0,1,1,0.0
vs. BCS non-AQ,2018,Texas State,2,8,10,0.2
vs. FBS Power 5,2018,Texas State,0,1,1,0.0
vs. FBS non-Power 5,2018,Texas State,2,8,10,0.2
in August/September,2018,Texas State,1,3,4,0.25
in October,2018,Texas State,1,3,4,0.25
in November,2018,Texas State,1,3,4,0.25
in December/January,2018,Texas State,0,0,0,
All Games,2019,Texas State,3,9,12,0.25
at Home,2019,Texas State,3,3,6,0.5
on Road/Neutral Site,2019,Texas State,0,6,6,0.0
vs. Conference,2019,Texas State,2,6,8,0.25
vs. Non-Conference,2019,Texas State,1,3,4,0.25
vs. Ranked (AP),2019,Texas State,0,1,1,0.0
vs. Unranked (AP),2019,Texas State,3,8,11,0.2727272727272727
vs. FBS (I-A),2019,Texas State,2,9,11,0.18181818181818182
vs. FCS (I-AA),2019,Texas State,1,0,1,1.0
vs. FBS Winning,2019,Texas State,1,6,7,0.14285714285714285
vs. FBS Non-Winning,2019,Texas State,1,3,4,0.25
vs. BCS AQ,2019,Texas State,0,2,2,0.0
vs. BCS non-AQ,2019,Texas State,2,7,9,0.2222222222222222
vs. FBS Power 5,2019,Texas State,0,1,1,0.0
vs. FBS non-Power 5,2019,Texas State,2,8,10,0.2
in August/September,2019,Texas State,2,3,5,0.4
in October,2019,Texas State,0,2,2,0.0
in November,2019,Texas State,1,4,5,0.2
in December/January,2019,Texas State,0,0,0,
All Games,2020,Texas State,2,10,12,0.16666666666666666
at Home,2020,Texas State,1,5,6,0.16666666666666666
on Road/Neutral Site,2020,Texas State,1,5,6,0.16666666666666666
vs. Conference,2020,Texas State,2,6,8,0.25
vs. Non-Conference,2020,Texas State,0,4,4,0.0
vs. Ranked (AP),2020,Texas State,0,3,3,0.0
vs. Unranked (AP),2020,Texas State,2,7,9,0.2222222222222222
vs. FBS (I-A),2020,Texas State,2,10,12,0.16666666666666666
vs. FCS (I-AA),2020,Texas State,0,0,0,
vs. FBS Winning,2020,Texas State,0,8,8,0.0
vs. FBS Non-Winning,2020,Texas State,2,2,4,0.5
vs. BCS AQ,2020,Texas State,0,2,2,0.0
vs. BCS non-AQ,2020,Texas State,2,8,10,0.2
vs. FBS Power 5,2020,Texas State,0,1,1,0.0
vs. FBS non-Power 5,2020,Texas State,2,9,11,0.18181818181818182
in August/September,2020,Texas State,1,3,4,0.25
in October,2020,Texas State,0,4,4,0.0
in November,2020,Texas State,1,3,4,0.25
in December/January,2020,Texas State,0,0,0,
All Games,2021,Texas State,4,8,12,0.3333333333333333
at Home,2021,Texas State,2,4,6,0.3333333333333333
on Road/Neutral Site,2021,Texas State,2,4,6,0.3333333333333333
vs. Conference,2021,Texas State,3,5,8,0.375
vs. Non-Conference,2021,Texas State,1,3,4,0.25
vs. Ranked (AP),2021,Texas State,0,2,2,0.0
vs. Unranked (AP),2021,Texas State,4,6,10,0.4
vs. FBS (I-A),2021,Texas State,4,7,11,0.36363636363636365
vs. FCS (I-AA),2021,Texas State,0,1,1,0.0
vs. FBS Winning,2021,Texas State,0,5,5,0.0
vs. FBS Non-Winning,2021,Texas State,4,2,6,0.6666666666666666
vs. BCS AQ,2021,Texas State,0,1,1,0.0
vs. BCS non-AQ,2021,Texas State,4,6,10,0.4
vs. FBS Power 5,2021,Texas State,0,1,1,0.0
vs. FBS non-Power 5,2021,Texas State,4,6,10,0.4
in August/September,2021,Texas State,1,3,4,0.25
in October,2021,Texas State,1,3,4,0.25
in November,2021,Texas State,2,2,4,0.5
in December/January,2021,Texas State,0,0,0,
All Games,2022,Texas State,4,8,12,0.3333333333333333
at Home,2022,Texas State,4,2,6,0.6666666666666666
on Road/Neutral Site,2022,Texas State,0,6,6,0.0
vs. Conference,2022,Texas State,2,6,8,0.25
vs. Non-Conference,2022,Texas State,2,2,4,0.5
vs. Ranked (AP),2022,Texas State,0,1,1,0.0
vs. Unranked (AP),2022,Texas State,4,7,11,0.36363636363636365
vs. FBS (I-A),2022,Texas State,3,8,11,0.2727272727272727
vs. FCS (I-AA),2022,Texas State,1,0,1,1.0
vs. FBS Winning,2022,Texas State,0,4,4,0.0
vs. FBS Non-Winning,2022,Texas State,3,4,7,0.42857142857142855
vs. BCS AQ,2022,Texas State,0,1,1,0.0
vs. BCS non-AQ,2022,Texas State,3,7,10,0.3
vs. FBS Power 5,2022,Texas State,0,1,1,0.0
vs. FBS non-Power 5,2022,Texas State,3,7,10,0.3
in August/September,2022,Texas State,2,2,4,0.5
in October,2022,Texas State,1,3,4,0.25
in November,2022,Texas State,1,3,4,0.25
in December/January,2022,Texas State,0,0,0,
All Games,2009,Texas Tech,9,4,13,0.6923076923076923
at Home,2009,Texas Tech,6,1,7,0.8571428571428571
on Road/Neutral Site,2009,Texas Tech,3,3,6,0.5
vs. Conference,2009,Texas Tech,5,3,8,0.625
vs. Non-Conference,2009,Texas Tech,4,1,5,0.8
vs. Ranked (AP),2009,Texas Tech,1,1,2,0.5
vs. Unranked (AP),2009,Texas Tech,8,3,11,0.7272727272727273
vs. FBS (I-A),2009,Texas Tech,8,4,12,0.6666666666666666
vs. FCS (I-AA),2009,Texas Tech,1,0,1,1.0
vs. FBS Winning,2009,Texas Tech,2,3,5,0.4
vs. FBS Non-Winning,2009,Texas Tech,6,1,7,0.8571428571428571
vs. BCS AQ,2009,Texas Tech,6,3,9,0.6666666666666666
vs. BCS non-AQ,2009,Texas Tech,2,1,3,0.6666666666666666
vs. FBS Power 5,2009,Texas Tech,6,3,9,0.6666666666666666
vs. FBS non-Power 5,2009,Texas Tech,2,1,3,0.6666666666666666
in August/September,2009,Texas Tech,2,2,4,0.5
in October,2009,Texas Tech,4,1,5,0.8
in November,2009,Texas Tech,2,1,3,0.6666666666666666
in December/January,2009,Texas Tech,1,0,1,1.0
All Games,2010,Texas Tech,8,5,13,0.6153846153846154
at Home,2010,Texas Tech,4,2,6,0.6666666666666666
on Road/Neutral Site,2010,Texas Tech,4,3,7,0.5714285714285714
vs. Conference,2010,Texas Tech,3,5,8,0.375
vs. Non-Conference,2010,Texas Tech,5,0,5,1.0
vs. Ranked (AP),2010,Texas Tech,1,3,4,0.25
vs. Unranked (AP),2010,Texas Tech,7,2,9,0.7777777777777778
vs. FBS (I-A),2010,Texas Tech,7,5,12,0.5833333333333334
vs. FCS (I-AA),2010,Texas Tech,1,0,1,1.0
vs. FBS Winning,2010,Texas Tech,3,3,6,0.5
vs. FBS Non-Winning,2010,Texas Tech,4,2,6,0.6666666666666666
vs. BCS AQ,2010,Texas Tech,4,5,9,0.4444444444444444
vs. BCS non-AQ,2010,Texas Tech,3,0,3,1.0
vs. FBS Power 5,2010,Texas Tech,4,5,9,0.4444444444444444
vs. FBS non-Power 5,2010,Texas Tech,3,0,3,1.0
in August/September,2010,Texas Tech,2,1,3,0.6666666666666666
in October,2010,Texas Tech,2,3,5,0.4
in November,2010,Texas Tech,3,1,4,0.75
in December/January,2010,Texas Tech,1,0,1,1.0
All Games,2011,Texas Tech,5,7,12,0.4166666666666667
at Home,2011,Texas Tech,2,4,6,0.3333333333333333
on Road/Neutral Site,2011,Texas Tech,3,3,6,0.5
vs. Conference,2011,Texas Tech,2,7,9,0.2222222222222222
vs. Non-Conference,2011,Texas Tech,3,0,3,1.0
vs. Ranked (AP),2011,Texas Tech,1,3,4,0.25
vs. Unranked (AP),2011,Texas Tech,4,4,8,0.5
vs. FBS (I-A),2011,Texas Tech,4,7,11,0.36363636363636365
vs. FCS (I-AA),2011,Texas Tech,1,0,1,1.0
vs. FBS Winning,2011,Texas Tech,2,6,8,0.25
vs. FBS Non-Winning,2011,Texas Tech,2,1,3,0.6666666666666666
vs. BCS AQ,2011,Texas Tech,2,7,9,0.2222222222222222
vs. BCS non-AQ,2011,Texas Tech,2,0,2,1.0
vs. FBS Power 5,2011,Texas Tech,2,7,9,0.2222222222222222
vs. FBS non-Power 5,2011,Texas Tech,2,0,2,1.0
in August/September,2011,Texas Tech,3,0,3,1.0
in October,2011,Texas Tech,2,3,5,0.4
in November,2011,Texas Tech,0,4,4,0.0
in December/January,2011,Texas Tech,0,0,0,
All Games,2012,Texas Tech,8,5,13,0.6153846153846154
at Home,2012,Texas Tech,4,2,6,0.6666666666666666
on Road/Neutral Site,2012,Texas Tech,4,3,7,0.5714285714285714
vs. Conference,2012,Texas Tech,4,5,9,0.4444444444444444
vs. Non-Conference,2012,Texas Tech,4,0,4,1.0
vs. Ranked (AP),2012,Texas Tech,0,3,3,0.0
vs. Unranked (AP),2012,Texas Tech,8,2,10,0.8
vs. FBS (I-A),2012,Texas Tech,7,5,12,0.5833333333333334
vs. FCS (I-AA),2012,Texas Tech,1,0,1,1.0
vs. FBS Winning,2012,Texas Tech,2,5,7,0.2857142857142857
vs. FBS Non-Winning,2012,Texas Tech,5,0,5,1.0
vs. BCS AQ,2012,Texas Tech,5,5,10,0.5
vs. BCS non-AQ,2012,Texas Tech,2,0,2,1.0
vs. FBS Power 5,2012,Texas Tech,5,5,10,0.5
vs. FBS non-Power 5,2012,Texas Tech,2,0,2,1.0
in August/September,2012,Texas Tech,4,0,4,1.0
in October,2012,Texas Tech,2,2,4,0.5
in November,2012,Texas Tech,1,3,4,0.25
in December/January,2012,Texas Tech,1,0,1,1.0
All Games,2013,Texas Tech,8,5,13,0.6153846153846154
at Home,2013,Texas Tech,4,2,6,0.6666666666666666
on Road/Neutral Site,2013,Texas Tech,4,3,7,0.5714285714285714
vs. Conference,2013,Texas Tech,4,5,9,0.4444444444444444
vs. Non-Conference,2013,Texas Tech,4,0,4,1.0
vs. Ranked (AP),2013,Texas Tech,1,3,4,0.25
vs. Unranked (AP),2013,Texas Tech,7,2,9,0.7777777777777778
vs. FBS (I-A),2013,Texas Tech,7,5,12,0.5833333333333334
vs. FCS (I-AA),2013,Texas Tech,1,0,1,1.0
vs. FBS Winning,2013,Texas Tech,1,5,6,0.16666666666666666
vs. FBS Non-Winning,2013,Texas Tech,6,0,6,1.0
vs. BCS AQ,2013,Texas Tech,6,5,11,0.5454545454545454
vs. BCS non-AQ,2013,Texas Tech,1,0,1,1.0
vs. FBS Power 5,2013,Texas Tech,5,5,10,0.5
vs. FBS non-Power 5,2013,Texas Tech,2,0,2,1.0
in August/September,2013,Texas Tech,4,0,4,1.0
in October,2013,Texas Tech,3,1,4,0.75
in November,2013,Texas Tech,0,4,4,0.0
in December/January,2013,Texas Tech,1,0,1,1.0
All Games,2014,Texas Tech,4,8,12,0.3333333333333333
at Home,2014,Texas Tech,2,4,6,0.3333333333333333
on Road/Neutral Site,2014,Texas Tech,2,4,6,0.3333333333333333
vs. Conference,2014,Texas Tech,2,7,9,0.2222222222222222
vs. Non-Conference,2014,Texas Tech,2,1,3,0.6666666666666666
vs. Ranked (AP),2014,Texas Tech,0,3,3,0.0
vs. Unranked (AP),2014,Texas Tech,4,5,9,0.4444444444444444
vs. FBS (I-A),2014,Texas Tech,3,8,11,0.2727272727272727
vs. FCS (I-AA),2014,Texas Tech,1,0,1,1.0
vs. FBS Winning,2014,Texas Tech,1,7,8,0.125
vs. FBS Non-Winning,2014,Texas Tech,2,1,3,0.6666666666666666
vs. BCS AQ,2014,Texas Tech,2,8,10,0.2
vs. BCS non-AQ,2014,Texas Tech,1,0,1,1.0
vs. FBS Power 5,2014,Texas Tech,2,8,10,0.2
vs. FBS non-Power 5,2014,Texas Tech,1,0,1,1.0
in August/September,2014,Texas Tech,2,2,4,0.5
in October,2014,Texas Tech,1,3,4,0.25
in November,2014,Texas Tech,1,3,4,0.25
in December/January,2014,Texas Tech,0,0,0,
All Games,2015,Texas Tech,7,6,13,0.5384615384615384
at Home,2015,Texas Tech,4,2,6,0.6666666666666666
on Road/Neutral Site,2015,Texas Tech,3,4,7,0.42857142857142855
vs. Conference,2015,Texas Tech,4,5,9,0.4444444444444444
vs. Non-Conference,2015,Texas Tech,3,1,4,0.75
vs. Ranked (AP),2015,Texas Tech,0,5,5,0.0
vs. Unranked (AP),2015,Texas Tech,7,1,8,0.875
vs. FBS (I-A),2015,Texas Tech,6,6,12,0.5
vs. FCS (I-AA),2015,Texas Tech,1,0,1,1.0
vs. FBS Winning,2015,Texas Tech,1,6,7,0.14285714285714285
vs. FBS Non-Winning,2015,Texas Tech,5,0,5,1.0
vs. BCS AQ,2015,Texas Tech,5,6,11,0.45454545454545453
vs. BCS non-AQ,2015,Texas Tech,1,0,1,1.0
vs. FBS Power 5,2015,Texas Tech,5,6,11,0.45454545454545453
vs. FBS non-Power 5,2015,Texas Tech,1,0,1,1.0
in August/September,2015,Texas Tech,3,1,4,0.75
in October,2015,Texas Tech,2,3,5,0.4
in November,2015,Texas Tech,2,1,3,0.6666666666666666
in December/January,2015,Texas Tech,0,1,1,0.0
All Games,2016,Texas Tech,5,7,12,0.4166666666666667
at Home,2016,Texas Tech,3,3,6,0.5
on Road/Neutral Site,2016,Texas Tech,2,4,6,0.3333333333333333
vs. Conference,2016,Texas Tech,3,6,9,0.3333333333333333
vs. Non-Conference,2016,Texas Tech,2,1,3,0.6666666666666666
vs. Ranked (AP),2016,Texas Tech,0,3,3,0.0
vs. Unranked (AP),2016,Texas Tech,5,4,9,0.5555555555555556
vs. FBS (I-A),2016,Texas Tech,4,7,11,0.36363636363636365
vs. FCS (I-AA),2016,Texas Tech,1,0,1,1.0
vs. FBS Winning,2016,Texas Tech,2,4,6,0.3333333333333333
vs. FBS Non-Winning,2016,Texas Tech,2,3,5,0.4
vs. BCS AQ,2016,Texas Tech,3,7,10,0.3
vs. BCS non-AQ,2016,Texas Tech,1,0,1,1.0
vs. FBS Power 5,2016,Texas Tech,3,7,10,0.3
vs. FBS non-Power 5,2016,Texas Tech,1,0,1,1.0
in August/September,2016,Texas Tech,3,1,4,0.75
in October,2016,Texas Tech,1,3,4,0.25
in November,2016,Texas Tech,1,3,4,0.25
in December/January,2016,Texas Tech,0,0,0,
All Games,2017,Texas Tech,6,7,13,0.46153846153846156
at Home,2017,Texas Tech,2,4,6,0.3333333333333333
on Road/Neutral Site,2017,Texas Tech,4,3,7,0.5714285714285714
vs. Conference,2017,Texas Tech,3,6,9,0.3333333333333333
vs. Non-Conference,2017,Texas Tech,3,1,4,0.75
vs. Ranked (AP),2017,Texas Tech,0,4,4,0.0
vs. Unranked (AP),2017,Texas Tech,6,3,9,0.6666666666666666
vs. FBS (I-A),2017,Texas Tech,5,7,12,0.4166666666666667
vs. FCS (I-AA),2017,Texas Tech,1,0,1,1.0
vs. FBS Winning,2017,Texas Tech,3,7,10,0.3
vs. FBS Non-Winning,2017,Texas Tech,2,0,2,1.0
vs. BCS AQ,2017,Texas Tech,5,7,12,0.4166666666666667
vs. BCS non-AQ,2017,Texas Tech,0,0,0,
vs. FBS Power 5,2017,Texas Tech,4,6,10,0.4
vs. FBS non-Power 5,2017,Texas Tech,1,1,2,0.5
in August/September,2017,Texas Tech,3,1,4,0.75
in October,2017,Texas Tech,1,3,4,0.25
in November,2017,Texas Tech,2,2,4,0.5
in December/January,2017,Texas Tech,0,1,1,0.0
All Games,2018,Texas Tech,5,7,12,0.4166666666666667
at Home,2018,Texas Tech,3,3,6,0.5
on Road/Neutral Site,2018,Texas Tech,2,4,6,0.3333333333333333
vs. Conference,2018,Texas Tech,3,6,9,0.3333333333333333
vs. Non-Conference,2018,Texas Tech,2,1,3,0.6666666666666666
vs. Ranked (AP),2018,Texas Tech,0,3,3,0.0
vs. Unranked (AP),2018,Texas Tech,5,4,9,0.5555555555555556
vs. FBS (I-A),2018,Texas Tech,4,7,11,0.36363636363636365
vs. FCS (I-AA),2018,Texas Tech,1,0,1,1.0
vs. FBS Winning,2018,Texas Tech,3,5,8,0.375
vs. FBS Non-Winning,2018,Texas Tech,1,2,3,0.3333333333333333
vs. BCS AQ,2018,Texas Tech,4,7,11,0.36363636363636365
vs. BCS non-AQ,2018,Texas Tech,0,0,0,
vs. FBS Power 5,2018,Texas Tech,3,7,10,0.3
vs. FBS non-Power 5,2018,Texas Tech,1,0,1,1.0
in August/September,2018,Texas Tech,3,2,5,0.6
in October,2018,Texas Tech,2,1,3,0.6666666666666666
in November,2018,Texas Tech,0,4,4,0.0
in December/January,2018,Texas Tech,0,0,0,
All Games,2019,Texas Tech,4,8,12,0.3333333333333333
at Home,2019,Texas Tech,3,3,6,0.5
on Road/Neutral Site,2019,Texas Tech,1,5,6,0.16666666666666666
vs. Conference,2019,Texas Tech,2,7,9,0.2222222222222222
vs. Non-Conference,2019,Texas Tech,2,1,3,0.6666666666666666
vs. Ranked (AP),2019,Texas Tech,0,3,3,0.0
vs. Unranked (AP),2019,Texas Tech,4,5,9,0.4444444444444444
vs. FBS (I-A),2019,Texas Tech,3,8,11,0.2727272727272727
vs. FCS (I-AA),2019,Texas Tech,1,0,1,1.0
vs. FBS Winning,2019,Texas Tech,1,5,6,0.16666666666666666
vs. FBS Non-Winning,2019,Texas Tech,2,3,5,0.4
vs. BCS AQ,2019,Texas Tech,2,8,10,0.2
vs. BCS non-AQ,2019,Texas Tech,1,0,1,1.0
vs. FBS Power 5,2019,Texas Tech,2,8,10,0.2
vs. FBS non-Power 5,2019,Texas Tech,1,0,1,1.0
in August/September,2019,Texas Tech,2,2,4,0.5
in October,2019,Texas Tech,1,3,4,0.25
in November,2019,Texas Tech,1,3,4,0.25
in December/January,2019,Texas Tech,0,0,0,
All Games,2020,Texas Tech,4,6,10,0.4
at Home,2020,Texas Tech,4,2,6,0.6666666666666666
on Road/Neutral Site,2020,Texas Tech,0,4,4,0.0
vs. Conference,2020,Texas Tech,3,6,9,0.3333333333333333
vs. Non-Conference,2020,Texas Tech,1,0,1,1.0
vs. Ranked (AP),2020,Texas Tech,0,3,3,0.0
vs. Unranked (AP),2020,Texas Tech,4,3,7,0.5714285714285714
vs. FBS (I-A),2020,Texas Tech,3,6,9,0.3333333333333333
vs. FCS (I-AA),2020,Texas Tech,1,0,1,1.0
vs. FBS Winning,2020,Texas Tech,1,5,6,0.16666666666666666
vs. FBS Non-Winning,2020,Texas Tech,2,1,3,0.6666666666666666
vs. BCS AQ,2020,Texas Tech,3,6,9,0.3333333333333333
vs. BCS non-AQ,2020,Texas Tech,0,0,0,
vs. FBS Power 5,2020,Texas Tech,3,6,9,0.3333333333333333
vs. FBS non-Power 5,2020,Texas Tech,0,0,0,
in August/September,2020,Texas Tech,1,1,2,0.5
in October,2020,Texas Tech,1,3,4,0.25
in November,2020,Texas Tech,1,2,3,0.3333333333333333
in December/January,2020,Texas Tech,1,0,1,1.0
All Games,2021,Texas Tech,7,6,13,0.5384615384615384
at Home,2021,Texas Tech,3,3,6,0.5
on Road/Neutral Site,2021,Texas Tech,4,3,7,0.5714285714285714
vs. Conference,2021,Texas Tech,3,6,9,0.3333333333333333
vs. Non-Conference,2021,Texas Tech,4,0,4,1.0
vs. Ranked (AP),2021,Texas Tech,1,3,4,0.25
vs. Unranked (AP),2021,Texas Tech,6,3,9,0.6666666666666666
vs. FBS (I-A),2021,Texas Tech,6,6,12,0.5
vs. FCS (I-AA),2021,Texas Tech,1,0,1,1.0
vs. FBS Winning,2021,Texas Tech,3,4,7,0.42857142857142855
vs. FBS Non-Winning,2021,Texas Tech,3,2,5,0.6
vs. BCS AQ,2021,Texas Tech,5,6,11,0.45454545454545453
vs. BCS non-AQ,2021,Texas Tech,1,0,1,1.0
vs. FBS Power 5,2021,Texas Tech,4,6,10,0.4
vs. FBS non-Power 5,2021,Texas Tech,2,0,2,1.0
in August/September,2021,Texas Tech,3,1,4,0.75
in October,2021,Texas Tech,2,3,5,0.4
in November,2021,Texas Tech,1,2,3,0.3333333333333333
in December/January,2021,Texas Tech,1,0,1,1.0
All Games,2022,Texas Tech,8,5,13,0.6153846153846154
at Home,2022,Texas Tech,6,1,7,0.8571428571428571
on Road/Neutral Site,2022,Texas Tech,2,4,6,0.3333333333333333
vs. Conference,2022,Texas Tech,5,4,9,0.5555555555555556
vs. Non-Conference,2022,Texas Tech,3,1,4,0.75
vs. Ranked (AP),2022,Texas Tech,1,2,3,0.3333333333333333
vs. Unranked (AP),2022,Texas Tech,7,3,10,0.7
vs. FBS (I-A),2022,Texas Tech,7,5,12,0.5833333333333334
vs. FCS (I-AA),2022,Texas Tech,1,0,1,1.0
vs. FBS Winning,2022,Texas Tech,3,4,7,0.42857142857142855
vs. FBS Non-Winning,2022,Texas Tech,4,1,5,0.8
vs. BCS AQ,2022,Texas Tech,7,5,12,0.5833333333333334
vs. BCS non-AQ,2022,Texas Tech,0,0,0,
vs. FBS Power 5,2022,Texas Tech,6,5,11,0.5454545454545454
vs. FBS non-Power 5,2022,Texas Tech,1,0,1,1.0
in August/September,2022,Texas Tech,3,1,4,0.75
in October,2022,Texas Tech,1,3,4,0.25
in November,2022,Texas Tech,3,1,4,0.75
in December/January,2022,Texas Tech,1,0,1,1.0
All Games,2009,Toledo,5,7,12,0.4166666666666667
at Home,2009,Toledo,3,2,5,0.6
on Road/Neutral Site,2009,Toledo,2,5,7,0.2857142857142857
vs. Conference,2009,Toledo,3,5,8,0.375
vs. Non-Conference,2009,Toledo,2,2,4,0.5
vs. Ranked (AP),2009,Toledo,0,2,2,0.0
vs. Unranked (AP),2009,Toledo,5,5,10,0.5
vs. FBS (I-A),2009,Toledo,5,7,12,0.4166666666666667
vs. FCS (I-AA),2009,Toledo,0,0,0,
vs. FBS Winning,2009,Toledo,1,4,5,0.2
vs. FBS Non-Winning,2009,Toledo,4,3,7,0.5714285714285714
vs. BCS AQ,2009,Toledo,1,2,3,0.3333333333333333
vs. BCS non-AQ,2009,Toledo,4,5,9,0.4444444444444444
vs. FBS Power 5,2009,Toledo,1,2,3,0.3333333333333333
vs. FBS non-Power 5,2009,Toledo,4,5,9,0.4444444444444444
in August/September,2009,Toledo,2,2,4,0.5
in October,2009,Toledo,2,3,5,0.4
in November,2009,Toledo,1,2,3,0.3333333333333333
in December/January,2009,Toledo,0,0,0,
All Games,2010,Toledo,8,5,13,0.6153846153846154
at Home,2010,Toledo,4,2,6,0.6666666666666666
on Road/Neutral Site,2010,Toledo,4,3,7,0.5714285714285714
vs. Conference,2010,Toledo,7,1,8,0.875
vs. Non-Conference,2010,Toledo,1,4,5,0.2
vs. Ranked (AP),2010,Toledo,0,1,1,0.0
vs. Unranked (AP),2010,Toledo,8,4,12,0.6666666666666666
vs. FBS (I-A),2010,Toledo,8,5,13,0.6153846153846154
vs. FCS (I-AA),2010,Toledo,0,0,0,
vs. FBS Winning,2010,Toledo,1,4,5,0.2
vs. FBS Non-Winning,2010,Toledo,7,1,8,0.875
vs. BCS AQ,2010,Toledo,1,1,2,0.5
vs. BCS non-AQ,2010,Toledo,7,4,11,0.6363636363636364
vs. FBS Power 5,2010,Toledo,1,1,2,0.5
vs. FBS non-Power 5,2010,Toledo,7,4,11,0.6363636363636364
in August/September,2010,Toledo,3,1,4,0.75
in October,2010,Toledo,3,2,5,0.6
in November,2010,Toledo,2,1,3,0.6666666666666666
in December/January,2010,Toledo,0,1,1,0.0
All Games,2011,Toledo,9,4,13,0.6923076923076923
at Home,2011,Toledo,4,2,6,0.6666666666666666
on Road/Neutral Site,2011,Toledo,5,2,7,0.7142857142857143
vs. Conference,2011,Toledo,7,1,8,0.875
vs. Non-Conference,2011,Toledo,2,3,5,0.4
vs. Ranked (AP),2011,Toledo,0,1,1,0.0
vs. Unranked (AP),2011,Toledo,9,3,12,0.75
vs. FBS (I-A),2011,Toledo,8,4,12,0.6666666666666666
vs. FCS (I-AA),2011,Toledo,1,0,1,1.0
vs. FBS Winning,2011,Toledo,3,2,5,0.6
vs. FBS Non-Winning,2011,Toledo,5,2,7,0.7142857142857143
vs. BCS AQ,2011,Toledo,0,2,2,0.0
vs. BCS non-AQ,2011,Toledo,8,2,10,0.8
vs. FBS Power 5,2011,Toledo,0,1,1,0.0
vs. FBS non-Power 5,2011,Toledo,8,3,11,0.7272727272727273
in August/September,2011,Toledo,1,3,4,0.25
in October,2011,Toledo,4,0,4,1.0
in November,2011,Toledo,3,1,4,0.75
in December/January,2011,Toledo,1,0,1,1.0
All Games,2012,Toledo,9,4,13,0.6923076923076923
at Home,2012,Toledo,5,1,6,0.8333333333333334
on Road/Neutral Site,2012,Toledo,4,3,7,0.5714285714285714
vs. Conference,2012,Toledo,6,2,8,0.75
vs. Non-Conference,2012,Toledo,3,2,5,0.6
vs. Ranked (AP),2012,Toledo,0,2,2,0.0
vs. Unranked (AP),2012,Toledo,9,2,11,0.8181818181818182
vs. FBS (I-A),2012,Toledo,8,4,12,0.6666666666666666
vs. FCS (I-AA),2012,Toledo,1,0,1,1.0
vs. FBS Winning,2012,Toledo,3,4,7,0.42857142857142855
vs. FBS Non-Winning,2012,Toledo,5,0,5,1.0
vs. BCS AQ,2012,Toledo,1,1,2,0.5
vs. BCS non-AQ,2012,Toledo,7,3,10,0.7
vs. FBS Power 5,2012,Toledo,0,1,1,0.0
vs. FBS non-Power 5,2012,Toledo,8,3,11,0.7272727272727273
in August/September,2012,Toledo,4,1,5,0.8
in October,2012,Toledo,4,0,4,1.0
in November,2012,Toledo,1,2,3,0.3333333333333333
in December/January,2012,Toledo,0,1,1,0.0
All Games,2013,Toledo,7,5,12,0.5833333333333334
at Home,2013,Toledo,5,1,6,0.8333333333333334
on Road/Neutral Site,2013,Toledo,2,4,6,0.3333333333333333
vs. Conference,2013,Toledo,5,3,8,0.625
vs. Non-Conference,2013,Toledo,2,2,4,0.5
vs. Ranked (AP),2013,Toledo,0,1,1,0.0
vs. Unranked (AP),2013,Toledo,7,4,11,0.6363636363636364
vs. FBS (I-A),2013,Toledo,6,5,11,0.5454545454545454
vs. FCS (I-AA),2013,Toledo,1,0,1,1.0
vs. FBS Winning,2013,Toledo,3,3,6,0.5
vs. FBS Non-Winning,2013,Toledo,3,2,5,0.6
vs. BCS AQ,2013,Toledo,0,2,2,0.0
vs. BCS non-AQ,2013,Toledo,6,3,9,0.6666666666666666
vs. FBS Power 5,2013,Toledo,0,2,2,0.0
vs. FBS non-Power 5,2013,Toledo,6,3,9,0.6666666666666666
in August/September,2013,Toledo,2,3,5,0.4
in October,2013,Toledo,3,0,3,1.0
in November,2013,Toledo,2,2,4,0.5
in December/January,2013,Toledo,0,0,0,
All Games,2014,Toledo,9,4,13,0.6923076923076923
at Home,2014,Toledo,5,1,6,0.8333333333333334
on Road/Neutral Site,2014,Toledo,4,3,7,0.5714285714285714
vs. Conference,2014,Toledo,7,1,8,0.875
vs. Non-Conference,2014,Toledo,2,3,5,0.4
vs. Ranked (AP),2014,Toledo,0,1,1,0.0
vs. Unranked (AP),2014,Toledo,9,3,12,0.75
vs. FBS (I-A),2014,Toledo,8,4,12,0.6666666666666666
vs. FCS (I-AA),2014,Toledo,1,0,1,1.0
vs. FBS Winning,2014,Toledo,4,3,7,0.5714285714285714
vs. FBS Non-Winning,2014,Toledo,4,1,5,0.8
vs. BCS AQ,2014,Toledo,0,3,3,0.0
vs. BCS non-AQ,2014,Toledo,8,1,9,0.8888888888888888
vs. FBS Power 5,2014,Toledo,0,2,2,0.0
vs. FBS non-Power 5,2014,Toledo,8,2,10,0.8
in August/September,2014,Toledo,3,2,5,0.6
in October,2014,Toledo,2,1,3,0.6666666666666666
in November,2014,Toledo,3,1,4,0.75
in December/January,2014,Toledo,1,0,1,1.0
All Games,2015,Toledo,10,2,12,0.8333333333333334
at Home,2015,Toledo,4,2,6,0.6666666666666666
on Road/Neutral Site,2015,Toledo,6,0,6,1.0
vs. Conference,2015,Toledo,6,2,8,0.75
vs. Non-Conference,2015,Toledo,4,0,4,1.0
vs. Ranked (AP),2015,Toledo,0,0,0,
vs. Unranked (AP),2015,Toledo,10,2,12,0.8333333333333334
vs. FBS (I-A),2015,Toledo,10,2,12,0.8333333333333334
vs. FCS (I-AA),2015,Toledo,0,0,0,
vs. FBS Winning,2015,Toledo,5,2,7,0.7142857142857143
vs. FBS Non-Winning,2015,Toledo,5,0,5,1.0
vs. BCS AQ,2015,Toledo,3,0,3,1.0
vs. BCS non-AQ,2015,Toledo,7,2,9,0.7777777777777778
vs. FBS Power 5,2015,Toledo,2,0,2,1.0
vs. FBS non-Power 5,2015,Toledo,8,2,10,0.8
in August/September,2015,Toledo,3,0,3,1.0
in October,2015,Toledo,4,0,4,1.0
in November,2015,Toledo,2,2,4,0.5
in December/January,2015,Toledo,1,0,1,1.0
All Games,2016,Toledo,9,4,13,0.6923076923076923
at Home,2016,Toledo,5,1,6,0.8333333333333334
on Road/Neutral Site,2016,Toledo,4,3,7,0.5714285714285714
vs. Conference,2016,Toledo,6,2,8,0.75
vs. Non-Conference,2016,Toledo,3,2,5,0.6
vs. Ranked (AP),2016,Toledo,0,1,1,0.0
vs. Unranked (AP),2016,Toledo,9,3,12,0.75
vs. FBS (I-A),2016,Toledo,8,4,12,0.6666666666666666
vs. FCS (I-AA),2016,Toledo,1,0,1,1.0
vs. FBS Winning,2016,Toledo,2,4,6,0.3333333333333333
vs. FBS Non-Winning,2016,Toledo,6,0,6,1.0
vs. BCS AQ,2016,Toledo,0,0,0,
vs. BCS non-AQ,2016,Toledo,8,4,12,0.6666666666666666
vs. FBS Power 5,2016,Toledo,0,0,0,
vs. FBS non-Power 5,2016,Toledo,8,4,12,0.6666666666666666
in August/September,2016,Toledo,3,1,4,0.75
in October,2016,Toledo,3,1,4,0.75
in November,2016,Toledo,3,1,4,0.75
in December/January,2016,Toledo,0,1,1,0.0
All Games,2017,Toledo,11,3,14,0.7857142857142857
at Home,2017,Toledo,6,0,6,1.0
on Road/Neutral Site,2017,Toledo,5,3,8,0.625
vs. Conference,2017,Toledo,8,1,9,0.8888888888888888
vs. Non-Conference,2017,Toledo,3,2,5,0.6
vs. Ranked (AP),2017,Toledo,0,1,1,0.0
vs. Unranked (AP),2017,Toledo,11,2,13,0.8461538461538461
vs. FBS (I-A),2017,Toledo,10,3,13,0.7692307692307693
vs. FCS (I-AA),2017,Toledo,1,0,1,1.0
vs. FBS Winning,2017,Toledo,2,3,5,0.4
vs. FBS Non-Winning,2017,Toledo,8,0,8,1.0
vs. BCS AQ,2017,Toledo,1,1,2,0.5
vs. BCS non-AQ,2017,Toledo,9,2,11,0.8181818181818182
vs. FBS Power 5,2017,Toledo,0,1,1,0.0
vs. FBS non-Power 5,2017,Toledo,10,2,12,0.8333333333333334
in August/September,2017,Toledo,3,1,4,0.75
in October,2017,Toledo,4,0,4,1.0
in November,2017,Toledo,3,1,4,0.75
in December/January,2017,Toledo,1,1,2,0.5
All Games,2018,Toledo,7,6,13,0.5384615384615384
at Home,2018,Toledo,5,2,7,0.7142857142857143
on Road/Neutral Site,2018,Toledo,2,4,6,0.3333333333333333
vs. Conference,2018,Toledo,5,3,8,0.625
vs. Non-Conference,2018,Toledo,2,3,5,0.4
vs. Ranked (AP),2018,Toledo,0,1,1,0.0
vs. Unranked (AP),2018,Toledo,7,5,12,0.5833333333333334
vs. FBS (I-A),2018,Toledo,6,6,12,0.5
vs. FCS (I-AA),2018,Toledo,1,0,1,1.0
vs. FBS Winning,2018,Toledo,2,6,8,0.25
vs. FBS Non-Winning,2018,Toledo,4,0,4,1.0
vs. BCS AQ,2018,Toledo,0,1,1,0.0
vs. BCS non-AQ,2018,Toledo,6,5,11,0.5454545454545454
vs. FBS Power 5,2018,Toledo,0,1,1,0.0
vs. FBS non-Power 5,2018,Toledo,6,5,11,0.5454545454545454
in August/September,2018,Toledo,2,2,4,0.5
in October,2018,Toledo,3,2,5,0.6
in November,2018,Toledo,2,1,3,0.6666666666666666
in December/January,2018,Toledo,0,1,1,0.0
All Games,2019,Toledo,6,6,12,0.5
at Home,2019,Toledo,5,1,6,0.8333333333333334
on Road/Neutral Site,2019,Toledo,1,5,6,0.16666666666666666
vs. Conference,2019,Toledo,3,5,8,0.375
vs. Non-Conference,2019,Toledo,3,1,4,0.75
vs. Ranked (AP),2019,Toledo,0,0,0,
vs. Unranked (AP),2019,Toledo,6,6,12,0.5
vs. FBS (I-A),2019,Toledo,5,6,11,0.45454545454545453
vs. FCS (I-AA),2019,Toledo,1,0,1,1.0
vs. FBS Winning,2019,Toledo,3,3,6,0.5
vs. FBS Non-Winning,2019,Toledo,2,3,5,0.4
vs. BCS AQ,2019,Toledo,0,1,1,0.0
vs. BCS non-AQ,2019,Toledo,5,5,10,0.5
vs. FBS Power 5,2019,Toledo,0,1,1,0.0
vs. FBS non-Power 5,2019,Toledo,5,5,10,0.5
in August/September,2019,Toledo,3,1,4,0.75
in October,2019,Toledo,2,2,4,0.5
in November,2019,Toledo,1,3,4,0.25
in December/January,2019,Toledo,0,0,0,
All Games,2020,Toledo,4,2,6,0.6666666666666666
at Home,2020,Toledo,2,1,3,0.6666666666666666
on Road/Neutral Site,2020,Toledo,2,1,3,0.6666666666666666
vs. Conference,2020,Toledo,4,2,6,0.6666666666666666
vs. Non-Conference,2020,Toledo,0,0,0,
vs. Ranked (AP),2020,Toledo,0,0,0,
vs. Unranked (AP),2020,Toledo,4,2,6,0.6666666666666666
vs. FBS (I-A),2020,Toledo,4,2,6,0.6666666666666666
vs. FCS (I-AA),2020,Toledo,0,0,0,
vs. FBS Winning,2020,Toledo,0,2,2,0.0
vs. FBS Non-Winning,2020,Toledo,4,0,4,1.0
vs. BCS AQ,2020,Toledo,0,0,0,
vs. BCS non-AQ,2020,Toledo,4,2,6,0.6666666666666666
vs. FBS Power 5,2020,Toledo,0,0,0,
vs. FBS non-Power 5,2020,Toledo,4,2,6,0.6666666666666666
in August/September,2020,Toledo,0,0,0,
in October,2020,Toledo,0,0,0,
in November,2020,Toledo,2,2,4,0.5
in December/January,2020,Toledo,2,0,2,1.0
All Games,2021,Toledo,7,6,13,0.5384615384615384
at Home,2021,Toledo,3,3,6,0.5
on Road/Neutral Site,2021,Toledo,4,3,7,0.5714285714285714
vs. Conference,2021,Toledo,5,3,8,0.625
vs. Non-Conference,2021,Toledo,2,3,5,0.4
vs. Ranked (AP),2021,Toledo,0,1,1,0.0
vs. Unranked (AP),2021,Toledo,7,5,12,0.5833333333333334
vs. FBS (I-A),2021,Toledo,6,6,12,0.5
vs. FCS (I-AA),2021,Toledo,1,0,1,1.0
vs. FBS Winning,2021,Toledo,1,5,6,0.16666666666666666
vs. FBS Non-Winning,2021,Toledo,5,1,6,0.8333333333333334
vs. BCS AQ,2021,Toledo,0,1,1,0.0
vs. BCS non-AQ,2021,Toledo,6,5,11,0.5454545454545454
vs. FBS Power 5,2021,Toledo,0,0,0,
vs. FBS non-Power 5,2021,Toledo,6,6,12,0.5
in August/September,2021,Toledo,2,2,4,0.5
in October,2021,Toledo,2,2,4,0.5
in November,2021,Toledo,3,1,4,0.75
in December/January,2021,Toledo,0,1,1,0.0
All Games,2022,Toledo,9,5,14,0.6428571428571429
at Home,2022,Toledo,5,1,6,0.8333333333333334
on Road/Neutral Site,2022,Toledo,4,4,8,0.5
vs. Conference,2022,Toledo,6,3,9,0.6666666666666666
vs. Non-Conference,2022,Toledo,3,2,5,0.6
vs. Ranked (AP),2022,Toledo,0,1,1,0.0
vs. Unranked (AP),2022,Toledo,9,4,13,0.6923076923076923
vs. FBS (I-A),2022,Toledo,8,5,13,0.6153846153846154
vs. FCS (I-AA),2022,Toledo,1,0,1,1.0
vs. FBS Winning,2022,Toledo,3,3,6,0.5
vs. FBS Non-Winning,2022,Toledo,5,2,7,0.7142857142857143
vs. BCS AQ,2022,Toledo,0,1,1,0.0
vs. BCS non-AQ,2022,Toledo,8,4,12,0.6666666666666666
vs. FBS Power 5,2022,Toledo,0,1,1,0.0
vs. FBS non-Power 5,2022,Toledo,8,4,12,0.6666666666666666
in August/September,2022,Toledo,2,2,4,0.5
in October,2022,Toledo,4,1,5,0.8
in November,2022,Toledo,1,2,3,0.3333333333333333
in December/January,2022,Toledo,2,0,2,1.0
All Games,2009,Troy,9,4,13,0.6923076923076923
at Home,2009,Troy,5,0,5,1.0
on Road/Neutral Site,2009,Troy,4,4,8,0.5
vs. Conference,2009,Troy,8,0,8,1.0
vs. Non-Conference,2009,Troy,1,4,5,0.2
vs. Ranked (AP),2009,Troy,0,2,2,0.0
vs. Unranked (AP),2009,Troy,9,2,11,0.8181818181818182
vs. FBS (I-A),2009,Troy,9,4,13,0.6923076923076923
vs. FCS (I-AA),2009,Troy,0,0,0,
vs. FBS Winning,2009,Troy,1,4,5,0.2
vs. FBS Non-Winning,2009,Troy,8,0,8,1.0
vs. BCS AQ,2009,Troy,0,2,2,0.0
vs. BCS non-AQ,2009,Troy,9,2,11,0.8181818181818182
vs. FBS Power 5,2009,Troy,0,2,2,0.0
vs. FBS non-Power 5,2009,Troy,9,2,11,0.8181818181818182
in August/September,2009,Troy,2,2,4,0.5
in October,2009,Troy,4,0,4,1.0
in November,2009,Troy,3,1,4,0.75
in December/January,2009,Troy,0,1,1,0.0
All Games,2010,Troy,8,5,13,0.6153846153846154
at Home,2010,Troy,4,1,5,0.8
on Road/Neutral Site,2010,Troy,4,4,8,0.5
vs. Conference,2010,Troy,6,2,8,0.75
vs. Non-Conference,2010,Troy,2,3,5,0.4
vs. Ranked (AP),2010,Troy,0,2,2,0.0
vs. Unranked (AP),2010,Troy,8,3,11,0.7272727272727273
vs. FBS (I-A),2010,Troy,8,5,13,0.6153846153846154
vs. FCS (I-AA),2010,Troy,0,0,0,
vs. FBS Winning,2010,Troy,1,3,4,0.25
vs. FBS Non-Winning,2010,Troy,7,2,9,0.7777777777777778
vs. BCS AQ,2010,Troy,0,2,2,0.0
vs. BCS non-AQ,2010,Troy,8,3,11,0.7272727272727273
vs. FBS Power 5,2010,Troy,0,2,2,0.0
vs. FBS non-Power 5,2010,Troy,8,3,11,0.7272727272727273
in August/September,2010,Troy,2,2,4,0.5
in October,2010,Troy,2,1,3,0.6666666666666666
in November,2010,Troy,2,2,4,0.5
in December/January,2010,Troy,2,0,2,1.0
All Games,2011,Troy,3,9,12,0.25
at Home,2011,Troy,3,2,5,0.6
on Road/Neutral Site,2011,Troy,0,7,7,0.0
vs. Conference,2011,Troy,2,6,8,0.25
vs. Non-Conference,2011,Troy,1,3,4,0.25
vs. Ranked (AP),2011,Troy,0,2,2,0.0
vs. Unranked (AP),2011,Troy,3,7,10,0.3
vs. FBS (I-A),2011,Troy,3,9,12,0.25
vs. FCS (I-AA),2011,Troy,0,0,0,
vs. FBS Winning,2011,Troy,0,6,6,0.0
vs. FBS Non-Winning,2011,Troy,3,3,6,0.5
vs. BCS AQ,2011,Troy,0,2,2,0.0
vs. BCS non-AQ,2011,Troy,3,7,10,0.3
vs. FBS Power 5,2011,Troy,0,2,2,0.0
vs. FBS non-Power 5,2011,Troy,3,7,10,0.3
in August/September,2011,Troy,1,2,3,0.3333333333333333
in October,2011,Troy,1,3,4,0.25
in November,2011,Troy,1,3,4,0.25
in December/January,2011,Troy,0,1,1,0.0
All Games,2012,Troy,5,7,12,0.4166666666666667
at Home,2012,Troy,2,4,6,0.3333333333333333
on Road/Neutral Site,2012,Troy,3,3,6,0.5
vs. Conference,2012,Troy,3,5,8,0.375
vs. Non-Conference,2012,Troy,2,2,4,0.5
vs. Ranked (AP),2012,Troy,0,0,0,
vs. Unranked (AP),2012,Troy,5,7,12,0.4166666666666667
vs. FBS (I-A),2012,Troy,5,7,12,0.4166666666666667
vs. FCS (I-AA),2012,Troy,0,0,0,
vs. FBS Winning,2012,Troy,1,5,6,0.16666666666666666
vs. FBS Non-Winning,2012,Troy,4,2,6,0.6666666666666666
vs. BCS AQ,2012,Troy,0,2,2,0.0
vs. BCS non-AQ,2012,Troy,5,5,10,0.5
vs. FBS Power 5,2012,Troy,0,2,2,0.0
vs. FBS non-Power 5,2012,Troy,5,5,10,0.5
in August/September,2012,Troy,3,2,5,0.6
in October,2012,Troy,1,2,3,0.3333333333333333
in November,2012,Troy,1,3,4,0.25
in December/January,2012,Troy,0,0,0,
All Games,2013,Troy,6,6,12,0.5
at Home,2013,Troy,4,1,5,0.8
on Road/Neutral Site,2013,Troy,2,5,7,0.2857142857142857
vs. Conference,2013,Troy,4,3,7,0.5714285714285714
vs. Non-Conference,2013,Troy,2,3,5,0.4
vs. Ranked (AP),2013,Troy,0,1,1,0.0
vs. Unranked (AP),2013,Troy,6,5,11,0.5454545454545454
vs. FBS (I-A),2013,Troy,5,6,11,0.45454545454545453
vs. FCS (I-AA),2013,Troy,1,0,1,1.0
vs. FBS Winning,2013,Troy,1,5,6,0.16666666666666666
vs. FBS Non-Winning,2013,Troy,4,1,5,0.8
vs. BCS AQ,2013,Troy,0,3,3,0.0
vs. BCS non-AQ,2013,Troy,5,3,8,0.625
vs. FBS Power 5,2013,Troy,0,3,3,0.0
vs. FBS non-Power 5,2013,Troy,5,3,8,0.625
in August/September,2013,Troy,2,3,5,0.4
in October,2013,Troy,3,1,4,0.75
in November,2013,Troy,1,2,3,0.3333333333333333
in December/January,2013,Troy,0,0,0,
All Games,2014,Troy,3,9,12,0.25
at Home,2014,Troy,2,4,6,0.3333333333333333
on Road/Neutral Site,2014,Troy,1,5,6,0.16666666666666666
vs. Conference,2014,Troy,3,5,8,0.375
vs. Non-Conference,2014,Troy,0,4,4,0.0
vs. Ranked (AP),2014,Troy,0,1,1,0.0
vs. Unranked (AP),2014,Troy,3,8,11,0.2727272727272727
vs. FBS (I-A),2014,Troy,3,8,11,0.2727272727272727
vs. FCS (I-AA),2014,Troy,0,1,1,0.0
vs. FBS Winning,2014,Troy,0,5,5,0.0
vs. FBS Non-Winning,2014,Troy,3,3,6,0.5
vs. BCS AQ,2014,Troy,0,2,2,0.0
vs. BCS non-AQ,2014,Troy,3,6,9,0.3333333333333333
vs. FBS Power 5,2014,Troy,0,2,2,0.0
vs. FBS non-Power 5,2014,Troy,3,6,9,0.3333333333333333
in August/September,2014,Troy,0,5,5,0.0
in October,2014,Troy,1,3,4,0.25
in November,2014,Troy,2,1,3,0.6666666666666666
in December/January,2014,Troy,0,0,0,
All Games,2015,Troy,4,8,12,0.3333333333333333
at Home,2015,Troy,2,3,5,0.4
on Road/Neutral Site,2015,Troy,2,5,7,0.2857142857142857
vs. Conference,2015,Troy,3,5,8,0.375
vs. Non-Conference,2015,Troy,1,3,4,0.25
vs. Ranked (AP),2015,Troy,0,1,1,0.0
vs. Unranked (AP),2015,Troy,4,7,11,0.36363636363636365
vs. FBS (I-A),2015,Troy,3,8,11,0.2727272727272727
vs. FCS (I-AA),2015,Troy,1,0,1,1.0
vs. FBS Winning,2015,Troy,0,5,5,0.0
vs. FBS Non-Winning,2015,Troy,3,3,6,0.5
vs. BCS AQ,2015,Troy,0,3,3,0.0
vs. BCS non-AQ,2015,Troy,3,5,8,0.375
vs. FBS Power 5,2015,Troy,0,3,3,0.0
vs. FBS non-Power 5,2015,Troy,3,5,8,0.375
in August/September,2015,Troy,1,2,3,0.3333333333333333
in October,2015,Troy,1,4,5,0.2
in November,2015,Troy,1,2,3,0.3333333333333333
in December/January,2015,Troy,1,0,1,1.0
All Games,2016,Troy,10,3,13,0.7692307692307693
at Home,2016,Troy,5,1,6,0.8333333333333334
on Road/Neutral Site,2016,Troy,5,2,7,0.7142857142857143
vs. Conference,2016,Troy,6,2,8,0.75
vs. Non-Conference,2016,Troy,4,1,5,0.8
vs. Ranked (AP),2016,Troy,0,1,1,0.0
vs. Unranked (AP),2016,Troy,10,2,12,0.8333333333333334
vs. FBS (I-A),2016,Troy,9,3,12,0.75
vs. FCS (I-AA),2016,Troy,1,0,1,1.0
vs. FBS Winning,2016,Troy,4,2,6,0.6666666666666666
vs. FBS Non-Winning,2016,Troy,5,1,6,0.8333333333333334
vs. BCS AQ,2016,Troy,0,1,1,0.0
vs. BCS non-AQ,2016,Troy,9,2,11,0.8181818181818182
vs. FBS Power 5,2016,Troy,0,1,1,0.0
vs. FBS non-Power 5,2016,Troy,9,2,11,0.8181818181818182
in August/September,2016,Troy,3,1,4,0.75
in October,2016,Troy,3,0,3,1.0
in November,2016,Troy,3,1,4,0.75
in December/January,2016,Troy,1,1,2,0.5
All Games,2017,Troy,11,2,13,0.8461538461538461
at Home,2017,Troy,5,1,6,0.8333333333333334
on Road/Neutral Site,2017,Troy,6,1,7,0.8571428571428571
vs. Conference,2017,Troy,7,1,8,0.875
vs. Non-Conference,2017,Troy,4,1,5,0.8
vs. Ranked (AP),2017,Troy,1,1,2,0.5
vs. Unranked (AP),2017,Troy,10,1,11,0.9090909090909091
vs. FBS (I-A),2017,Troy,10,2,12,0.8333333333333334
vs. FCS (I-AA),2017,Troy,1,0,1,1.0
vs. FBS Winning,2017,Troy,5,1,6,0.8333333333333334
vs. FBS Non-Winning,2017,Troy,5,1,6,0.8333333333333334
vs. BCS AQ,2017,Troy,1,0,1,1.0
vs. BCS non-AQ,2017,Troy,9,2,11,0.8181818181818182
vs. FBS Power 5,2017,Troy,1,0,1,1.0
vs. FBS non-Power 5,2017,Troy,9,2,11,0.8181818181818182
in August/September,2017,Troy,4,1,5,0.8
in October,2017,Troy,2,1,3,0.6666666666666666
in November,2017,Troy,3,0,3,1.0
in December/January,2017,Troy,2,0,2,1.0
All Games,2018,Troy,10,3,13,0.7692307692307693
at Home,2018,Troy,5,1,6,0.8333333333333334
on Road/Neutral Site,2018,Troy,5,2,7,0.7142857142857143
vs. Conference,2018,Troy,7,1,8,0.875
vs. Non-Conference,2018,Troy,3,2,5,0.6
vs. Ranked (AP),2018,Troy,0,1,1,0.0
vs. Unranked (AP),2018,Troy,10,2,12,0.8333333333333334
vs. FBS (I-A),2018,Troy,9,3,12,0.75
vs. FCS (I-AA),2018,Troy,1,0,1,1.0
vs. FBS Winning,2018,Troy,2,2,4,0.5
vs. FBS Non-Winning,2018,Troy,7,1,8,0.875
vs. BCS AQ,2018,Troy,1,0,1,1.0
vs. BCS non-AQ,2018,Troy,8,3,11,0.7272727272727273
vs. FBS Power 5,2018,Troy,1,0,1,1.0
vs. FBS non-Power 5,2018,Troy,8,3,11,0.7272727272727273
in August/September,2018,Troy,4,1,5,0.8
in October,2018,Troy,2,1,3,0.6666666666666666
in November,2018,Troy,3,1,4,0.75
in December/January,2018,Troy,1,0,1,1.0
All Games,2019,Troy,5,7,12,0.4166666666666667
at Home,2019,Troy,3,3,6,0.5
on Road/Neutral Site,2019,Troy,2,4,6,0.3333333333333333
vs. Conference,2019,Troy,3,5,8,0.375
vs. Non-Conference,2019,Troy,2,2,4,0.5
vs. Ranked (AP),2019,Troy,0,1,1,0.0
vs. Unranked (AP),2019,Troy,5,6,11,0.45454545454545453
vs. FBS (I-A),2019,Troy,4,7,11,0.36363636363636365
vs. FCS (I-AA),2019,Troy,1,0,1,1.0
vs. FBS Winning,2019,Troy,1,5,6,0.16666666666666666
vs. FBS Non-Winning,2019,Troy,3,2,5,0.6
vs. BCS AQ,2019,Troy,0,1,1,0.0
vs. BCS non-AQ,2019,Troy,4,6,10,0.4
vs. FBS Power 5,2019,Troy,0,1,1,0.0
vs. FBS non-Power 5,2019,Troy,4,6,10,0.4
in August/September,2019,Troy,2,2,4,0.5
in October,2019,Troy,1,2,3,0.3333333333333333
in November,2019,Troy,2,3,5,0.4
in December/January,2019,Troy,0,0,0,
All Games,2020,Troy,5,6,11,0.45454545454545453
at Home,2020,Troy,2,3,5,0.4
on Road/Neutral Site,2020,Troy,3,3,6,0.5
vs. Conference,2020,Troy,3,4,7,0.42857142857142855
vs. Non-Conference,2020,Troy,2,2,4,0.5
vs. Ranked (AP),2020,Troy,0,2,2,0.0
vs. Unranked (AP),2020,Troy,5,4,9,0.5555555555555556
vs. FBS (I-A),2020,Troy,4,6,10,0.4
vs. FCS (I-AA),2020,Troy,1,0,1,1.0
vs. FBS Winning,2020,Troy,0,5,5,0.0
vs. FBS Non-Winning,2020,Troy,4,1,5,0.8
vs. BCS AQ,2020,Troy,0,0,0,
vs. BCS non-AQ,2020,Troy,4,6,10,0.4
vs. FBS Power 5,2020,Troy,0,0,0,
vs. FBS non-Power 5,2020,Troy,4,6,10,0.4
in August/September,2020,Troy,1,1,2,0.5
in October,2020,Troy,3,1,4,0.75
in November,2020,Troy,0,3,3,0.0
in December/January,2020,Troy,1,1,2,0.5
All Games,2021,Troy,5,7,12,0.4166666666666667
at Home,2021,Troy,3,3,6,0.5
on Road/Neutral Site,2021,Troy,2,4,6,0.3333333333333333
vs. Conference,2021,Troy,3,5,8,0.375
vs. Non-Conference,2021,Troy,2,2,4,0.5
vs. Ranked (AP),2021,Troy,0,1,1,0.0
vs. Unranked (AP),2021,Troy,5,6,11,0.45454545454545453
vs. FBS (I-A),2021,Troy,4,7,11,0.36363636363636365
vs. FCS (I-AA),2021,Troy,1,0,1,1.0
vs. FBS Winning,2021,Troy,0,6,6,0.0
vs. FBS Non-Winning,2021,Troy,4,1,5,0.8
vs. BCS AQ,2021,Troy,0,1,1,0.0
vs. BCS non-AQ,2021,Troy,4,6,10,0.4
vs. FBS Power 5,2021,Troy,0,1,1,0.0
vs. FBS non-Power 5,2021,Troy,4,6,10,0.4
in August/September,2021,Troy,2,2,4,0.5
in October,2021,Troy,2,2,4,0.5
in November,2021,Troy,1,3,4,0.25
in December/January,2021,Troy,0,0,0,
All Games,2022,Troy,12,2,14,0.8571428571428571
at Home,2022,Troy,7,0,7,1.0
on Road/Neutral Site,2022,Troy,5,2,7,0.7142857142857143
vs. Conference,2022,Troy,8,1,9,0.8888888888888888
vs. Non-Conference,2022,Troy,4,1,5,0.8
vs. Ranked (AP),2022,Troy,0,0,0,
vs. Unranked (AP),2022,Troy,12,2,14,0.8571428571428571
vs. FBS (I-A),2022,Troy,11,2,13,0.8461538461538461
vs. FCS (I-AA),2022,Troy,1,0,1,1.0
vs. FBS Winning,2022,Troy,6,1,7,0.8571428571428571
vs. FBS Non-Winning,2022,Troy,5,1,6,0.8333333333333334
vs. BCS AQ,2022,Troy,0,1,1,0.0
vs. BCS non-AQ,2022,Troy,11,1,12,0.9166666666666666
vs. FBS Power 5,2022,Troy,0,1,1,0.0
vs. FBS non-Power 5,2022,Troy,11,1,12,0.9166666666666666
in August/September,2022,Troy,2,2,4,0.5
in October,2022,Troy,4,0,4,1.0
in November,2022,Troy,4,0,4,1.0
in December/January,2022,Troy,2,0,2,1.0
All Games,2009,Tulane,3,9,12,0.25
at Home,2009,Tulane,2,4,6,0.3333333333333333
on Road/Neutral Site,2009,Tulane,1,5,6,0.16666666666666666
vs. Conference,2009,Tulane,1,7,8,0.125
vs. Non-Conference,2009,Tulane,2,2,4,0.5
vs. Ranked (AP),2009,Tulane,0,2,2,0.0
vs. Unranked (AP),2009,Tulane,3,7,10,0.3
vs. FBS (I-A),2009,Tulane,2,9,11,0.18181818181818182
vs. FCS (I-AA),2009,Tulane,1,0,1,1.0
vs. FBS Winning,2009,Tulane,0,7,7,0.0
vs. FBS Non-Winning,2009,Tulane,2,2,4,0.5
vs. BCS AQ,2009,Tulane,0,1,1,0.0
vs. BCS non-AQ,2009,Tulane,2,8,10,0.2
vs. FBS Power 5,2009,Tulane,0,1,1,0.0
vs. FBS non-Power 5,2009,Tulane,2,8,10,0.2
in August/September,2009,Tulane,1,2,3,0.3333333333333333
in October,2009,Tulane,1,4,5,0.2
in November,2009,Tulane,1,3,4,0.25
in December/January,2009,Tulane,0,0,0,
All Games,2010,Tulane,4,8,12,0.3333333333333333
at Home,2010,Tulane,2,5,7,0.2857142857142857
on Road/Neutral Site,2010,Tulane,2,3,5,0.4
vs. Conference,2010,Tulane,2,6,8,0.25
vs. Non-Conference,2010,Tulane,2,2,4,0.5
vs. Ranked (AP),2010,Tulane,0,2,2,0.0
vs. Unranked (AP),2010,Tulane,4,6,10,0.4
vs. FBS (I-A),2010,Tulane,3,8,11,0.2727272727272727
vs. FCS (I-AA),2010,Tulane,1,0,1,1.0
vs. FBS Winning,2010,Tulane,0,4,4,0.0
vs. FBS Non-Winning,2010,Tulane,3,4,7,0.42857142857142855
vs. BCS AQ,2010,Tulane,1,1,2,0.5
vs. BCS non-AQ,2010,Tulane,2,7,9,0.2222222222222222
vs. FBS Power 5,2010,Tulane,0,1,1,0.0
vs. FBS non-Power 5,2010,Tulane,3,7,10,0.3
in August/September,2010,Tulane,1,2,3,0.3333333333333333
in October,2010,Tulane,2,3,5,0.4
in November,2010,Tulane,1,3,4,0.25
in December/January,2010,Tulane,0,0,0,
All Games,2011,Tulane,2,11,13,0.15384615384615385
at Home,2011,Tulane,1,5,6,0.16666666666666666
on Road/Neutral Site,2011,Tulane,1,6,7,0.14285714285714285
vs. Conference,2011,Tulane,1,7,8,0.125
vs. Non-Conference,2011,Tulane,1,4,5,0.2
vs. Ranked (AP),2011,Tulane,0,1,1,0.0
vs. Unranked (AP),2011,Tulane,2,10,12,0.16666666666666666
vs. FBS (I-A),2011,Tulane,1,11,12,0.08333333333333333
vs. FCS (I-AA),2011,Tulane,1,0,1,1.0
vs. FBS Winning,2011,Tulane,0,3,3,0.0
vs. FBS Non-Winning,2011,Tulane,1,8,9,0.1111111111111111
vs. BCS AQ,2011,Tulane,0,2,2,0.0
vs. BCS non-AQ,2011,Tulane,1,9,10,0.1
vs. FBS Power 5,2011,Tulane,0,1,1,0.0
vs. FBS non-Power 5,2011,Tulane,1,10,11,0.09090909090909091
in August/September,2011,Tulane,2,2,4,0.5
in October,2011,Tulane,0,5,5,0.0
in November,2011,Tulane,0,4,4,0.0
in December/January,2011,Tulane,0,0,0,
All Games,2012,Tulane,2,10,12,0.16666666666666666
at Home,2012,Tulane,2,5,7,0.2857142857142857
on Road/Neutral Site,2012,Tulane,0,5,5,0.0
vs. Conference,2012,Tulane,2,6,8,0.25
vs. Non-Conference,2012,Tulane,0,4,4,0.0
vs. Ranked (AP),2012,Tulane,0,0,0,
vs. Unranked (AP),2012,Tulane,2,10,12,0.16666666666666666
vs. FBS (I-A),2012,Tulane,2,10,12,0.16666666666666666
vs. FCS (I-AA),2012,Tulane,0,0,0,
vs. FBS Winning,2012,Tulane,1,7,8,0.125
vs. FBS Non-Winning,2012,Tulane,1,3,4,0.25
vs. BCS AQ,2012,Tulane,0,2,2,0.0
vs. BCS non-AQ,2012,Tulane,2,8,10,0.2
vs. FBS Power 5,2012,Tulane,0,1,1,0.0
vs. FBS non-Power 5,2012,Tulane,2,9,11,0.18181818181818182
in August/September,2012,Tulane,0,4,4,0.0
in October,2012,Tulane,2,2,4,0.5
in November,2012,Tulane,0,4,4,0.0
in December/January,2012,Tulane,0,0,0,
All Games,2013,Tulane,7,6,13,0.5384615384615384
at Home,2013,Tulane,5,1,6,0.8333333333333334
on Road/Neutral Site,2013,Tulane,2,5,7,0.2857142857142857
vs. Conference,2013,Tulane,5,3,8,0.625
vs. Non-Conference,2013,Tulane,2,3,5,0.4
vs. Ranked (AP),2013,Tulane,0,0,0,
vs. Unranked (AP),2013,Tulane,7,6,13,0.5384615384615384
vs. FBS (I-A),2013,Tulane,6,6,12,0.5
vs. FCS (I-AA),2013,Tulane,1,0,1,1.0
vs. FBS Winning,2013,Tulane,2,4,6,0.3333333333333333
vs. FBS Non-Winning,2013,Tulane,4,2,6,0.6666666666666666
vs. BCS AQ,2013,Tulane,0,1,1,0.0
vs. BCS non-AQ,2013,Tulane,6,5,11,0.5454545454545454
vs. FBS Power 5,2013,Tulane,0,1,1,0.0
vs. FBS non-Power 5,2013,Tulane,6,5,11,0.5454545454545454
in August/September,2013,Tulane,3,2,5,0.6
in October,2013,Tulane,3,0,3,1.0
in November,2013,Tulane,1,3,4,0.25
in December/January,2013,Tulane,0,1,1,0.0
All Games,2014,Tulane,3,9,12,0.25
at Home,2014,Tulane,2,4,6,0.3333333333333333
on Road/Neutral Site,2014,Tulane,1,5,6,0.16666666666666666
vs. Conference,2014,Tulane,2,6,8,0.25
vs. Non-Conference,2014,Tulane,1,3,4,0.25
vs. Ranked (AP),2014,Tulane,0,2,2,0.0
vs. Unranked (AP),2014,Tulane,3,7,10,0.3
vs. FBS (I-A),2014,Tulane,2,9,11,0.18181818181818182
vs. FCS (I-AA),2014,Tulane,1,0,1,1.0
vs. FBS Winning,2014,Tulane,1,7,8,0.125
vs. FBS Non-Winning,2014,Tulane,1,2,3,0.3333333333333333
vs. BCS AQ,2014,Tulane,2,9,11,0.18181818181818182
vs. BCS non-AQ,2014,Tulane,0,0,0,
vs. FBS Power 5,2014,Tulane,0,3,3,0.0
vs. FBS non-Power 5,2014,Tulane,2,6,8,0.25
in August/September,2014,Tulane,1,4,5,0.2
in October,2014,Tulane,1,2,3,0.3333333333333333
in November,2014,Tulane,1,2,3,0.3333333333333333
in December/January,2014,Tulane,0,1,1,0.0
All Games,2015,Tulane,3,9,12,0.25
at Home,2015,Tulane,2,4,6,0.3333333333333333
on Road/Neutral Site,2015,Tulane,1,5,6,0.16666666666666666
vs. Conference,2015,Tulane,1,7,8,0.125
vs. Non-Conference,2015,Tulane,2,2,4,0.5
vs. Ranked (AP),2015,Tulane,0,2,2,0.0
vs. Unranked (AP),2015,Tulane,3,7,10,0.3
vs. FBS (I-A),2015,Tulane,2,9,11,0.18181818181818182
vs. FCS (I-AA),2015,Tulane,1,0,1,1.0
vs. FBS Winning,2015,Tulane,0,5,5,0.0
vs. FBS Non-Winning,2015,Tulane,2,4,6,0.3333333333333333
vs. BCS AQ,2015,Tulane,1,9,10,0.1
vs. BCS non-AQ,2015,Tulane,1,0,1,1.0
vs. FBS Power 5,2015,Tulane,0,2,2,0.0
vs. FBS non-Power 5,2015,Tulane,2,7,9,0.2222222222222222
in August/September,2015,Tulane,1,2,3,0.3333333333333333
in October,2015,Tulane,1,4,5,0.2
in November,2015,Tulane,1,3,4,0.25
in December/January,2015,Tulane,0,0,0,
All Games,2016,Tulane,4,8,12,0.3333333333333333
at Home,2016,Tulane,2,4,6,0.3333333333333333
on Road/Neutral Site,2016,Tulane,2,4,6,0.3333333333333333
vs. Conference,2016,Tulane,1,7,8,0.125
vs. Non-Conference,2016,Tulane,3,1,4,0.75
vs. Ranked (AP),2016,Tulane,0,1,1,0.0
vs. Unranked (AP),2016,Tulane,4,7,11,0.36363636363636365
vs. FBS (I-A),2016,Tulane,3,8,11,0.2727272727272727
vs. FCS (I-AA),2016,Tulane,1,0,1,1.0
vs. FBS Winning,2016,Tulane,0,6,6,0.0
vs. FBS Non-Winning,2016,Tulane,3,2,5,0.6
vs. BCS AQ,2016,Tulane,1,8,9,0.1111111111111111
vs. BCS non-AQ,2016,Tulane,2,0,2,1.0
vs. FBS Power 5,2016,Tulane,0,1,1,0.0
vs. FBS non-Power 5,2016,Tulane,3,7,10,0.3
in August/September,2016,Tulane,2,2,4,0.5
in October,2016,Tulane,1,3,4,0.25
in November,2016,Tulane,1,3,4,0.25
in December/January,2016,Tulane,0,0,0,
All Games,2017,Tulane,5,7,12,0.4166666666666667
at Home,2017,Tulane,4,2,6,0.6666666666666666
on Road/Neutral Site,2017,Tulane,1,5,6,0.16666666666666666
vs. Conference,2017,Tulane,3,5,8,0.375
vs. Non-Conference,2017,Tulane,2,2,4,0.5
vs. Ranked (AP),2017,Tulane,0,3,3,0.0
vs. Unranked (AP),2017,Tulane,5,4,9,0.5555555555555556
vs. FBS (I-A),2017,Tulane,4,7,11,0.36363636363636365
vs. FCS (I-AA),2017,Tulane,1,0,1,1.0
vs. FBS Winning,2017,Tulane,2,6,8,0.25
vs. FBS Non-Winning,2017,Tulane,2,1,3,0.6666666666666666
vs. BCS AQ,2017,Tulane,3,6,9,0.3333333333333333
vs. BCS non-AQ,2017,Tulane,1,1,2,0.5
vs. FBS Power 5,2017,Tulane,0,1,1,0.0
vs. FBS non-Power 5,2017,Tulane,4,6,10,0.4
in August/September,2017,Tulane,2,2,4,0.5
in October,2017,Tulane,1,3,4,0.25
in November,2017,Tulane,2,2,4,0.5
in December/January,2017,Tulane,0,0,0,
All Games,2018,Tulane,7,6,13,0.5384615384615384
at Home,2018,Tulane,4,2,6,0.6666666666666666
on Road/Neutral Site,2018,Tulane,3,4,7,0.42857142857142855
vs. Conference,2018,Tulane,5,3,8,0.625
vs. Non-Conference,2018,Tulane,2,3,5,0.4
vs. Ranked (AP),2018,Tulane,0,2,2,0.0
vs. Unranked (AP),2018,Tulane,7,4,11,0.6363636363636364
vs. FBS (I-A),2018,Tulane,6,6,12,0.5
vs. FCS (I-AA),2018,Tulane,1,0,1,1.0
vs. FBS Winning,2018,Tulane,2,5,7,0.2857142857142857
vs. FBS Non-Winning,2018,Tulane,4,1,5,0.8
vs. BCS AQ,2018,Tulane,5,5,10,0.5
vs. BCS non-AQ,2018,Tulane,1,1,2,0.5
vs. FBS Power 5,2018,Tulane,0,2,2,0.0
vs. FBS non-Power 5,2018,Tulane,6,4,10,0.6
in August/September,2018,Tulane,2,3,5,0.4
in October,2018,Tulane,1,2,3,0.3333333333333333
in November,2018,Tulane,3,1,4,0.75
in December/January,2018,Tulane,1,0,1,1.0
All Games,2019,Tulane,7,6,13,0.5384615384615384
at Home,2019,Tulane,5,1,6,0.8333333333333334
on Road/Neutral Site,2019,Tulane,2,5,7,0.2857142857142857
vs. Conference,2019,Tulane,3,5,8,0.375
vs. Non-Conference,2019,Tulane,4,1,5,0.8
vs. Ranked (AP),2019,Tulane,0,4,4,0.0
vs. Unranked (AP),2019,Tulane,7,2,9,0.7777777777777778
vs. FBS (I-A),2019,Tulane,6,6,12,0.5
vs. FCS (I-AA),2019,Tulane,1,0,1,1.0
vs. FBS Winning,2019,Tulane,1,6,7,0.14285714285714285
vs. FBS Non-Winning,2019,Tulane,5,0,5,1.0
vs. BCS AQ,2019,Tulane,3,6,9,0.3333333333333333
vs. BCS non-AQ,2019,Tulane,3,0,3,1.0
vs. FBS Power 5,2019,Tulane,0,1,1,0.0
vs. FBS non-Power 5,2019,Tulane,6,5,11,0.5454545454545454
in August/September,2019,Tulane,3,1,4,0.75
in October,2019,Tulane,2,2,4,0.5
in November,2019,Tulane,1,3,4,0.25
in December/January,2019,Tulane,1,0,1,1.0
All Games,2020,Tulane,6,6,12,0.5
at Home,2020,Tulane,3,2,5,0.6
on Road/Neutral Site,2020,Tulane,3,4,7,0.42857142857142855
vs. Conference,2020,Tulane,3,5,8,0.375
vs. Non-Conference,2020,Tulane,3,1,4,0.75
vs. Ranked (AP),2020,Tulane,0,1,1,0.0
vs. Unranked (AP),2020,Tulane,6,5,11,0.5454545454545454
vs. FBS (I-A),2020,Tulane,6,6,12,0.5
vs. FCS (I-AA),2020,Tulane,0,0,0,
vs. FBS Winning,2020,Tulane,2,4,6,0.3333333333333333
vs. FBS Non-Winning,2020,Tulane,4,2,6,0.6666666666666666
vs. BCS AQ,2020,Tulane,3,5,8,0.375
vs. BCS non-AQ,2020,Tulane,3,1,4,0.75
vs. FBS Power 5,2020,Tulane,0,0,0,
vs. FBS non-Power 5,2020,Tulane,6,6,12,0.5
in August/September,2020,Tulane,2,1,3,0.6666666666666666
in October,2020,Tulane,1,3,4,0.25
in November,2020,Tulane,2,1,3,0.6666666666666666
in December/January,2020,Tulane,1,1,2,0.5
All Games,2021,Tulane,2,10,12,0.16666666666666666
at Home,2021,Tulane,2,4,6,0.3333333333333333
on Road/Neutral Site,2021,Tulane,0,6,6,0.0
vs. Conference,2021,Tulane,1,7,8,0.125
vs. Non-Conference,2021,Tulane,1,3,4,0.25
vs. Ranked (AP),2021,Tulane,0,4,4,0.0
vs. Unranked (AP),2021,Tulane,2,6,8,0.25
vs. FBS (I-A),2021,Tulane,1,10,11,0.09090909090909091
vs. FCS (I-AA),2021,Tulane,1,0,1,1.0
vs. FBS Winning,2021,Tulane,0,9,9,0.0
vs. FBS Non-Winning,2021,Tulane,1,1,2,0.5
vs. BCS AQ,2021,Tulane,1,9,10,0.1
vs. BCS non-AQ,2021,Tulane,0,1,1,0.0
vs. FBS Power 5,2021,Tulane,0,2,2,0.0
vs. FBS non-Power 5,2021,Tulane,1,8,9,0.1111111111111111
in August/September,2021,Tulane,1,3,4,0.25
in October,2021,Tulane,0,4,4,0.0
in November,2021,Tulane,1,3,4,0.25
in December/January,2021,Tulane,0,0,0,
All Games,2022,Tulane,12,2,14,0.8571428571428571
at Home,2022,Tulane,6,2,8,0.75
on Road/Neutral Site,2022,Tulane,6,0,6,1.0
vs. Conference,2022,Tulane,8,1,9,0.8888888888888888
vs. Non-Conference,2022,Tulane,4,1,5,0.8
vs. Ranked (AP),2022,Tulane,2,0,2,1.0
vs. Unranked (AP),2022,Tulane,10,2,12,0.8333333333333334
vs. FBS (I-A),2022,Tulane,11,2,13,0.8461538461538461
vs. FCS (I-AA),2022,Tulane,1,0,1,1.0
vs. FBS Winning,2022,Tulane,8,2,10,0.8
vs. FBS Non-Winning,2022,Tulane,3,0,3,1.0
vs. BCS AQ,2022,Tulane,10,1,11,0.9090909090909091
vs. BCS non-AQ,2022,Tulane,1,1,2,0.5
vs. FBS Power 5,2022,Tulane,2,0,2,1.0
vs. FBS non-Power 5,2022,Tulane,9,2,11,0.8181818181818182
in August/September,2022,Tulane,4,1,5,0.8
in October,2022,Tulane,3,0,3,1.0
in November,2022,Tulane,3,1,4,0.75
in December/January,2022,Tulane,2,0,2,1.0
All Games,2009,Tulsa,5,7,12,0.4166666666666667
at Home,2009,Tulsa,2,4,6,0.3333333333333333
on Road/Neutral Site,2009,Tulsa,3,3,6,0.5
vs. Conference,2009,Tulsa,3,5,8,0.375
vs. Non-Conference,2009,Tulsa,2,2,4,0.5
vs. Ranked (AP),2009,Tulsa,0,1,1,0.0
vs. Unranked (AP),2009,Tulsa,5,6,11,0.45454545454545453
vs. FBS (I-A),2009,Tulsa,4,7,11,0.36363636363636365
vs. FCS (I-AA),2009,Tulsa,1,0,1,1.0
vs. FBS Winning,2009,Tulsa,0,6,6,0.0
vs. FBS Non-Winning,2009,Tulsa,4,1,5,0.8
vs. BCS AQ,2009,Tulsa,0,1,1,0.0
vs. BCS non-AQ,2009,Tulsa,4,6,10,0.4
vs. FBS Power 5,2009,Tulsa,0,1,1,0.0
vs. FBS non-Power 5,2009,Tulsa,4,6,10,0.4
in August/September,2009,Tulsa,3,1,4,0.75
in October,2009,Tulsa,1,3,4,0.25
in November,2009,Tulsa,1,3,4,0.25
in December/January,2009,Tulsa,0,0,0,
All Games,2010,Tulsa,10,3,13,0.7692307692307693
at Home,2010,Tulsa,6,0,6,1.0
on Road/Neutral Site,2010,Tulsa,4,3,7,0.5714285714285714
vs. Conference,2010,Tulsa,6,2,8,0.75
vs. Non-Conference,2010,Tulsa,4,1,5,0.8
vs. Ranked (AP),2010,Tulsa,0,1,1,0.0
vs. Unranked (AP),2010,Tulsa,10,2,12,0.8333333333333334
vs. FBS (I-A),2010,Tulsa,9,3,12,0.75
vs. FCS (I-AA),2010,Tulsa,1,0,1,1.0
vs. FBS Winning,2010,Tulsa,3,1,4,0.75
vs. FBS Non-Winning,2010,Tulsa,6,2,8,0.75
vs. BCS AQ,2010,Tulsa,1,1,2,0.5
vs. BCS non-AQ,2010,Tulsa,8,2,10,0.8
vs. FBS Power 5,2010,Tulsa,0,1,1,0.0
vs. FBS non-Power 5,2010,Tulsa,9,2,11,0.8181818181818182
in August/September,2010,Tulsa,2,2,4,0.5
in October,2010,Tulsa,3,1,4,0.75
in November,2010,Tulsa,4,0,4,1.0
in December/January,2010,Tulsa,1,0,1,1.0
All Games,2011,Tulsa,8,5,13,0.6153846153846154
at Home,2011,Tulsa,4,2,6,0.6666666666666666
on Road/Neutral Site,2011,Tulsa,4,3,7,0.5714285714285714
vs. Conference,2011,Tulsa,7,1,8,0.875
vs. Non-Conference,2011,Tulsa,1,4,5,0.2
vs. Ranked (AP),2011,Tulsa,0,4,4,0.0
vs. Unranked (AP),2011,Tulsa,8,1,9,0.8888888888888888
vs. FBS (I-A),2011,Tulsa,8,5,13,0.6153846153846154
vs. FCS (I-AA),2011,Tulsa,0,0,0,
vs. FBS Winning,2011,Tulsa,2,5,7,0.2857142857142857
vs. FBS Non-Winning,2011,Tulsa,6,0,6,1.0
vs. BCS AQ,2011,Tulsa,0,2,2,0.0
vs. BCS non-AQ,2011,Tulsa,8,3,11,0.7272727272727273
vs. FBS Power 5,2011,Tulsa,0,2,2,0.0
vs. FBS non-Power 5,2011,Tulsa,8,3,11,0.7272727272727273
in August/September,2011,Tulsa,1,3,4,0.25
in October,2011,Tulsa,4,0,4,1.0
in November,2011,Tulsa,3,1,4,0.75
in December/January,2011,Tulsa,0,1,1,0.0
All Games,2012,Tulsa,11,3,14,0.7857142857142857
at Home,2012,Tulsa,7,0,7,1.0
on Road/Neutral Site,2012,Tulsa,4,3,7,0.5714285714285714
vs. Conference,2012,Tulsa,8,1,9,0.8888888888888888
vs. Non-Conference,2012,Tulsa,3,2,5,0.6
vs. Ranked (AP),2012,Tulsa,0,0,0,
vs. Unranked (AP),2012,Tulsa,11,3,14,0.7857142857142857
vs. FBS (I-A),2012,Tulsa,10,3,13,0.7692307692307693
vs. FCS (I-AA),2012,Tulsa,1,0,1,1.0
vs. FBS Winning,2012,Tulsa,4,1,5,0.8
vs. FBS Non-Winning,2012,Tulsa,6,2,8,0.75
vs. BCS AQ,2012,Tulsa,1,2,3,0.3333333333333333
vs. BCS non-AQ,2012,Tulsa,9,1,10,0.9
vs. FBS Power 5,2012,Tulsa,1,2,3,0.3333333333333333
vs. FBS non-Power 5,2012,Tulsa,9,1,10,0.9
in August/September,2012,Tulsa,4,1,5,0.8
in October,2012,Tulsa,3,0,3,1.0
in November,2012,Tulsa,2,2,4,0.5
in December/January,2012,Tulsa,2,0,2,1.0
All Games,2013,Tulsa,3,9,12,0.25
at Home,2013,Tulsa,1,5,6,0.16666666666666666
on Road/Neutral Site,2013,Tulsa,2,4,6,0.3333333333333333
vs. Conference,2013,Tulsa,2,6,8,0.25
vs. Non-Conference,2013,Tulsa,1,3,4,0.25
vs. Ranked (AP),2013,Tulsa,0,1,1,0.0
vs. Unranked (AP),2013,Tulsa,3,8,11,0.2727272727272727
vs. FBS (I-A),2013,Tulsa,3,9,12,0.25
vs. FCS (I-AA),2013,Tulsa,0,0,0,
vs. FBS Winning,2013,Tulsa,1,8,9,0.1111111111111111
vs. FBS Non-Winning,2013,Tulsa,2,1,3,0.6666666666666666
vs. BCS AQ,2013,Tulsa,0,2,2,0.0
vs. BCS non-AQ,2013,Tulsa,3,7,10,0.3
vs. FBS Power 5,2013,Tulsa,0,2,2,0.0
vs. FBS non-Power 5,2013,Tulsa,3,7,10,0.3
in August/September,2013,Tulsa,1,3,4,0.25
in October,2013,Tulsa,1,2,3,0.3333333333333333
in November,2013,Tulsa,1,4,5,0.2
in December/January,2013,Tulsa,0,0,0,
All Games,2014,Tulsa,2,10,12,0.16666666666666666
at Home,2014,Tulsa,2,4,6,0.3333333333333333
on Road/Neutral Site,2014,Tulsa,0,6,6,0.0
vs. Conference,2014,Tulsa,2,6,8,0.25
vs. Non-Conference,2014,Tulsa,0,4,4,0.0
vs. Ranked (AP),2014,Tulsa,0,1,1,0.0
vs. Unranked (AP),2014,Tulsa,2,9,11,0.18181818181818182
vs. FBS (I-A),2014,Tulsa,2,10,12,0.16666666666666666
vs. FCS (I-AA),2014,Tulsa,0,0,0,
vs. FBS Winning,2014,Tulsa,0,7,7,0.0
vs. FBS Non-Winning,2014,Tulsa,2,3,5,0.4
vs. BCS AQ,2014,Tulsa,2,7,9,0.2222222222222222
vs. BCS non-AQ,2014,Tulsa,0,3,3,0.0
vs. FBS Power 5,2014,Tulsa,0,1,1,0.0
vs. FBS non-Power 5,2014,Tulsa,2,9,11,0.18181818181818182
in August/September,2014,Tulsa,1,3,4,0.25
in October,2014,Tulsa,0,4,4,0.0
in November,2014,Tulsa,1,3,4,0.25
in December/January,2014,Tulsa,0,0,0,
All Games,2015,Tulsa,6,7,13,0.46153846153846156
at Home,2015,Tulsa,3,3,6,0.5
on Road/Neutral Site,2015,Tulsa,3,4,7,0.42857142857142855
vs. Conference,2015,Tulsa,3,5,8,0.375
vs. Non-Conference,2015,Tulsa,3,2,5,0.6
vs. Ranked (AP),2015,Tulsa,0,3,3,0.0
vs. Unranked (AP),2015,Tulsa,6,4,10,0.6
vs. FBS (I-A),2015,Tulsa,6,7,13,0.46153846153846156
vs. FCS (I-AA),2015,Tulsa,0,0,0,
vs. FBS Winning,2015,Tulsa,1,6,7,0.14285714285714285
vs. FBS Non-Winning,2015,Tulsa,5,1,6,0.8333333333333334
vs. BCS AQ,2015,Tulsa,3,7,10,0.3
vs. BCS non-AQ,2015,Tulsa,3,0,3,1.0
vs. FBS Power 5,2015,Tulsa,0,2,2,0.0
vs. FBS non-Power 5,2015,Tulsa,6,5,11,0.5454545454545454
in August/September,2015,Tulsa,2,1,3,0.6666666666666666
in October,2015,Tulsa,2,3,5,0.4
in November,2015,Tulsa,2,2,4,0.5
in December/January,2015,Tulsa,0,1,1,0.0
All Games,2016,Tulsa,10,3,13,0.7692307692307693
at Home,2016,Tulsa,6,0,6,1.0
on Road/Neutral Site,2016,Tulsa,4,3,7,0.5714285714285714
vs. Conference,2016,Tulsa,6,2,8,0.75
vs. Non-Conference,2016,Tulsa,4,1,5,0.8
vs. Ranked (AP),2016,Tulsa,0,1,1,0.0
vs. Unranked (AP),2016,Tulsa,10,2,12,0.8333333333333334
vs. FBS (I-A),2016,Tulsa,9,3,12,0.75
vs. FCS (I-AA),2016,Tulsa,1,0,1,1.0
vs. FBS Winning,2016,Tulsa,1,3,4,0.25
vs. FBS Non-Winning,2016,Tulsa,8,0,8,1.0
vs. BCS AQ,2016,Tulsa,6,3,9,0.6666666666666666
vs. BCS non-AQ,2016,Tulsa,3,0,3,1.0
vs. FBS Power 5,2016,Tulsa,0,1,1,0.0
vs. FBS non-Power 5,2016,Tulsa,9,2,11,0.8181818181818182
in August/September,2016,Tulsa,3,1,4,0.75
in October,2016,Tulsa,3,1,4,0.75
in November,2016,Tulsa,3,1,4,0.75
in December/January,2016,Tulsa,1,0,1,1.0
All Games,2017,Tulsa,2,10,12,0.16666666666666666
at Home,2017,Tulsa,2,4,6,0.3333333333333333
on Road/Neutral Site,2017,Tulsa,0,6,6,0.0
vs. Conference,2017,Tulsa,1,7,8,0.125
vs. Non-Conference,2017,Tulsa,1,3,4,0.25
vs. Ranked (AP),2017,Tulsa,0,3,3,0.0
vs. Unranked (AP),2017,Tulsa,2,7,9,0.2222222222222222
vs. FBS (I-A),2017,Tulsa,2,10,12,0.16666666666666666
vs. FCS (I-AA),2017,Tulsa,0,0,0,
vs. FBS Winning,2017,Tulsa,1,7,8,0.125
vs. FBS Non-Winning,2017,Tulsa,1,3,4,0.25
vs. BCS AQ,2017,Tulsa,1,8,9,0.1111111111111111
vs. BCS non-AQ,2017,Tulsa,1,2,3,0.3333333333333333
vs. FBS Power 5,2017,Tulsa,0,1,1,0.0
vs. FBS non-Power 5,2017,Tulsa,2,9,11,0.18181818181818182
in August/September,2017,Tulsa,1,4,5,0.2
in October,2017,Tulsa,1,3,4,0.25
in November,2017,Tulsa,0,3,3,0.0
in December/January,2017,Tulsa,0,0,0,
All Games,2018,Tulsa,3,9,12,0.25
at Home,2018,Tulsa,3,3,6,0.5
on Road/Neutral Site,2018,Tulsa,0,6,6,0.0
vs. Conference,2018,Tulsa,2,6,8,0.25
vs. Non-Conference,2018,Tulsa,1,3,4,0.25
vs. Ranked (AP),2018,Tulsa,0,1,1,0.0
vs. Unranked (AP),2018,Tulsa,3,8,11,0.2727272727272727
vs. FBS (I-A),2018,Tulsa,2,9,11,0.18181818181818182
vs. FCS (I-AA),2018,Tulsa,1,0,1,1.0
vs. FBS Winning,2018,Tulsa,0,7,7,0.0
vs. FBS Non-Winning,2018,Tulsa,2,2,4,0.5
vs. BCS AQ,2018,Tulsa,2,8,10,0.2
vs. BCS non-AQ,2018,Tulsa,0,1,1,0.0
vs. FBS Power 5,2018,Tulsa,0,2,2,0.0
vs. FBS non-Power 5,2018,Tulsa,2,7,9,0.2222222222222222
in August/September,2018,Tulsa,1,3,4,0.25
in October,2018,Tulsa,0,4,4,0.0
in November,2018,Tulsa,2,2,4,0.5
in December/January,2018,Tulsa,0,0,0,
All Games,2019,Tulsa,4,8,12,0.3333333333333333
at Home,2019,Tulsa,2,4,6,0.3333333333333333
on Road/Neutral Site,2019,Tulsa,2,4,6,0.3333333333333333
vs. Conference,2019,Tulsa,2,6,8,0.25
vs. Non-Conference,2019,Tulsa,2,2,4,0.5
vs. Ranked (AP),2019,Tulsa,1,3,4,0.25
vs. Unranked (AP),2019,Tulsa,3,5,8,0.375
vs. FBS (I-A),2019,Tulsa,4,8,12,0.3333333333333333
vs. FCS (I-AA),2019,Tulsa,0,0,0,
vs. FBS Winning,2019,Tulsa,2,7,9,0.2222222222222222
vs. FBS Non-Winning,2019,Tulsa,2,1,3,0.6666666666666666
vs. BCS AQ,2019,Tulsa,2,8,10,0.2
vs. BCS non-AQ,2019,Tulsa,2,0,2,1.0
vs. FBS Power 5,2019,Tulsa,0,2,2,0.0
vs. FBS non-Power 5,2019,Tulsa,4,6,10,0.4
in August/September,2019,Tulsa,2,2,4,0.5
in October,2019,Tulsa,0,4,4,0.0
in November,2019,Tulsa,2,2,4,0.5
in December/January,2019,Tulsa,0,0,0,
All Games,2020,Tulsa,6,3,9,0.6666666666666666
at Home,2020,Tulsa,3,0,3,1.0
on Road/Neutral Site,2020,Tulsa,3,3,6,0.5
vs. Conference,2020,Tulsa,6,1,7,0.8571428571428571
vs. Non-Conference,2020,Tulsa,0,2,2,0.0
vs. Ranked (AP),2020,Tulsa,0,1,1,0.0
vs. Unranked (AP),2020,Tulsa,6,2,8,0.75
vs. FBS (I-A),2020,Tulsa,6,3,9,0.6666666666666666
vs. FCS (I-AA),2020,Tulsa,0,0,0,
vs. FBS Winning,2020,Tulsa,2,2,4,0.5
vs. FBS Non-Winning,2020,Tulsa,4,1,5,0.8
vs. BCS AQ,2020,Tulsa,6,3,9,0.6666666666666666
vs. BCS non-AQ,2020,Tulsa,0,0,0,
vs. FBS Power 5,2020,Tulsa,0,2,2,0.0
vs. FBS non-Power 5,2020,Tulsa,6,1,7,0.8571428571428571
in August/September,2020,Tulsa,0,1,1,0.0
in October,2020,Tulsa,3,0,3,1.0
in November,2020,Tulsa,2,0,2,1.0
in December/January,2020,Tulsa,1,2,3,0.3333333333333333
All Games,2021,Tulsa,7,6,13,0.5384615384615384
at Home,2021,Tulsa,3,3,6,0.5
on Road/Neutral Site,2021,Tulsa,4,3,7,0.5714285714285714
vs. Conference,2021,Tulsa,5,3,8,0.625
vs. Non-Conference,2021,Tulsa,2,3,5,0.4
vs. Ranked (AP),2021,Tulsa,0,4,4,0.0
vs. Unranked (AP),2021,Tulsa,7,2,9,0.7777777777777778
vs. FBS (I-A),2021,Tulsa,7,5,12,0.5833333333333334
vs. FCS (I-AA),2021,Tulsa,0,1,1,0.0
vs. FBS Winning,2021,Tulsa,1,4,5,0.2
vs. FBS Non-Winning,2021,Tulsa,6,1,7,0.8571428571428571
vs. BCS AQ,2021,Tulsa,5,5,10,0.5
vs. BCS non-AQ,2021,Tulsa,2,0,2,1.0
vs. FBS Power 5,2021,Tulsa,0,2,2,0.0
vs. FBS non-Power 5,2021,Tulsa,7,3,10,0.7
in August/September,2021,Tulsa,1,3,4,0.25
in October,2021,Tulsa,2,2,4,0.5
in November,2021,Tulsa,3,1,4,0.75
in December/January,2021,Tulsa,1,0,1,1.0
All Games,2022,Tulsa,5,7,12,0.4166666666666667
at Home,2022,Tulsa,3,3,6,0.5
on Road/Neutral Site,2022,Tulsa,2,4,6,0.3333333333333333
vs. Conference,2022,Tulsa,3,5,8,0.375
vs. Non-Conference,2022,Tulsa,2,2,4,0.5
vs. Ranked (AP),2022,Tulsa,0,1,1,0.0
vs. Unranked (AP),2022,Tulsa,5,6,11,0.45454545454545453
vs. FBS (I-A),2022,Tulsa,4,7,11,0.36363636363636365
vs. FCS (I-AA),2022,Tulsa,1,0,1,1.0
vs. FBS Winning,2022,Tulsa,1,6,7,0.14285714285714285
vs. FBS Non-Winning,2022,Tulsa,3,1,4,0.75
vs. BCS AQ,2022,Tulsa,3,6,9,0.3333333333333333
vs. BCS non-AQ,2022,Tulsa,1,1,2,0.5
vs. FBS Power 5,2022,Tulsa,0,1,1,0.0
vs. FBS non-Power 5,2022,Tulsa,4,6,10,0.4
in August/September,2022,Tulsa,2,2,4,0.5
in October,2022,Tulsa,1,3,4,0.25
in November,2022,Tulsa,2,2,4,0.5
in December/January,2022,Tulsa,0,0,0,
All Games,2009,UAB,5,7,12,0.4166666666666667
at Home,2009,UAB,3,2,5,0.6
on Road/Neutral Site,2009,UAB,2,5,7,0.2857142857142857
vs. Conference,2009,UAB,4,4,8,0.5
vs. Non-Conference,2009,UAB,1,3,4,0.25
vs. Ranked (AP),2009,UAB,0,1,1,0.0
vs. Unranked (AP),2009,UAB,5,6,11,0.45454545454545453
vs. FBS (I-A),2009,UAB,5,7,12,0.4166666666666667
vs. FCS (I-AA),2009,UAB,0,0,0,
vs. FBS Winning,2009,UAB,1,6,7,0.14285714285714285
vs. FBS Non-Winning,2009,UAB,4,1,5,0.8
vs. BCS AQ,2009,UAB,0,2,2,0.0
vs. BCS non-AQ,2009,UAB,5,5,10,0.5
vs. FBS Power 5,2009,UAB,0,2,2,0.0
vs. FBS non-Power 5,2009,UAB,5,5,10,0.5
in August/September,2009,UAB,1,3,4,0.25
in October,2009,UAB,2,2,4,0.5
in November,2009,UAB,2,2,4,0.5
in December/January,2009,UAB,0,0,0,
All Games,2010,UAB,4,8,12,0.3333333333333333
at Home,2010,UAB,3,3,6,0.5
on Road/Neutral Site,2010,UAB,1,5,6,0.16666666666666666
vs. Conference,2010,UAB,3,5,8,0.375
vs. Non-Conference,2010,UAB,1,3,4,0.25
vs. Ranked (AP),2010,UAB,0,2,2,0.0
vs. Unranked (AP),2010,UAB,4,6,10,0.4
vs. FBS (I-A),2010,UAB,4,8,12,0.3333333333333333
vs. FCS (I-AA),2010,UAB,0,0,0,
vs. FBS Winning,2010,UAB,2,2,4,0.5
vs. FBS Non-Winning,2010,UAB,2,6,8,0.25
vs. BCS AQ,2010,UAB,0,2,2,0.0
vs. BCS non-AQ,2010,UAB,4,6,10,0.4
vs. FBS Power 5,2010,UAB,0,2,2,0.0
vs. FBS non-Power 5,2010,UAB,4,6,10,0.4
in August/September,2010,UAB,1,3,4,0.25
in October,2010,UAB,2,2,4,0.5
in November,2010,UAB,1,3,4,0.25
in December/January,2010,UAB,0,0,0,
All Games,2011,UAB,3,9,12,0.25
at Home,2011,UAB,2,3,5,0.4
on Road/Neutral Site,2011,UAB,1,6,7,0.14285714285714285
vs. Conference,2011,UAB,3,5,8,0.375
vs. Non-Conference,2011,UAB,0,4,4,0.0
vs. Ranked (AP),2011,UAB,1,1,2,0.5
vs. Unranked (AP),2011,UAB,2,8,10,0.2
vs. FBS (I-A),2011,UAB,3,9,12,0.25
vs. FCS (I-AA),2011,UAB,0,0,0,
vs. FBS Winning,2011,UAB,1,5,6,0.16666666666666666
vs. FBS Non-Winning,2011,UAB,2,4,6,0.3333333333333333
vs. BCS AQ,2011,UAB,0,2,2,0.0
vs. BCS non-AQ,2011,UAB,3,7,10,0.3
vs. FBS Power 5,2011,UAB,0,2,2,0.0
vs. FBS non-Power 5,2011,UAB,3,7,10,0.3
in August/September,2011,UAB,0,3,3,0.0
in October,2011,UAB,1,4,5,0.2
in November,2011,UAB,2,2,4,0.5
in December/January,2011,UAB,0,0,0,
All Games,2012,UAB,3,9,12,0.25
at Home,2012,UAB,2,4,6,0.3333333333333333
on Road/Neutral Site,2012,UAB,1,5,6,0.16666666666666666
vs. Conference,2012,UAB,2,6,8,0.25
vs. Non-Conference,2012,UAB,1,3,4,0.25
vs. Ranked (AP),2012,UAB,0,2,2,0.0
vs. Unranked (AP),2012,UAB,3,7,10,0.3
vs. FBS (I-A),2012,UAB,2,9,11,0.18181818181818182
vs. FCS (I-AA),2012,UAB,1,0,1,1.0
vs. FBS Winning,2012,UAB,0,5,5,0.0
vs. FBS Non-Winning,2012,UAB,2,4,6,0.3333333333333333
vs. BCS AQ,2012,UAB,0,2,2,0.0
vs. BCS non-AQ,2012,UAB,2,7,9,0.2222222222222222
vs. FBS Power 5,2012,UAB,0,2,2,0.0
vs. FBS non-Power 5,2012,UAB,2,7,9,0.2222222222222222
in August/September,2012,UAB,0,4,4,0.0
in October,2012,UAB,1,3,4,0.25
in November,2012,UAB,2,2,4,0.5
in December/January,2012,UAB,0,0,0,
All Games,2013,UAB,2,10,12,0.16666666666666666
at Home,2013,UAB,1,4,5,0.2
on Road/Neutral Site,2013,UAB,1,6,7,0.14285714285714285
vs. Conference,2013,UAB,1,7,8,0.125
vs. Non-Conference,2013,UAB,1,3,4,0.25
vs. Ranked (AP),2013,UAB,0,2,2,0.0
vs. Unranked (AP),2013,UAB,2,8,10,0.2
vs. FBS (I-A),2013,UAB,1,10,11,0.09090909090909091
vs. FCS (I-AA),2013,UAB,1,0,1,1.0
vs. FBS Winning,2013,UAB,0,7,7,0.0
vs. FBS Non-Winning,2013,UAB,1,3,4,0.25
vs. BCS AQ,2013,UAB,0,2,2,0.0
vs. BCS non-AQ,2013,UAB,1,8,9,0.1111111111111111
vs. FBS Power 5,2013,UAB,0,2,2,0.0
vs. FBS non-Power 5,2013,UAB,1,8,9,0.1111111111111111
in August/September,2013,UAB,1,3,4,0.25
in October,2013,UAB,1,2,3,0.3333333333333333
in November,2013,UAB,0,5,5,0.0
in December/January,2013,UAB,0,0,0,
All Games,2014,UAB,6,6,12,0.5
at Home,2014,UAB,3,3,6,0.5
on Road/Neutral Site,2014,UAB,3,3,6,0.5
vs. Conference,2014,UAB,4,4,8,0.5
vs. Non-Conference,2014,UAB,2,2,4,0.5
vs. Ranked (AP),2014,UAB,0,2,2,0.0
vs. Unranked (AP),2014,UAB,6,4,10,0.6
vs. FBS (I-A),2014,UAB,5,6,11,0.45454545454545453
vs. FCS (I-AA),2014,UAB,1,0,1,1.0
vs. FBS Winning,2014,UAB,1,4,5,0.2
vs. FBS Non-Winning,2014,UAB,4,2,6,0.6666666666666666
vs. BCS AQ,2014,UAB,0,2,2,0.0
vs. BCS non-AQ,2014,UAB,5,4,9,0.5555555555555556
vs. FBS Power 5,2014,UAB,0,2,2,0.0
vs. FBS non-Power 5,2014,UAB,5,4,9,0.5555555555555556
in August/September,2014,UAB,2,2,4,0.5
in October,2014,UAB,2,2,4,0.5
in November,2014,UAB,2,2,4,0.5
in December/January,2014,UAB,0,0,0,
All Games,2017,UAB,8,5,13,0.6153846153846154
at Home,2017,UAB,6,0,6,1.0
on Road/Neutral Site,2017,UAB,2,5,7,0.2857142857142857
vs. Conference,2017,UAB,6,2,8,0.75
vs. Non-Conference,2017,UAB,2,3,5,0.4
vs. Ranked (AP),2017,UAB,0,0,0,
vs. Unranked (AP),2017,UAB,8,5,13,0.6153846153846154
vs. FBS (I-A),2017,UAB,7,5,12,0.5833333333333334
vs. FCS (I-AA),2017,UAB,1,0,1,1.0
vs. FBS Winning,2017,UAB,4,2,6,0.6666666666666666
vs. FBS Non-Winning,2017,UAB,3,3,6,0.5
vs. BCS AQ,2017,UAB,0,1,1,0.0
vs. BCS non-AQ,2017,UAB,7,4,11,0.6363636363636364
vs. FBS Power 5,2017,UAB,0,1,1,0.0
vs. FBS non-Power 5,2017,UAB,7,4,11,0.6363636363636364
in August/September,2017,UAB,2,2,4,0.5
in October,2017,UAB,3,1,4,0.75
in November,2017,UAB,3,1,4,0.75
in December/January,2017,UAB,0,1,1,0.0
All Games,2018,UAB,11,3,14,0.7857142857142857
at Home,2018,UAB,6,0,6,1.0
on Road/Neutral Site,2018,UAB,5,3,8,0.625
vs. Conference,2018,UAB,8,1,9,0.8888888888888888
vs. Non-Conference,2018,UAB,3,2,5,0.6
vs. Ranked (AP),2018,UAB,0,1,1,0.0
vs. Unranked (AP),2018,UAB,11,2,13,0.8461538461538461
vs. FBS (I-A),2018,UAB,10,3,13,0.7692307692307693
vs. FCS (I-AA),2018,UAB,1,0,1,1.0
vs. FBS Winning,2018,UAB,6,2,8,0.75
vs. FBS Non-Winning,2018,UAB,4,1,5,0.8
vs. BCS AQ,2018,UAB,1,1,2,0.5
vs. BCS non-AQ,2018,UAB,9,2,11,0.8181818181818182
vs. FBS Power 5,2018,UAB,0,1,1,0.0
vs. FBS non-Power 5,2018,UAB,10,2,12,0.8333333333333334
in August/September,2018,UAB,3,1,4,0.75
in October,2018,UAB,4,0,4,1.0
in November,2018,UAB,2,2,4,0.5
in December/January,2018,UAB,2,0,2,1.0
All Games,2019,UAB,9,5,14,0.6428571428571429
at Home,2019,UAB,6,0,6,1.0
on Road/Neutral Site,2019,UAB,3,5,8,0.375
vs. Conference,2019,UAB,6,3,9,0.6666666666666666
vs. Non-Conference,2019,UAB,3,2,5,0.6
vs. Ranked (AP),2019,UAB,0,1,1,0.0
vs. Unranked (AP),2019,UAB,9,4,13,0.6923076923076923
vs. FBS (I-A),2019,UAB,8,5,13,0.6153846153846154
vs. FCS (I-AA),2019,UAB,1,0,1,1.0
vs. FBS Winning,2019,UAB,1,5,6,0.16666666666666666
vs. FBS Non-Winning,2019,UAB,7,0,7,1.0
vs. BCS AQ,2019,UAB,0,1,1,0.0
vs. BCS non-AQ,2019,UAB,8,4,12,0.6666666666666666
vs. FBS Power 5,2019,UAB,0,1,1,0.0
vs. FBS non-Power 5,2019,UAB,8,4,12,0.6666666666666666
in August/September,2019,UAB,3,1,4,0.75
in October,2019,UAB,3,0,3,1.0
in November,2019,UAB,3,2,5,0.6
in December/January,2019,UAB,0,2,2,0.0
All Games,2020,UAB,6,3,9,0.6666666666666666
at Home,2020,UAB,3,1,4,0.75
on Road/Neutral Site,2020,UAB,3,2,5,0.6
vs. Conference,2020,UAB,4,1,5,0.8
vs. Non-Conference,2020,UAB,2,2,4,0.5
vs. Ranked (AP),2020,UAB,0,2,2,0.0
vs. Unranked (AP),2020,UAB,6,1,7,0.8571428571428571
vs. FBS (I-A),2020,UAB,5,3,8,0.625
vs. FCS (I-AA),2020,UAB,1,0,1,1.0
vs. FBS Winning,2020,UAB,2,2,4,0.5
vs. FBS Non-Winning,2020,UAB,3,1,4,0.75
vs. BCS AQ,2020,UAB,0,1,1,0.0
vs. BCS non-AQ,2020,UAB,5,2,7,0.7142857142857143
vs. FBS Power 5,2020,UAB,0,1,1,0.0
vs. FBS non-Power 5,2020,UAB,5,2,7,0.7142857142857143
in August/September,2020,UAB,2,1,3,0.6666666666666666
in October,2020,UAB,2,2,4,0.5
in November,2020,UAB,0,0,0,
in December/January,2020,UAB,2,0,2,1.0
All Games,2021,UAB,9,4,13,0.6923076923076923
at Home,2021,UAB,3,2,5,0.6
on Road/Neutral Site,2021,UAB,6,2,8,0.75
vs. Conference,2021,UAB,6,2,8,0.75
vs. Non-Conference,2021,UAB,3,2,5,0.6
vs. Ranked (AP),2021,UAB,1,1,2,0.5
vs. Unranked (AP),2021,UAB,8,3,11,0.7272727272727273
vs. FBS (I-A),2021,UAB,8,4,12,0.6666666666666666
vs. FCS (I-AA),2021,UAB,1,0,1,1.0
vs. FBS Winning,2021,UAB,3,3,6,0.5
vs. FBS Non-Winning,2021,UAB,5,1,6,0.8333333333333334
vs. BCS AQ,2021,UAB,1,1,2,0.5
vs. BCS non-AQ,2021,UAB,7,3,10,0.7
vs. FBS Power 5,2021,UAB,0,1,1,0.0
vs. FBS non-Power 5,2021,UAB,8,3,11,0.7272727272727273
in August/September,2021,UAB,3,1,4,0.75
in October,2021,UAB,2,2,4,0.5
in November,2021,UAB,3,1,4,0.75
in December/January,2021,UAB,1,0,1,1.0
All Games,2022,UAB,7,6,13,0.5384615384615384
at Home,2022,UAB,5,1,6,0.8333333333333334
on Road/Neutral Site,2022,UAB,2,5,7,0.2857142857142857
vs. Conference,2022,UAB,4,4,8,0.5
vs. Non-Conference,2022,UAB,3,2,5,0.6
vs. Ranked (AP),2022,UAB,0,1,1,0.0
vs. Unranked (AP),2022,UAB,7,5,12,0.5833333333333334
vs. FBS (I-A),2022,UAB,6,6,12,0.5
vs. FCS (I-AA),2022,UAB,1,0,1,1.0
vs. FBS Winning,2022,UAB,1,4,5,0.2
vs. FBS Non-Winning,2022,UAB,5,2,7,0.7142857142857143
vs. BCS AQ,2022,UAB,0,1,1,0.0
vs. BCS non-AQ,2022,UAB,6,5,11,0.5454545454545454
vs. FBS Power 5,2022,UAB,0,1,1,0.0
vs. FBS non-Power 5,2022,UAB,6,5,11,0.5454545454545454
in August/September,2022,UAB,2,1,3,0.6666666666666666
in October,2022,UAB,2,3,5,0.4
in November,2022,UAB,2,2,4,0.5
in December/January,2022,UAB,1,0,1,1.0
All Games,2009,UCF,8,5,13,0.6153846153846154
at Home,2009,UCF,6,1,7,0.8571428571428571
on Road/Neutral Site,2009,UCF,2,4,6,0.3333333333333333
vs. Conference,2009,UCF,6,2,8,0.75
vs. Non-Conference,2009,UCF,2,3,5,0.4
vs. Ranked (AP),2009,UCF,0,2,2,0.0
vs. Unranked (AP),2009,UCF,8,3,11,0.7272727272727273
vs. FBS (I-A),2009,UCF,7,5,12,0.5833333333333334
vs. FCS (I-AA),2009,UCF,1,0,1,1.0
vs. FBS Winning,2009,UCF,2,5,7,0.2857142857142857
vs. FBS Non-Winning,2009,UCF,5,0,5,1.0
vs. BCS AQ,2009,UCF,0,3,3,0.0
vs. BCS non-AQ,2009,UCF,7,2,9,0.7777777777777778
vs. FBS Power 5,2009,UCF,0,2,2,0.0
vs. FBS non-Power 5,2009,UCF,7,3,10,0.7
in August/September,2009,UCF,2,2,4,0.5
in October,2009,UCF,2,1,3,0.6666666666666666
in November,2009,UCF,4,1,5,0.8
in December/January,2009,UCF,0,1,1,0.0
All Games,2010,UCF,11,3,14,0.7857142857142857
at Home,2010,UCF,5,2,7,0.7142857142857143
on Road/Neutral Site,2010,UCF,6,1,7,0.8571428571428571
vs. Conference,2010,UCF,8,1,9,0.8888888888888888
vs. Non-Conference,2010,UCF,3,2,5,0.6
vs. Ranked (AP),2010,UCF,0,1,1,0.0
vs. Unranked (AP),2010,UCF,11,2,13,0.8461538461538461
vs. FBS (I-A),2010,UCF,10,3,13,0.7692307692307693
vs. FCS (I-AA),2010,UCF,1,0,1,1.0
vs. FBS Winning,2010,UCF,0,3,3,0.0
vs. FBS Non-Winning,2010,UCF,10,0,10,1.0
vs. BCS AQ,2010,UCF,1,2,3,0.3333333333333333
vs. BCS non-AQ,2010,UCF,9,1,10,0.9
vs. FBS Power 5,2010,UCF,1,2,3,0.3333333333333333
vs. FBS non-Power 5,2010,UCF,9,1,10,0.9
in August/September,2010,UCF,2,2,4,0.5
in October,2010,UCF,4,0,4,1.0
in November,2010,UCF,3,1,4,0.75
in December/January,2010,UCF,2,0,2,1.0
All Games,2011,UCF,5,7,12,0.4166666666666667
at Home,2011,UCF,5,1,6,0.8333333333333334
on Road/Neutral Site,2011,UCF,0,6,6,0.0
vs. Conference,2011,UCF,3,5,8,0.375
vs. Non-Conference,2011,UCF,2,2,4,0.5
vs. Ranked (AP),2011,UCF,0,1,1,0.0
vs. Unranked (AP),2011,UCF,5,6,11,0.45454545454545453
vs. FBS (I-A),2011,UCF,4,7,11,0.36363636363636365
vs. FCS (I-AA),2011,UCF,1,0,1,1.0
vs. FBS Winning,2011,UCF,1,5,6,0.16666666666666666
vs. FBS Non-Winning,2011,UCF,3,2,5,0.6
vs. BCS AQ,2011,UCF,1,0,1,1.0
vs. BCS non-AQ,2011,UCF,3,7,10,0.3
vs. FBS Power 5,2011,UCF,1,0,1,1.0
vs. FBS non-Power 5,2011,UCF,3,7,10,0.3
in August/September,2011,UCF,2,2,4,0.5
in October,2011,UCF,2,2,4,0.5
in November,2011,UCF,1,3,4,0.25
in December/January,2011,UCF,0,0,0,
All Games,2012,UCF,10,4,14,0.7142857142857143
at Home,2012,UCF,5,1,6,0.8333333333333334
on Road/Neutral Site,2012,UCF,5,3,8,0.625
vs. Conference,2012,UCF,7,2,9,0.7777777777777778
vs. Non-Conference,2012,UCF,3,2,5,0.6
vs. Ranked (AP),2012,UCF,0,1,1,0.0
vs. Unranked (AP),2012,UCF,10,3,13,0.7692307692307693
vs. FBS (I-A),2012,UCF,10,4,14,0.7142857142857143
vs. FCS (I-AA),2012,UCF,0,0,0,
vs. FBS Winning,2012,UCF,3,3,6,0.5
vs. FBS Non-Winning,2012,UCF,7,1,8,0.875
vs. BCS AQ,2012,UCF,0,2,2,0.0
vs. BCS non-AQ,2012,UCF,10,2,12,0.8333333333333334
vs. FBS Power 5,2012,UCF,0,2,2,0.0
vs. FBS non-Power 5,2012,UCF,10,2,12,0.8333333333333334
in August/September,2012,UCF,2,2,4,0.5
in October,2012,UCF,4,0,4,1.0
in November,2012,UCF,3,1,4,0.75
in December/January,2012,UCF,1,1,2,0.5
All Games,2013,UCF,12,1,13,0.9230769230769231
at Home,2013,UCF,5,1,6,0.8333333333333334
on Road/Neutral Site,2013,UCF,7,0,7,1.0
vs. Conference,2013,UCF,8,0,8,1.0
vs. Non-Conference,2013,UCF,4,1,5,0.8
vs. Ranked (AP),2013,UCF,2,1,3,0.6666666666666666
vs. Unranked (AP),2013,UCF,10,0,10,1.0
vs. FBS (I-A),2013,UCF,12,1,13,0.9230769230769231
vs. FCS (I-AA),2013,UCF,0,0,0,
vs. FBS Winning,2013,UCF,4,1,5,0.8
vs. FBS Non-Winning,2013,UCF,8,0,8,1.0
vs. BCS AQ,2013,UCF,10,1,11,0.9090909090909091
vs. BCS non-AQ,2013,UCF,2,0,2,1.0
vs. FBS Power 5,2013,UCF,2,1,3,0.6666666666666666
vs. FBS non-Power 5,2013,UCF,10,0,10,1.0
in August/September,2013,UCF,3,1,4,0.75
in October,2013,UCF,3,0,3,1.0
in November,2013,UCF,4,0,4,1.0
in December/January,2013,UCF,2,0,2,1.0
All Games,2014,UCF,9,4,13,0.6923076923076923
at Home,2014,UCF,6,0,6,1.0
on Road/Neutral Site,2014,UCF,3,4,7,0.42857142857142855
vs. Conference,2014,UCF,7,1,8,0.875
vs. Non-Conference,2014,UCF,2,3,5,0.4
vs. Ranked (AP),2014,UCF,0,1,1,0.0
vs. Unranked (AP),2014,UCF,9,3,12,0.75
vs. FBS (I-A),2014,UCF,8,4,12,0.6666666666666666
vs. FCS (I-AA),2014,UCF,1,0,1,1.0
vs. FBS Winning,2014,UCF,3,3,6,0.5
vs. FBS Non-Winning,2014,UCF,5,1,6,0.8333333333333334
vs. BCS AQ,2014,UCF,7,4,11,0.6363636363636364
vs. BCS non-AQ,2014,UCF,1,0,1,1.0
vs. FBS Power 5,2014,UCF,0,3,3,0.0
vs. FBS non-Power 5,2014,UCF,8,1,9,0.8888888888888888
in August/September,2014,UCF,1,2,3,0.3333333333333333
in October,2014,UCF,4,0,4,1.0
in November,2014,UCF,3,1,4,0.75
in December/January,2014,UCF,1,1,2,0.5
All Games,2015,UCF,0,12,12,0.0
at Home,2015,UCF,0,6,6,0.0
on Road/Neutral Site,2015,UCF,0,6,6,0.0
vs. Conference,2015,UCF,0,8,8,0.0
vs. Non-Conference,2015,UCF,0,4,4,0.0
vs. Ranked (AP),2015,UCF,0,2,2,0.0
vs. Unranked (AP),2015,UCF,0,10,10,0.0
vs. FBS (I-A),2015,UCF,0,11,11,0.0
vs. FCS (I-AA),2015,UCF,0,1,1,0.0
vs. FBS Winning,2015,UCF,0,5,5,0.0
vs. FBS Non-Winning,2015,UCF,0,6,6,0.0
vs. BCS AQ,2015,UCF,0,10,10,0.0
vs. BCS non-AQ,2015,UCF,0,1,1,0.0
vs. FBS Power 5,2015,UCF,0,2,2,0.0
vs. FBS non-Power 5,2015,UCF,0,9,9,0.0
in August/September,2015,UCF,0,4,4,0.0
in October,2015,UCF,0,5,5,0.0
in November,2015,UCF,0,3,3,0.0
in December/January,2015,UCF,0,0,0,
All Games,2016,UCF,6,7,13,0.46153846153846156
at Home,2016,UCF,3,3,6,0.5
on Road/Neutral Site,2016,UCF,3,4,7,0.42857142857142855
vs. Conference,2016,UCF,4,4,8,0.5
vs. Non-Conference,2016,UCF,2,3,5,0.4
vs. Ranked (AP),2016,UCF,0,3,3,0.0
vs. Unranked (AP),2016,UCF,6,4,10,0.6
vs. FBS (I-A),2016,UCF,5,7,12,0.4166666666666667
vs. FCS (I-AA),2016,UCF,1,0,1,1.0
vs. FBS Winning,2016,UCF,0,6,6,0.0
vs. FBS Non-Winning,2016,UCF,5,1,6,0.8333333333333334
vs. BCS AQ,2016,UCF,4,6,10,0.4
vs. BCS non-AQ,2016,UCF,1,1,2,0.5
vs. FBS Power 5,2016,UCF,0,2,2,0.0
vs. FBS non-Power 5,2016,UCF,5,5,10,0.5
in August/September,2016,UCF,2,2,4,0.5
in October,2016,UCF,2,2,4,0.5
in November,2016,UCF,2,2,4,0.5
in December/January,2016,UCF,0,1,1,0.0
All Games,2017,UCF,13,0,13,1.0
at Home,2017,UCF,7,0,7,1.0
on Road/Neutral Site,2017,UCF,6,0,6,1.0
vs. Conference,2017,UCF,9,0,9,1.0
vs. Non-Conference,2017,UCF,4,0,4,1.0
vs. Ranked (AP),2017,UCF,4,0,4,1.0
vs. Unranked (AP),2017,UCF,9,0,9,1.0
vs. FBS (I-A),2017,UCF,12,0,12,1.0
vs. FCS (I-AA),2017,UCF,1,0,1,1.0
vs. FBS Winning,2017,UCF,8,0,8,1.0
vs. FBS Non-Winning,2017,UCF,4,0,4,1.0
vs. BCS AQ,2017,UCF,11,0,11,1.0
vs. BCS non-AQ,2017,UCF,1,0,1,1.0
vs. FBS Power 5,2017,UCF,2,0,2,1.0
vs. FBS non-Power 5,2017,UCF,10,0,10,1.0
in August/September,2017,UCF,3,0,3,1.0
in October,2017,UCF,4,0,4,1.0
in November,2017,UCF,4,0,4,1.0
in December/January,2017,UCF,2,0,2,1.0
All Games,2018,UCF,12,1,13,0.9230769230769231
at Home,2018,UCF,8,0,8,1.0
on Road/Neutral Site,2018,UCF,4,1,5,0.8
vs. Conference,2018,UCF,9,0,9,1.0
vs. Non-Conference,2018,UCF,3,1,4,0.75
vs. Ranked (AP),2018,UCF,1,1,2,0.5
vs. Unranked (AP),2018,UCF,11,0,11,1.0
vs. FBS (I-A),2018,UCF,11,1,12,0.9166666666666666
vs. FCS (I-AA),2018,UCF,1,0,1,1.0
vs. FBS Winning,2018,UCF,5,1,6,0.8333333333333334
vs. FBS Non-Winning,2018,UCF,6,0,6,1.0
vs. BCS AQ,2018,UCF,10,1,11,0.9090909090909091
vs. BCS non-AQ,2018,UCF,1,0,1,1.0
vs. FBS Power 5,2018,UCF,1,1,2,0.5
vs. FBS non-Power 5,2018,UCF,10,0,10,1.0
in August/September,2018,UCF,4,0,4,1.0
in October,2018,UCF,3,0,3,1.0
in November,2018,UCF,4,0,4,1.0
in December/January,2018,UCF,1,1,2,0.5
All Games,2019,UCF,10,3,13,0.7692307692307693
at Home,2019,UCF,6,0,6,1.0
on Road/Neutral Site,2019,UCF,4,3,7,0.5714285714285714
vs. Conference,2019,UCF,6,2,8,0.75
vs. Non-Conference,2019,UCF,4,1,5,0.8
vs. Ranked (AP),2019,UCF,0,1,1,0.0
vs. Unranked (AP),2019,UCF,10,2,12,0.8333333333333334
vs. FBS (I-A),2019,UCF,9,3,12,0.75
vs. FCS (I-AA),2019,UCF,1,0,1,1.0
vs. FBS Winning,2019,UCF,4,2,6,0.6666666666666666
vs. FBS Non-Winning,2019,UCF,5,1,6,0.8333333333333334
vs. BCS AQ,2019,UCF,7,3,10,0.7
vs. BCS non-AQ,2019,UCF,2,0,2,1.0
vs. FBS Power 5,2019,UCF,1,1,2,0.5
vs. FBS non-Power 5,2019,UCF,8,2,10,0.8
in August/September,2019,UCF,4,1,5,0.8
in October,2019,UCF,2,1,3,0.6666666666666666
in November,2019,UCF,3,1,4,0.75
in December/January,2019,UCF,1,0,1,1.0
All Games,2020,UCF,6,4,10,0.6
at Home,2020,UCF,2,2,4,0.5
on Road/Neutral Site,2020,UCF,4,2,6,0.6666666666666666
vs. Conference,2020,UCF,5,3,8,0.625
vs. Non-Conference,2020,UCF,1,1,2,0.5
vs. Ranked (AP),2020,UCF,0,3,3,0.0
vs. Unranked (AP),2020,UCF,6,1,7,0.8571428571428571
vs. FBS (I-A),2020,UCF,6,4,10,0.6
vs. FCS (I-AA),2020,UCF,0,0,0,
vs. FBS Winning,2020,UCF,0,4,4,0.0
vs. FBS Non-Winning,2020,UCF,6,0,6,1.0
vs. BCS AQ,2020,UCF,6,3,9,0.6666666666666666
vs. BCS non-AQ,2020,UCF,0,1,1,0.0
vs. FBS Power 5,2020,UCF,1,0,1,1.0
vs. FBS non-Power 5,2020,UCF,5,4,9,0.5555555555555556
in August/September,2020,UCF,2,0,2,1.0
in October,2020,UCF,2,2,4,0.5
in November,2020,UCF,2,1,3,0.6666666666666666
in December/January,2020,UCF,0,1,1,0.0
All Games,2021,UCF,9,4,13,0.6923076923076923
at Home,2021,UCF,7,0,7,1.0
on Road/Neutral Site,2021,UCF,2,4,6,0.3333333333333333
vs. Conference,2021,UCF,5,3,8,0.625
vs. Non-Conference,2021,UCF,4,1,5,0.8
vs. Ranked (AP),2021,UCF,0,1,1,0.0
vs. Unranked (AP),2021,UCF,9,3,12,0.75
vs. FBS (I-A),2021,UCF,8,4,12,0.6666666666666666
vs. FCS (I-AA),2021,UCF,1,0,1,1.0
vs. FBS Winning,2021,UCF,2,2,4,0.5
vs. FBS Non-Winning,2021,UCF,6,2,8,0.75
vs. BCS AQ,2021,UCF,6,4,10,0.6
vs. BCS non-AQ,2021,UCF,2,0,2,1.0
vs. FBS Power 5,2021,UCF,1,1,2,0.5
vs. FBS non-Power 5,2021,UCF,7,3,10,0.7
in August/September,2021,UCF,2,1,3,0.6666666666666666
in October,2021,UCF,3,2,5,0.6
in November,2021,UCF,3,1,4,0.75
in December/January,2021,UCF,1,0,1,1.0
All Games,2022,UCF,9,5,14,0.6428571428571429
at Home,2022,UCF,5,2,7,0.7142857142857143
on Road/Neutral Site,2022,UCF,4,3,7,0.5714285714285714
vs. Conference,2022,UCF,6,3,9,0.6666666666666666
vs. Non-Conference,2022,UCF,3,2,5,0.6
vs. Ranked (AP),2022,UCF,1,1,2,0.5
vs. Unranked (AP),2022,UCF,8,4,12,0.6666666666666666
vs. FBS (I-A),2022,UCF,8,5,13,0.6153846153846154
vs. FCS (I-AA),2022,UCF,1,0,1,1.0
vs. FBS Winning,2022,UCF,4,4,8,0.5
vs. FBS Non-Winning,2022,UCF,4,1,5,0.8
vs. BCS AQ,2022,UCF,7,5,12,0.5833333333333334
vs. BCS non-AQ,2022,UCF,1,0,1,1.0
vs. FBS Power 5,2022,UCF,1,2,3,0.3333333333333333
vs. FBS non-Power 5,2022,UCF,7,3,10,0.7
in August/September,2022,UCF,3,1,4,0.75
in October,2022,UCF,3,1,4,0.75
in November,2022,UCF,3,1,4,0.75
in December/January,2022,UCF,0,2,2,0.0
All Games,2009,UCLA,7,6,13,0.5384615384615384
at Home,2009,UCLA,4,2,6,0.6666666666666666
on Road/Neutral Site,2009,UCLA,3,4,7,0.42857142857142855
vs. Conference,2009,UCLA,3,6,9,0.3333333333333333
vs. Non-Conference,2009,UCLA,4,0,4,1.0
vs. Ranked (AP),2009,UCLA,0,2,2,0.0
vs. Unranked (AP),2009,UCLA,7,4,11,0.6363636363636364
vs. FBS (I-A),2009,UCLA,7,6,13,0.5384615384615384
vs. FCS (I-AA),2009,UCLA,0,0,0,
vs. FBS Winning,2009,UCLA,2,6,8,0.25
vs. FBS Non-Winning,2009,UCLA,5,0,5,1.0
vs. BCS AQ,2009,UCLA,5,6,11,0.45454545454545453
vs. BCS non-AQ,2009,UCLA,2,0,2,1.0
vs. FBS Power 5,2009,UCLA,5,6,11,0.45454545454545453
vs. FBS non-Power 5,2009,UCLA,2,0,2,1.0
in August/September,2009,UCLA,3,0,3,1.0
in October,2009,UCLA,0,5,5,0.0
in November,2009,UCLA,3,1,4,0.75
in December/January,2009,UCLA,1,0,1,1.0
All Games,2010,UCLA,4,8,12,0.3333333333333333
at Home,2010,UCLA,3,3,6,0.5
on Road/Neutral Site,2010,UCLA,1,5,6,0.16666666666666666
vs. Conference,2010,UCLA,2,7,9,0.2222222222222222
vs. Non-Conference,2010,UCLA,2,1,3,0.6666666666666666
vs. Ranked (AP),2010,UCLA,0,2,2,0.0
vs. Unranked (AP),2010,UCLA,4,6,10,0.4
vs. FBS (I-A),2010,UCLA,4,8,12,0.3333333333333333
vs. FCS (I-AA),2010,UCLA,0,0,0,
vs. FBS Winning,2010,UCLA,0,6,6,0.0
vs. FBS Non-Winning,2010,UCLA,4,2,6,0.6666666666666666
vs. BCS AQ,2010,UCLA,3,8,11,0.2727272727272727
vs. BCS non-AQ,2010,UCLA,1,0,1,1.0
vs. FBS Power 5,2010,UCLA,3,8,11,0.2727272727272727
vs. FBS non-Power 5,2010,UCLA,1,0,1,1.0
in August/September,2010,UCLA,2,2,4,0.5
in October,2010,UCLA,1,3,4,0.25
in November,2010,UCLA,1,2,3,0.3333333333333333
in December/January,2010,UCLA,0,1,1,0.0
All Games,2011,UCLA,6,8,14,0.42857142857142855
at Home,2011,UCLA,5,1,6,0.8333333333333334
on Road/Neutral Site,2011,UCLA,1,7,8,0.125
vs. Conference,2011,UCLA,5,5,10,0.5
vs. Non-Conference,2011,UCLA,1,3,4,0.25
vs. Ranked (AP),2011,UCLA,0,4,4,0.0
vs. Unranked (AP),2011,UCLA,6,4,10,0.6
vs. FBS (I-A),2011,UCLA,6,8,14,0.42857142857142855
vs. FCS (I-AA),2011,UCLA,0,0,0,
vs. FBS Winning,2011,UCLA,1,7,8,0.125
vs. FBS Non-Winning,2011,UCLA,5,1,6,0.8333333333333334
vs. BCS AQ,2011,UCLA,5,7,12,0.4166666666666667
vs. BCS non-AQ,2011,UCLA,1,1,2,0.5
vs. FBS Power 5,2011,UCLA,5,7,12,0.4166666666666667
vs. FBS non-Power 5,2011,UCLA,1,1,2,0.5
in August/September,2011,UCLA,2,2,4,0.5
in October,2011,UCLA,2,2,4,0.5
in November,2011,UCLA,2,2,4,0.5
in December/January,2011,UCLA,0,2,2,0.0
All Games,2012,UCLA,9,5,14,0.6428571428571429
at Home,2012,UCLA,5,2,7,0.7142857142857143
on Road/Neutral Site,2012,UCLA,4,3,7,0.5714285714285714
vs. Conference,2012,UCLA,6,4,10,0.6
vs. Non-Conference,2012,UCLA,3,1,4,0.75
vs. Ranked (AP),2012,UCLA,1,3,4,0.25
vs. Unranked (AP),2012,UCLA,8,2,10,0.8
vs. FBS (I-A),2012,UCLA,9,5,14,0.6428571428571429
vs. FCS (I-AA),2012,UCLA,0,0,0,
vs. FBS Winning,2012,UCLA,5,4,9,0.5555555555555556
vs. FBS Non-Winning,2012,UCLA,4,1,5,0.8
vs. BCS AQ,2012,UCLA,7,5,12,0.5833333333333334
vs. BCS non-AQ,2012,UCLA,2,0,2,1.0
vs. FBS Power 5,2012,UCLA,7,5,12,0.5833333333333334
vs. FBS non-Power 5,2012,UCLA,2,0,2,1.0
in August/September,2012,UCLA,4,1,5,0.8
in October,2012,UCLA,2,1,3,0.6666666666666666
in November,2012,UCLA,3,2,5,0.6
in December/January,2012,UCLA,0,1,1,0.0
All Games,2013,UCLA,10,3,13,0.7692307692307693
at Home,2013,UCLA,5,1,6,0.8333333333333334
on Road/Neutral Site,2013,UCLA,5,2,7,0.7142857142857143
vs. Conference,2013,UCLA,6,3,9,0.6666666666666666
vs. Non-Conference,2013,UCLA,4,0,4,1.0
vs. Ranked (AP),2013,UCLA,2,3,5,0.4
vs. Unranked (AP),2013,UCLA,8,0,8,1.0
vs. FBS (I-A),2013,UCLA,10,3,13,0.7692307692307693
vs. FCS (I-AA),2013,UCLA,0,0,0,
vs. FBS Winning,2013,UCLA,5,3,8,0.625
vs. FBS Non-Winning,2013,UCLA,5,0,5,1.0
vs. BCS AQ,2013,UCLA,8,3,11,0.7272727272727273
vs. BCS non-AQ,2013,UCLA,2,0,2,1.0
vs. FBS Power 5,2013,UCLA,8,3,11,0.7272727272727273
vs. FBS non-Power 5,2013,UCLA,2,0,2,1.0
in August/September,2013,UCLA,3,0,3,1.0
in October,2013,UCLA,2,2,4,0.5
in November,2013,UCLA,4,1,5,0.8
in December/January,2013,UCLA,1,0,1,1.0
All Games,2014,UCLA,10,3,13,0.7692307692307693
at Home,2014,UCLA,3,3,6,0.5
on Road/Neutral Site,2014,UCLA,7,0,7,1.0
vs. Conference,2014,UCLA,6,3,9,0.6666666666666666
vs. Non-Conference,2014,UCLA,4,0,4,1.0
vs. Ranked (AP),2014,UCLA,5,2,7,0.7142857142857143
vs. Unranked (AP),2014,UCLA,5,1,6,0.8333333333333334
vs. FBS (I-A),2014,UCLA,10,3,13,0.7692307692307693
vs. FCS (I-AA),2014,UCLA,0,0,0,
vs. FBS Winning,2014,UCLA,6,3,9,0.6666666666666666
vs. FBS Non-Winning,2014,UCLA,4,0,4,1.0
vs. BCS AQ,2014,UCLA,10,3,13,0.7692307692307693
vs. BCS non-AQ,2014,UCLA,0,0,0,
vs. FBS Power 5,2014,UCLA,9,3,12,0.75
vs. FBS non-Power 5,2014,UCLA,1,0,1,1.0
in August/September,2014,UCLA,4,0,4,1.0
in October,2014,UCLA,2,2,4,0.5
in November,2014,UCLA,3,1,4,0.75
in December/January,2014,UCLA,1,0,1,1.0
All Games,2015,UCLA,8,5,13,0.6153846153846154
at Home,2015,UCLA,4,2,6,0.6666666666666666
on Road/Neutral Site,2015,UCLA,4,3,7,0.5714285714285714
vs. Conference,2015,UCLA,5,4,9,0.5555555555555556
vs. Non-Conference,2015,UCLA,3,1,4,0.75
vs. Ranked (AP),2015,UCLA,1,1,2,0.5
vs. Unranked (AP),2015,UCLA,7,4,11,0.6363636363636364
vs. FBS (I-A),2015,UCLA,8,5,13,0.6153846153846154
vs. FCS (I-AA),2015,UCLA,0,0,0,
vs. FBS Winning,2015,UCLA,4,3,7,0.5714285714285714
vs. FBS Non-Winning,2015,UCLA,4,2,6,0.6666666666666666
vs. BCS AQ,2015,UCLA,6,5,11,0.5454545454545454
vs. BCS non-AQ,2015,UCLA,2,0,2,1.0
vs. FBS Power 5,2015,UCLA,6,5,11,0.5454545454545454
vs. FBS non-Power 5,2015,UCLA,2,0,2,1.0
in August/September,2015,UCLA,4,0,4,1.0
in October,2015,UCLA,2,2,4,0.5
in November,2015,UCLA,2,2,4,0.5
in December/January,2015,UCLA,0,1,1,0.0
All Games,2016,UCLA,4,8,12,0.3333333333333333
at Home,2016,UCLA,3,3,6,0.5
on Road/Neutral Site,2016,UCLA,1,5,6,0.16666666666666666
vs. Conference,2016,UCLA,2,7,9,0.2222222222222222
vs. Non-Conference,2016,UCLA,2,1,3,0.6666666666666666
vs. Ranked (AP),2016,UCLA,0,3,3,0.0
vs. Unranked (AP),2016,UCLA,4,5,9,0.4444444444444444
vs. FBS (I-A),2016,UCLA,4,8,12,0.3333333333333333
vs. FCS (I-AA),2016,UCLA,0,0,0,
vs. FBS Winning,2016,UCLA,1,6,7,0.14285714285714285
vs. FBS Non-Winning,2016,UCLA,3,2,5,0.6
vs. BCS AQ,2016,UCLA,2,8,10,0.2
vs. BCS non-AQ,2016,UCLA,2,0,2,1.0
vs. FBS Power 5,2016,UCLA,2,8,10,0.2
vs. FBS non-Power 5,2016,UCLA,2,0,2,1.0
in August/September,2016,UCLA,2,2,4,0.5
in October,2016,UCLA,1,3,4,0.25
in November,2016,UCLA,1,3,4,0.25
in December/January,2016,UCLA,0,0,0,
All Games,2017,UCLA,6,7,13,0.46153846153846156
at Home,2017,UCLA,6,0,6,1.0
on Road/Neutral Site,2017,UCLA,0,7,7,0.0
vs. Conference,2017,UCLA,4,5,9,0.4444444444444444
vs. Non-Conference,2017,UCLA,2,2,4,0.5
vs. Ranked (AP),2017,UCLA,0,4,4,0.0
vs. Unranked (AP),2017,UCLA,6,3,9,0.6666666666666666
vs. FBS (I-A),2017,UCLA,6,7,13,0.46153846153846156
vs. FCS (I-AA),2017,UCLA,0,0,0,
vs. FBS Winning,2017,UCLA,3,7,10,0.3
vs. FBS Non-Winning,2017,UCLA,3,0,3,1.0
vs. BCS AQ,2017,UCLA,5,7,12,0.4166666666666667
vs. BCS non-AQ,2017,UCLA,1,0,1,1.0
vs. FBS Power 5,2017,UCLA,5,6,11,0.45454545454545453
vs. FBS non-Power 5,2017,UCLA,1,1,2,0.5
in August/September,2017,UCLA,3,2,5,0.6
in October,2017,UCLA,1,2,3,0.3333333333333333
in November,2017,UCLA,2,2,4,0.5
in December/January,2017,UCLA,0,1,1,0.0
All Games,2018,UCLA,3,9,12,0.25
at Home,2018,UCLA,2,5,7,0.2857142857142857
on Road/Neutral Site,2018,UCLA,1,4,5,0.2
vs. Conference,2018,UCLA,3,6,9,0.3333333333333333
vs. Non-Conference,2018,UCLA,0,3,3,0.0
vs. Ranked (AP),2018,UCLA,0,4,4,0.0
vs. Unranked (AP),2018,UCLA,3,5,8,0.375
vs. FBS (I-A),2018,UCLA,3,9,12,0.25
vs. FCS (I-AA),2018,UCLA,0,0,0,
vs. FBS Winning,2018,UCLA,1,8,9,0.1111111111111111
vs. FBS Non-Winning,2018,UCLA,2,1,3,0.6666666666666666
vs. BCS AQ,2018,UCLA,3,8,11,0.2727272727272727
vs. BCS non-AQ,2018,UCLA,0,1,1,0.0
vs. FBS Power 5,2018,UCLA,3,7,10,0.3
vs. FBS non-Power 5,2018,UCLA,0,2,2,0.0
in August/September,2018,UCLA,0,4,4,0.0
in October,2018,UCLA,2,2,4,0.5
in November,2018,UCLA,1,3,4,0.25
in December/January,2018,UCLA,0,0,0,
All Games,2019,UCLA,4,8,12,0.3333333333333333
at Home,2019,UCLA,2,4,6,0.3333333333333333
on Road/Neutral Site,2019,UCLA,2,4,6,0.3333333333333333
vs. Conference,2019,UCLA,4,5,9,0.4444444444444444
vs. Non-Conference,2019,UCLA,0,3,3,0.0
vs. Ranked (AP),2019,UCLA,0,3,3,0.0
vs. Unranked (AP),2019,UCLA,4,5,9,0.4444444444444444
vs. FBS (I-A),2019,UCLA,4,8,12,0.3333333333333333
vs. FCS (I-AA),2019,UCLA,0,0,0,
vs. FBS Winning,2019,UCLA,1,6,7,0.14285714285714285
vs. FBS Non-Winning,2019,UCLA,3,2,5,0.6
vs. BCS AQ,2019,UCLA,4,7,11,0.36363636363636365
vs. BCS non-AQ,2019,UCLA,0,1,1,0.0
vs. FBS Power 5,2019,UCLA,4,6,10,0.4
vs. FBS non-Power 5,2019,UCLA,0,2,2,0.0
in August/September,2019,UCLA,1,4,5,0.2
in October,2019,UCLA,2,1,3,0.6666666666666666
in November,2019,UCLA,1,3,4,0.25
in December/January,2019,UCLA,0,0,0,
All Games,2020,UCLA,3,4,7,0.42857142857142855
at Home,2020,UCLA,2,2,4,0.5
on Road/Neutral Site,2020,UCLA,1,2,3,0.3333333333333333
vs. Conference,2020,UCLA,3,4,7,0.42857142857142855
vs. Non-Conference,2020,UCLA,0,0,0,
vs. Ranked (AP),2020,UCLA,0,2,2,0.0
vs. Unranked (AP),2020,UCLA,3,2,5,0.6
vs. FBS (I-A),2020,UCLA,3,4,7,0.42857142857142855
vs. FCS (I-AA),2020,UCLA,0,0,0,
vs. FBS Winning,2020,UCLA,0,4,4,0.0
vs. FBS Non-Winning,2020,UCLA,3,0,3,1.0
vs. BCS AQ,2020,UCLA,3,4,7,0.42857142857142855
vs. BCS non-AQ,2020,UCLA,0,0,0,
vs. FBS Power 5,2020,UCLA,3,4,7,0.42857142857142855
vs. FBS non-Power 5,2020,UCLA,0,0,0,
in August/September,2020,UCLA,0,0,0,
in October,2020,UCLA,0,0,0,
in November,2020,UCLA,2,2,4,0.5
in December/January,2020,UCLA,1,2,3,0.3333333333333333
All Games,2021,UCLA,8,4,12,0.6666666666666666
at Home,2021,UCLA,4,3,7,0.5714285714285714
on Road/Neutral Site,2021,UCLA,4,1,5,0.8
vs. Conference,2021,UCLA,6,3,9,0.6666666666666666
vs. Non-Conference,2021,UCLA,2,1,3,0.6666666666666666
vs. Ranked (AP),2021,UCLA,0,2,2,0.0
vs. Unranked (AP),2021,UCLA,8,2,10,0.8
vs. FBS (I-A),2021,UCLA,8,4,12,0.6666666666666666
vs. FCS (I-AA),2021,UCLA,0,0,0,
vs. FBS Winning,2021,UCLA,0,4,4,0.0
vs. FBS Non-Winning,2021,UCLA,8,0,8,1.0
vs. BCS AQ,2021,UCLA,7,3,10,0.7
vs. BCS non-AQ,2021,UCLA,1,1,2,0.5
vs. FBS Power 5,2021,UCLA,7,3,10,0.7
vs. FBS non-Power 5,2021,UCLA,1,1,2,0.5
in August/September,2021,UCLA,3,1,4,0.75
in October,2021,UCLA,2,3,5,0.4
in November,2021,UCLA,3,0,3,1.0
in December/January,2021,UCLA,0,0,0,
All Games,2022,UCLA,9,4,13,0.6923076923076923
at Home,2022,UCLA,6,2,8,0.75
on Road/Neutral Site,2022,UCLA,3,2,5,0.6
vs. Conference,2022,UCLA,6,3,9,0.6666666666666666
vs. Non-Conference,2022,UCLA,3,1,4,0.75
vs. Ranked (AP),2022,UCLA,2,3,5,0.4
vs. Unranked (AP),2022,UCLA,7,1,8,0.875
vs. FBS (I-A),2022,UCLA,8,4,12,0.6666666666666666
vs. FCS (I-AA),2022,UCLA,1,0,1,1.0
vs. FBS Winning,2022,UCLA,3,3,6,0.5
vs. FBS Non-Winning,2022,UCLA,5,1,6,0.8333333333333334
vs. BCS AQ,2022,UCLA,6,4,10,0.6
vs. BCS non-AQ,2022,UCLA,2,0,2,1.0
vs. FBS Power 5,2022,UCLA,6,4,10,0.6
vs. FBS non-Power 5,2022,UCLA,2,0,2,1.0
in August/September,2022,UCLA,5,0,5,1.0
in October,2022,UCLA,2,1,3,0.6666666666666666
in November,2022,UCLA,2,2,4,0.5
in December/January,2022,UCLA,0,1,1,0.0
All Games,2009,UNLV,5,7,12,0.4166666666666667
at Home,2009,UNLV,4,3,7,0.5714285714285714
on Road/Neutral Site,2009,UNLV,1,4,5,0.2
vs. Conference,2009,UNLV,3,5,8,0.375
vs. Non-Conference,2009,UNLV,2,2,4,0.5
vs. Ranked (AP),2009,UNLV,0,3,3,0.0
vs. Unranked (AP),2009,UNLV,5,4,9,0.5555555555555556
vs. FBS (I-A),2009,UNLV,4,7,11,0.36363636363636365
vs. FCS (I-AA),2009,UNLV,1,0,1,1.0
vs. FBS Winning,2009,UNLV,0,7,7,0.0
vs. FBS Non-Winning,2009,UNLV,4,0,4,1.0
vs. BCS AQ,2009,UNLV,0,1,1,0.0
vs. BCS non-AQ,2009,UNLV,4,6,10,0.4
vs. FBS Power 5,2009,UNLV,0,1,1,0.0
vs. FBS non-Power 5,2009,UNLV,4,6,10,0.4
in August/September,2009,UNLV,2,2,4,0.5
in October,2009,UNLV,1,4,5,0.2
in November,2009,UNLV,2,1,3,0.6666666666666666
in December/January,2009,UNLV,0,0,0,
All Games,2010,UNLV,2,11,13,0.15384615384615385
at Home,2010,UNLV,2,4,6,0.3333333333333333
on Road/Neutral Site,2010,UNLV,0,7,7,0.0
vs. Conference,2010,UNLV,2,6,8,0.25
vs. Non-Conference,2010,UNLV,0,5,5,0.0
vs. Ranked (AP),2010,UNLV,0,3,3,0.0
vs. Unranked (AP),2010,UNLV,2,8,10,0.2
vs. FBS (I-A),2010,UNLV,2,11,13,0.15384615384615385
vs. FCS (I-AA),2010,UNLV,0,0,0,
vs. FBS Winning,2010,UNLV,0,9,9,0.0
vs. FBS Non-Winning,2010,UNLV,2,2,4,0.5
vs. BCS AQ,2010,UNLV,0,2,2,0.0
vs. BCS non-AQ,2010,UNLV,2,9,11,0.18181818181818182
vs. FBS Power 5,2010,UNLV,0,1,1,0.0
vs. FBS non-Power 5,2010,UNLV,2,10,12,0.16666666666666666
in August/September,2010,UNLV,1,3,4,0.25
in October,2010,UNLV,0,4,4,0.0
in November,2010,UNLV,1,3,4,0.25
in December/January,2010,UNLV,0,1,1,0.0
All Games,2011,UNLV,2,10,12,0.16666666666666666
at Home,2011,UNLV,2,3,5,0.4
on Road/Neutral Site,2011,UNLV,0,7,7,0.0
vs. Conference,2011,UNLV,1,6,7,0.14285714285714285
vs. Non-Conference,2011,UNLV,1,4,5,0.2
vs. Ranked (AP),2011,UNLV,0,3,3,0.0
vs. Unranked (AP),2011,UNLV,2,7,9,0.2222222222222222
vs. FBS (I-A),2011,UNLV,2,9,11,0.18181818181818182
vs. FCS (I-AA),2011,UNLV,0,1,1,0.0
vs. FBS Winning,2011,UNLV,0,7,7,0.0
vs. FBS Non-Winning,2011,UNLV,2,2,4,0.5
vs. BCS AQ,2011,UNLV,0,2,2,0.0
vs. BCS non-AQ,2011,UNLV,2,7,9,0.2222222222222222
vs. FBS Power 5,2011,UNLV,0,2,2,0.0
vs. FBS non-Power 5,2011,UNLV,2,7,9,0.2222222222222222
in August/September,2011,UNLV,1,3,4,0.25
in October,2011,UNLV,1,2,3,0.3333333333333333
in November,2011,UNLV,0,4,4,0.0
in December/January,2011,UNLV,0,1,1,0.0
All Games,2012,UNLV,2,11,13,0.15384615384615385
at Home,2012,UNLV,2,5,7,0.2857142857142857
on Road/Neutral Site,2012,UNLV,0,6,6,0.0
vs. Conference,2012,UNLV,2,6,8,0.25
vs. Non-Conference,2012,UNLV,0,5,5,0.0
vs. Ranked (AP),2012,UNLV,0,2,2,0.0
vs. Unranked (AP),2012,UNLV,2,9,11,0.18181818181818182
vs. FBS (I-A),2012,UNLV,2,10,12,0.16666666666666666
vs. FCS (I-AA),2012,UNLV,0,1,1,0.0
vs. FBS Winning,2012,UNLV,0,5,5,0.0
vs. FBS Non-Winning,2012,UNLV,2,5,7,0.2857142857142857
vs. BCS AQ,2012,UNLV,0,2,2,0.0
vs. BCS non-AQ,2012,UNLV,2,8,10,0.2
vs. FBS Power 5,2012,UNLV,0,2,2,0.0
vs. FBS non-Power 5,2012,UNLV,2,8,10,0.2
in August/September,2012,UNLV,1,4,5,0.2
in October,2012,UNLV,0,4,4,0.0
in November,2012,UNLV,1,3,4,0.25
in December/January,2012,UNLV,0,0,0,
All Games,2013,UNLV,7,6,13,0.5384615384615384
at Home,2013,UNLV,4,3,7,0.5714285714285714
on Road/Neutral Site,2013,UNLV,3,3,6,0.5
vs. Conference,2013,UNLV,5,3,8,0.625
vs. Non-Conference,2013,UNLV,2,3,5,0.4
vs. Ranked (AP),2013,UNLV,0,0,0,
vs. Unranked (AP),2013,UNLV,7,6,13,0.5384615384615384
vs. FBS (I-A),2013,UNLV,6,6,12,0.5
vs. FCS (I-AA),2013,UNLV,1,0,1,1.0
vs. FBS Winning,2013,UNLV,1,5,6,0.16666666666666666
vs. FBS Non-Winning,2013,UNLV,5,1,6,0.8333333333333334
vs. BCS AQ,2013,UNLV,0,2,2,0.0
vs. BCS non-AQ,2013,UNLV,6,4,10,0.6
vs. FBS Power 5,2013,UNLV,0,2,2,0.0
vs. FBS non-Power 5,2013,UNLV,6,4,10,0.6
in August/September,2013,UNLV,3,2,5,0.6
in October,2013,UNLV,2,1,3,0.6666666666666666
in November,2013,UNLV,2,2,4,0.5
in December/January,2013,UNLV,0,1,1,0.0
All Games,2014,UNLV,2,11,13,0.15384615384615385
at Home,2014,UNLV,2,4,6,0.3333333333333333
on Road/Neutral Site,2014,UNLV,0,7,7,0.0
vs. Conference,2014,UNLV,1,7,8,0.125
vs. Non-Conference,2014,UNLV,1,4,5,0.2
vs. Ranked (AP),2014,UNLV,0,1,1,0.0
vs. Unranked (AP),2014,UNLV,2,10,12,0.16666666666666666
vs. FBS (I-A),2014,UNLV,1,11,12,0.08333333333333333
vs. FCS (I-AA),2014,UNLV,1,0,1,1.0
vs. FBS Winning,2014,UNLV,0,8,8,0.0
vs. FBS Non-Winning,2014,UNLV,1,3,4,0.25
vs. BCS AQ,2014,UNLV,0,2,2,0.0
vs. BCS non-AQ,2014,UNLV,1,9,10,0.1
vs. FBS Power 5,2014,UNLV,0,1,1,0.0
vs. FBS non-Power 5,2014,UNLV,1,10,11,0.09090909090909091
in August/September,2014,UNLV,1,4,5,0.2
in October,2014,UNLV,1,2,3,0.3333333333333333
in November,2014,UNLV,0,5,5,0.0
in December/January,2014,UNLV,0,0,0,
All Games,2015,UNLV,3,9,12,0.25
at Home,2015,UNLV,2,4,6,0.3333333333333333
on Road/Neutral Site,2015,UNLV,1,5,6,0.16666666666666666
vs. Conference,2015,UNLV,2,6,8,0.25
vs. Non-Conference,2015,UNLV,1,3,4,0.25
vs. Ranked (AP),2015,UNLV,0,1,1,0.0
vs. Unranked (AP),2015,UNLV,3,8,11,0.2727272727272727
vs. FBS (I-A),2015,UNLV,2,9,11,0.18181818181818182
vs. FCS (I-AA),2015,UNLV,1,0,1,1.0
vs. FBS Winning,2015,UNLV,1,6,7,0.14285714285714285
vs. FBS Non-Winning,2015,UNLV,1,3,4,0.25
vs. BCS AQ,2015,UNLV,0,2,2,0.0
vs. BCS non-AQ,2015,UNLV,2,7,9,0.2222222222222222
vs. FBS Power 5,2015,UNLV,0,2,2,0.0
vs. FBS non-Power 5,2015,UNLV,2,7,9,0.2222222222222222
in August/September,2015,UNLV,1,3,4,0.25
in October,2015,UNLV,1,3,4,0.25
in November,2015,UNLV,1,3,4,0.25
in December/January,2015,UNLV,0,0,0,
All Games,2016,UNLV,4,8,12,0.3333333333333333
at Home,2016,UNLV,3,3,6,0.5
on Road/Neutral Site,2016,UNLV,1,5,6,0.16666666666666666
vs. Conference,2016,UNLV,3,5,8,0.375
vs. Non-Conference,2016,UNLV,1,3,4,0.25
vs. Ranked (AP),2016,UNLV,0,0,0,
vs. Unranked (AP),2016,UNLV,4,8,12,0.3333333333333333
vs. FBS (I-A),2016,UNLV,3,8,11,0.2727272727272727
vs. FCS (I-AA),2016,UNLV,1,0,1,1.0
vs. FBS Winning,2016,UNLV,1,4,5,0.2
vs. FBS Non-Winning,2016,UNLV,2,4,6,0.3333333333333333
vs. BCS AQ,2016,UNLV,0,1,1,0.0
vs. BCS non-AQ,2016,UNLV,3,7,10,0.3
vs. FBS Power 5,2016,UNLV,0,1,1,0.0
vs. FBS non-Power 5,2016,UNLV,3,7,10,0.3
in August/September,2016,UNLV,1,3,4,0.25
in October,2016,UNLV,2,3,5,0.4
in November,2016,UNLV,1,2,3,0.3333333333333333
in December/January,2016,UNLV,0,0,0,
All Games,2017,UNLV,5,7,12,0.4166666666666667
at Home,2017,UNLV,2,4,6,0.3333333333333333
on Road/Neutral Site,2017,UNLV,3,3,6,0.5
vs. Conference,2017,UNLV,4,4,8,0.5
vs. Non-Conference,2017,UNLV,1,3,4,0.25
vs. Ranked (AP),2017,UNLV,0,1,1,0.0
vs. Unranked (AP),2017,UNLV,5,6,11,0.45454545454545453
vs. FBS (I-A),2017,UNLV,5,6,11,0.45454545454545453
vs. FCS (I-AA),2017,UNLV,0,1,1,0.0
vs. FBS Winning,2017,UNLV,1,2,3,0.3333333333333333
vs. FBS Non-Winning,2017,UNLV,4,4,8,0.5
vs. BCS AQ,2017,UNLV,0,1,1,0.0
vs. BCS non-AQ,2017,UNLV,5,5,10,0.5
vs. FBS Power 5,2017,UNLV,0,1,1,0.0
vs. FBS non-Power 5,2017,UNLV,5,5,10,0.5
in August/September,2017,UNLV,2,2,4,0.5
in October,2017,UNLV,1,3,4,0.25
in November,2017,UNLV,2,2,4,0.5
in December/January,2017,UNLV,0,0,0,
All Games,2018,UNLV,4,8,12,0.3333333333333333
at Home,2018,UNLV,3,3,6,0.5
on Road/Neutral Site,2018,UNLV,1,5,6,0.16666666666666666
vs. Conference,2018,UNLV,2,6,8,0.25
vs. Non-Conference,2018,UNLV,2,2,4,0.5
vs. Ranked (AP),2018,UNLV,0,2,2,0.0
vs. Unranked (AP),2018,UNLV,4,6,10,0.4
vs. FBS (I-A),2018,UNLV,3,8,11,0.2727272727272727
vs. FCS (I-AA),2018,UNLV,1,0,1,1.0
vs. FBS Winning,2018,UNLV,2,4,6,0.3333333333333333
vs. FBS Non-Winning,2018,UNLV,1,4,5,0.2
vs. BCS AQ,2018,UNLV,0,1,1,0.0
vs. BCS non-AQ,2018,UNLV,3,7,10,0.3
vs. FBS Power 5,2018,UNLV,0,1,1,0.0
vs. FBS non-Power 5,2018,UNLV,3,7,10,0.3
in August/September,2018,UNLV,2,2,4,0.5
in October,2018,UNLV,0,4,4,0.0
in November,2018,UNLV,2,2,4,0.5
in December/January,2018,UNLV,0,0,0,
All Games,2019,UNLV,4,8,12,0.3333333333333333
at Home,2019,UNLV,2,4,6,0.3333333333333333
on Road/Neutral Site,2019,UNLV,2,4,6,0.3333333333333333
vs. Conference,2019,UNLV,2,6,8,0.25
vs. Non-Conference,2019,UNLV,2,2,4,0.5
vs. Ranked (AP),2019,UNLV,0,1,1,0.0
vs. Unranked (AP),2019,UNLV,4,7,11,0.36363636363636365
vs. FBS (I-A),2019,UNLV,3,8,11,0.2727272727272727
vs. FCS (I-AA),2019,UNLV,1,0,1,1.0
vs. FBS Winning,2019,UNLV,1,5,6,0.16666666666666666
vs. FBS Non-Winning,2019,UNLV,2,3,5,0.4
vs. BCS AQ,2019,UNLV,1,1,2,0.5
vs. BCS non-AQ,2019,UNLV,2,7,9,0.2222222222222222
vs. FBS Power 5,2019,UNLV,1,1,2,0.5
vs. FBS non-Power 5,2019,UNLV,2,7,9,0.2222222222222222
in August/September,2019,UNLV,1,3,4,0.25
in October,2019,UNLV,1,3,4,0.25
in November,2019,UNLV,2,2,4,0.5
in December/January,2019,UNLV,0,0,0,
All Games,2020,UNLV,0,6,6,0.0
at Home,2020,UNLV,0,3,3,0.0
on Road/Neutral Site,2020,UNLV,0,3,3,0.0
vs. Conference,2020,UNLV,0,6,6,0.0
vs. Non-Conference,2020,UNLV,0,0,0,
vs. Ranked (AP),2020,UNLV,0,1,1,0.0
vs. Unranked (AP),2020,UNLV,0,5,5,0.0
vs. FBS (I-A),2020,UNLV,0,6,6,0.0
vs. FCS (I-AA),2020,UNLV,0,0,0,
vs. FBS Winning,2020,UNLV,0,3,3,0.0
vs. FBS Non-Winning,2020,UNLV,0,3,3,0.0
vs. BCS AQ,2020,UNLV,0,0,0,
vs. BCS non-AQ,2020,UNLV,0,6,6,0.0
vs. FBS Power 5,2020,UNLV,0,0,0,
vs. FBS non-Power 5,2020,UNLV,0,6,6,0.0
in August/September,2020,UNLV,0,0,0,
in October,2020,UNLV,0,2,2,0.0
in November,2020,UNLV,0,3,3,0.0
in December/January,2020,UNLV,0,1,1,0.0
All Games,2021,UNLV,2,10,12,0.16666666666666666
at Home,2021,UNLV,1,5,6,0.16666666666666666
on Road/Neutral Site,2021,UNLV,1,5,6,0.16666666666666666
vs. Conference,2021,UNLV,2,6,8,0.25
vs. Non-Conference,2021,UNLV,0,4,4,0.0
vs. Ranked (AP),2021,UNLV,0,2,2,0.0
vs. Unranked (AP),2021,UNLV,2,8,10,0.2
vs. FBS (I-A),2021,UNLV,2,9,11,0.18181818181818182
vs. FCS (I-AA),2021,UNLV,0,1,1,0.0
vs. FBS Winning,2021,UNLV,0,8,8,0.0
vs. FBS Non-Winning,2021,UNLV,2,1,3,0.6666666666666666
vs. BCS AQ,2021,UNLV,0,2,2,0.0
vs. BCS non-AQ,2021,UNLV,2,7,9,0.2222222222222222
vs. FBS Power 5,2021,UNLV,0,2,2,0.0
vs. FBS non-Power 5,2021,UNLV,2,7,9,0.2222222222222222
in August/September,2021,UNLV,0,4,4,0.0
in October,2021,UNLV,0,4,4,0.0
in November,2021,UNLV,2,2,4,0.5
in December/January,2021,UNLV,0,0,0,
All Games,2022,UNLV,5,7,12,0.4166666666666667
at Home,2022,UNLV,4,2,6,0.6666666666666666
on Road/Neutral Site,2022,UNLV,1,5,6,0.16666666666666666
vs. Conference,2022,UNLV,3,5,8,0.375
vs. Non-Conference,2022,UNLV,2,2,4,0.5
vs. Ranked (AP),2022,UNLV,0,2,2,0.0
vs. Unranked (AP),2022,UNLV,5,5,10,0.5
vs. FBS (I-A),2022,UNLV,4,7,11,0.36363636363636365
vs. FCS (I-AA),2022,UNLV,1,0,1,1.0
vs. FBS Winning,2022,UNLV,0,5,5,0.0
vs. FBS Non-Winning,2022,UNLV,4,2,6,0.6666666666666666
vs. BCS AQ,2022,UNLV,0,2,2,0.0
vs. BCS non-AQ,2022,UNLV,4,5,9,0.4444444444444444
vs. FBS Power 5,2022,UNLV,0,1,1,0.0
vs. FBS non-Power 5,2022,UNLV,4,6,10,0.4
in August/September,2022,UNLV,4,1,5,0.8
in October,2022,UNLV,0,3,3,0.0
in November,2022,UNLV,1,3,4,0.25
in December/January,2022,UNLV,0,0,0,
All Games,2009,USC,9,4,13,0.6923076923076923
at Home,2009,USC,4,2,6,0.6666666666666666
on Road/Neutral Site,2009,USC,5,2,7,0.7142857142857143
vs. Conference,2009,USC,5,4,9,0.5555555555555556
vs. Non-Conference,2009,USC,4,0,4,1.0
vs. Ranked (AP),2009,USC,1,1,2,0.5
vs. Unranked (AP),2009,USC,8,3,11,0.7272727272727273
vs. FBS (I-A),2009,USC,9,4,13,0.6923076923076923
vs. FCS (I-AA),2009,USC,0,0,0,
vs. FBS Winning,2009,USC,5,3,8,0.625
vs. FBS Non-Winning,2009,USC,4,1,5,0.8
vs. BCS AQ,2009,USC,8,4,12,0.6666666666666666
vs. BCS non-AQ,2009,USC,1,0,1,1.0
vs. FBS Power 5,2009,USC,7,4,11,0.6363636363636364
vs. FBS non-Power 5,2009,USC,2,0,2,1.0
in August/September,2009,USC,3,1,4,0.75
in October,2009,USC,3,1,4,0.75
in November,2009,USC,2,1,3,0.6666666666666666
in December/January,2009,USC,1,1,2,0.5
All Games,2010,USC,8,5,13,0.6153846153846154
at Home,2010,USC,3,3,6,0.5
on Road/Neutral Site,2010,USC,5,2,7,0.7142857142857143
vs. Conference,2010,USC,5,4,9,0.5555555555555556
vs. Non-Conference,2010,USC,3,1,4,0.75
vs. Ranked (AP),2010,USC,0,2,2,0.0
vs. Unranked (AP),2010,USC,8,3,11,0.7272727272727273
vs. FBS (I-A),2010,USC,8,5,13,0.6153846153846154
vs. FCS (I-AA),2010,USC,0,0,0,
vs. FBS Winning,2010,USC,2,4,6,0.3333333333333333
vs. FBS Non-Winning,2010,USC,6,1,7,0.8571428571428571
vs. BCS AQ,2010,USC,7,5,12,0.5833333333333334
vs. BCS non-AQ,2010,USC,1,0,1,1.0
vs. FBS Power 5,2010,USC,7,4,11,0.6363636363636364
vs. FBS non-Power 5,2010,USC,1,1,2,0.5
in August/September,2010,USC,4,0,4,1.0
in October,2010,USC,1,3,4,0.25
in November,2010,USC,2,2,4,0.5
in December/January,2010,USC,1,0,1,1.0
All Games,2011,USC,10,2,12,0.8333333333333334
at Home,2011,USC,6,1,7,0.8571428571428571
on Road/Neutral Site,2011,USC,4,1,5,0.8
vs. Conference,2011,USC,7,2,9,0.7777777777777778
vs. Non-Conference,2011,USC,3,0,3,1.0
vs. Ranked (AP),2011,USC,1,1,2,0.5
vs. Unranked (AP),2011,USC,9,1,10,0.9
vs. FBS (I-A),2011,USC,10,2,12,0.8333333333333334
vs. FCS (I-AA),2011,USC,0,0,0,
vs. FBS Winning,2011,USC,5,1,6,0.8333333333333334
vs. FBS Non-Winning,2011,USC,5,1,6,0.8333333333333334
vs. BCS AQ,2011,USC,10,2,12,0.8333333333333334
vs. BCS non-AQ,2011,USC,0,0,0,
vs. FBS Power 5,2011,USC,8,2,10,0.8
vs. FBS non-Power 5,2011,USC,2,0,2,1.0
in August/September,2011,USC,3,1,4,0.75
in October,2011,USC,3,1,4,0.75
in November,2011,USC,4,0,4,1.0
in December/January,2011,USC,0,0,0,
All Games,2012,USC,7,6,13,0.5384615384615384
at Home,2012,USC,4,2,6,0.6666666666666666
on Road/Neutral Site,2012,USC,3,4,7,0.42857142857142855
vs. Conference,2012,USC,5,4,9,0.5555555555555556
vs. Non-Conference,2012,USC,2,2,4,0.5
vs. Ranked (AP),2012,USC,0,3,3,0.0
vs. Unranked (AP),2012,USC,7,3,10,0.7
vs. FBS (I-A),2012,USC,7,6,13,0.5384615384615384
vs. FCS (I-AA),2012,USC,0,0,0,
vs. FBS Winning,2012,USC,3,5,8,0.375
vs. FBS Non-Winning,2012,USC,4,1,5,0.8
vs. BCS AQ,2012,USC,6,6,12,0.5
vs. BCS non-AQ,2012,USC,1,0,1,1.0
vs. FBS Power 5,2012,USC,5,5,10,0.5
vs. FBS non-Power 5,2012,USC,2,1,3,0.6666666666666666
in August/September,2012,USC,3,1,4,0.75
in October,2012,USC,3,1,4,0.75
in November,2012,USC,1,3,4,0.25
in December/January,2012,USC,0,1,1,0.0
All Games,2013,USC,10,4,14,0.7142857142857143
at Home,2013,USC,5,2,7,0.7142857142857143
on Road/Neutral Site,2013,USC,5,2,7,0.7142857142857143
vs. Conference,2013,USC,6,3,9,0.6666666666666666
vs. Non-Conference,2013,USC,4,1,5,0.8
vs. Ranked (AP),2013,USC,1,3,4,0.25
vs. Unranked (AP),2013,USC,9,1,10,0.9
vs. FBS (I-A),2013,USC,10,4,14,0.7142857142857143
vs. FCS (I-AA),2013,USC,0,0,0,
vs. FBS Winning,2013,USC,6,3,9,0.6666666666666666
vs. FBS Non-Winning,2013,USC,4,1,5,0.8
vs. BCS AQ,2013,USC,7,4,11,0.6363636363636364
vs. BCS non-AQ,2013,USC,3,0,3,1.0
vs. FBS Power 5,2013,USC,7,3,10,0.7
vs. FBS non-Power 5,2013,USC,3,1,4,0.75
in August/September,2013,USC,3,2,5,0.6
in October,2013,USC,2,1,3,0.6666666666666666
in November,2013,USC,4,1,5,0.8
in December/January,2013,USC,1,0,1,1.0
All Games,2014,USC,9,4,13,0.6923076923076923
at Home,2014,USC,5,1,6,0.8333333333333334
on Road/Neutral Site,2014,USC,4,3,7,0.5714285714285714
vs. Conference,2014,USC,6,3,9,0.6666666666666666
vs. Non-Conference,2014,USC,3,1,4,0.75
vs. Ranked (AP),2014,USC,1,3,4,0.25
vs. Unranked (AP),2014,USC,8,1,9,0.8888888888888888
vs. FBS (I-A),2014,USC,9,4,13,0.6923076923076923
vs. FCS (I-AA),2014,USC,0,0,0,
vs. FBS Winning,2014,USC,4,4,8,0.5
vs. FBS Non-Winning,2014,USC,5,0,5,1.0
vs. BCS AQ,2014,USC,8,4,12,0.6666666666666666
vs. BCS non-AQ,2014,USC,1,0,1,1.0
vs. FBS Power 5,2014,USC,7,4,11,0.6363636363636364
vs. FBS non-Power 5,2014,USC,2,0,2,1.0
in August/September,2014,USC,3,1,4,0.75
in October,2014,USC,2,2,4,0.5
in November,2014,USC,3,1,4,0.75
in December/January,2014,USC,1,0,1,1.0
All Games,2015,USC,8,6,14,0.5714285714285714
at Home,2015,USC,5,2,7,0.7142857142857143
on Road/Neutral Site,2015,USC,3,4,7,0.42857142857142855
vs. Conference,2015,USC,6,4,10,0.6
vs. Non-Conference,2015,USC,2,2,4,0.5
vs. Ranked (AP),2015,USC,1,5,6,0.16666666666666666
vs. Unranked (AP),2015,USC,7,1,8,0.875
vs. FBS (I-A),2015,USC,8,6,14,0.5714285714285714
vs. FCS (I-AA),2015,USC,0,0,0,
vs. FBS Winning,2015,USC,5,6,11,0.45454545454545453
vs. FBS Non-Winning,2015,USC,3,0,3,1.0
vs. BCS AQ,2015,USC,6,6,12,0.5
vs. BCS non-AQ,2015,USC,2,0,2,1.0
vs. FBS Power 5,2015,USC,6,5,11,0.5454545454545454
vs. FBS non-Power 5,2015,USC,2,1,3,0.6666666666666666
in August/September,2015,USC,3,1,4,0.75
in October,2015,USC,2,2,4,0.5
in November,2015,USC,3,1,4,0.75
in December/January,2015,USC,0,2,2,0.0
All Games,2016,USC,10,3,13,0.7692307692307693
at Home,2016,USC,6,0,6,1.0
on Road/Neutral Site,2016,USC,4,3,7,0.5714285714285714
vs. Conference,2016,USC,7,2,9,0.7777777777777778
vs. Non-Conference,2016,USC,3,1,4,0.75
vs. Ranked (AP),2016,USC,3,2,5,0.6
vs. Unranked (AP),2016,USC,7,1,8,0.875
vs. FBS (I-A),2016,USC,10,3,13,0.7692307692307693
vs. FCS (I-AA),2016,USC,0,0,0,
vs. FBS Winning,2016,USC,3,3,6,0.5
vs. FBS Non-Winning,2016,USC,7,0,7,1.0
vs. BCS AQ,2016,USC,9,3,12,0.75
vs. BCS non-AQ,2016,USC,1,0,1,1.0
vs. FBS Power 5,2016,USC,8,3,11,0.7272727272727273
vs. FBS non-Power 5,2016,USC,2,0,2,1.0
in August/September,2016,USC,1,3,4,0.25
in October,2016,USC,4,0,4,1.0
in November,2016,USC,4,0,4,1.0
in December/January,2016,USC,1,0,1,1.0
All Games,2017,USC,11,3,14,0.7857142857142857
at Home,2017,USC,7,0,7,1.0
on Road/Neutral Site,2017,USC,4,3,7,0.5714285714285714
vs. Conference,2017,USC,9,1,10,0.9
vs. Non-Conference,2017,USC,2,2,4,0.5
vs. Ranked (AP),2017,USC,2,2,4,0.5
vs. Unranked (AP),2017,USC,9,1,10,0.9
vs. FBS (I-A),2017,USC,11,3,14,0.7857142857142857
vs. FCS (I-AA),2017,USC,0,0,0,
vs. FBS Winning,2017,USC,6,3,9,0.6666666666666666
vs. FBS Non-Winning,2017,USC,5,0,5,1.0
vs. BCS AQ,2017,USC,10,3,13,0.7692307692307693
vs. BCS non-AQ,2017,USC,1,0,1,1.0
vs. FBS Power 5,2017,USC,10,2,12,0.8333333333333334
vs. FBS non-Power 5,2017,USC,1,1,2,0.5
in August/September,2017,USC,4,1,5,0.8
in October,2017,USC,3,1,4,0.75
in November,2017,USC,3,0,3,1.0
in December/January,2017,USC,1,1,2,0.5
All Games,2018,USC,5,7,12,0.4166666666666667
at Home,2018,USC,3,3,6,0.5
on Road/Neutral Site,2018,USC,2,4,6,0.3333333333333333
vs. Conference,2018,USC,4,5,9,0.4444444444444444
vs. Non-Conference,2018,USC,1,2,3,0.3333333333333333
vs. Ranked (AP),2018,USC,1,2,3,0.3333333333333333
vs. Unranked (AP),2018,USC,4,5,9,0.4444444444444444
vs. FBS (I-A),2018,USC,5,7,12,0.4166666666666667
vs. FCS (I-AA),2018,USC,0,0,0,
vs. FBS Winning,2018,USC,1,6,7,0.14285714285714285
vs. FBS Non-Winning,2018,USC,4,1,5,0.8
vs. BCS AQ,2018,USC,4,7,11,0.36363636363636365
vs. BCS non-AQ,2018,USC,1,0,1,1.0
vs. FBS Power 5,2018,USC,4,6,10,0.4
vs. FBS non-Power 5,2018,USC,1,1,2,0.5
in August/September,2018,USC,3,2,5,0.6
in October,2018,USC,1,2,3,0.3333333333333333
in November,2018,USC,1,3,4,0.25
in December/January,2018,USC,0,0,0,
All Games,2019,USC,8,5,13,0.6153846153846154
at Home,2019,USC,5,1,6,0.8333333333333334
on Road/Neutral Site,2019,USC,3,4,7,0.42857142857142855
vs. Conference,2019,USC,7,2,9,0.7777777777777778
vs. Non-Conference,2019,USC,1,3,4,0.25
vs. Ranked (AP),2019,USC,1,3,4,0.25
vs. Unranked (AP),2019,USC,7,2,9,0.7777777777777778
vs. FBS (I-A),2019,USC,8,5,13,0.6153846153846154
vs. FCS (I-AA),2019,USC,0,0,0,
vs. FBS Winning,2019,USC,3,5,8,0.375
vs. FBS Non-Winning,2019,USC,5,0,5,1.0
vs. BCS AQ,2019,USC,7,4,11,0.6363636363636364
vs. BCS non-AQ,2019,USC,1,1,2,0.5
vs. FBS Power 5,2019,USC,7,3,10,0.7
vs. FBS non-Power 5,2019,USC,1,2,3,0.3333333333333333
in August/September,2019,USC,3,2,5,0.6
in October,2019,USC,2,1,3,0.6666666666666666
in November,2019,USC,3,1,4,0.75
in December/January,2019,USC,0,1,1,0.0
All Games,2020,USC,5,1,6,0.8333333333333334
at Home,2020,USC,2,1,3,0.6666666666666666
on Road/Neutral Site,2020,USC,3,0,3,1.0
vs. Conference,2020,USC,5,1,6,0.8333333333333334
vs. Non-Conference,2020,USC,0,0,0,
vs. Ranked (AP),2020,USC,0,1,1,0.0
vs. Unranked (AP),2020,USC,5,0,5,1.0
vs. FBS (I-A),2020,USC,5,1,6,0.8333333333333334
vs. FCS (I-AA),2020,USC,0,0,0,
vs. FBS Winning,2020,USC,1,1,2,0.5
vs. FBS Non-Winning,2020,USC,4,0,4,1.0
vs. BCS AQ,2020,USC,5,1,6,0.8333333333333334
vs. BCS non-AQ,2020,USC,0,0,0,
vs. FBS Power 5,2020,USC,5,1,6,0.8333333333333334
vs. FBS non-Power 5,2020,USC,0,0,0,
in August/September,2020,USC,0,0,0,
in October,2020,USC,0,0,0,
in November,2020,USC,3,0,3,1.0
in December/January,2020,USC,2,1,3,0.6666666666666666
All Games,2021,USC,4,8,12,0.3333333333333333
at Home,2021,USC,2,5,7,0.2857142857142857
on Road/Neutral Site,2021,USC,2,3,5,0.4
vs. Conference,2021,USC,3,6,9,0.3333333333333333
vs. Non-Conference,2021,USC,1,2,3,0.3333333333333333
vs. Ranked (AP),2021,USC,0,3,3,0.0
vs. Unranked (AP),2021,USC,4,5,9,0.4444444444444444
vs. FBS (I-A),2021,USC,4,8,12,0.3333333333333333
vs. FCS (I-AA),2021,USC,0,0,0,
vs. FBS Winning,2021,USC,1,6,7,0.14285714285714285
vs. FBS Non-Winning,2021,USC,3,2,5,0.6
vs. BCS AQ,2021,USC,3,7,10,0.3
vs. BCS non-AQ,2021,USC,1,1,2,0.5
vs. FBS Power 5,2021,USC,3,6,9,0.3333333333333333
vs. FBS non-Power 5,2021,USC,1,2,3,0.3333333333333333
in August/September,2021,USC,2,2,4,0.5
in October,2021,USC,2,2,4,0.5
in November,2021,USC,0,3,3,0.0
in December/January,2021,USC,0,1,1,0.0
All Games,2022,USC,11,3,14,0.7857142857142857
at Home,2022,USC,7,0,7,1.0
on Road/Neutral Site,2022,USC,4,3,7,0.5714285714285714
vs. Conference,2022,USC,8,2,10,0.8
vs. Non-Conference,2022,USC,3,1,4,0.75
vs. Ranked (AP),2022,USC,4,3,7,0.5714285714285714
vs. Unranked (AP),2022,USC,7,0,7,1.0
vs. FBS (I-A),2022,USC,11,3,14,0.7857142857142857
vs. FCS (I-AA),2022,USC,0,0,0,
vs. FBS Winning,2022,USC,5,3,8,0.625
vs. FBS Non-Winning,2022,USC,6,0,6,1.0
vs. BCS AQ,2022,USC,9,3,12,0.75
vs. BCS non-AQ,2022,USC,2,0,2,1.0
vs. FBS Power 5,2022,USC,8,2,10,0.8
vs. FBS non-Power 5,2022,USC,3,1,4,0.75
in August/September,2022,USC,4,0,4,1.0
in October,2022,USC,3,1,4,0.75
in November,2022,USC,4,0,4,1.0
in December/January,2022,USC,0,2,2,0.0
All Games,2009,UTEP,4,8,12,0.3333333333333333
at Home,2009,UTEP,3,3,6,0.5
on Road/Neutral Site,2009,UTEP,1,5,6,0.16666666666666666
vs. Conference,2009,UTEP,3,5,8,0.375
vs. Non-Conference,2009,UTEP,1,3,4,0.25
vs. Ranked (AP),2009,UTEP,0,1,1,0.0
vs. Unranked (AP),2009,UTEP,4,7,11,0.36363636363636365
vs. FBS (I-A),2009,UTEP,4,8,12,0.3333333333333333
vs. FCS (I-AA),2009,UTEP,0,0,0,
vs. FBS Winning,2009,UTEP,2,2,4,0.5
vs. FBS Non-Winning,2009,UTEP,2,6,8,0.25
vs. BCS AQ,2009,UTEP,0,2,2,0.0
vs. BCS non-AQ,2009,UTEP,4,6,10,0.4
vs. FBS Power 5,2009,UTEP,0,2,2,0.0
vs. FBS non-Power 5,2009,UTEP,4,6,10,0.4
in August/September,2009,UTEP,1,3,4,0.25
in October,2009,UTEP,2,2,4,0.5
in November,2009,UTEP,1,3,4,0.25
in December/January,2009,UTEP,0,0,0,
All Games,2010,UTEP,6,7,13,0.46153846153846156
at Home,2010,UTEP,5,1,6,0.8333333333333334
on Road/Neutral Site,2010,UTEP,1,6,7,0.14285714285714285
vs. Conference,2010,UTEP,3,5,8,0.375
vs. Non-Conference,2010,UTEP,3,2,5,0.6
vs. Ranked (AP),2010,UTEP,0,2,2,0.0
vs. Unranked (AP),2010,UTEP,6,5,11,0.5454545454545454
vs. FBS (I-A),2010,UTEP,5,7,12,0.4166666666666667
vs. FCS (I-AA),2010,UTEP,1,0,1,1.0
vs. FBS Winning,2010,UTEP,0,3,3,0.0
vs. FBS Non-Winning,2010,UTEP,5,4,9,0.5555555555555556
vs. BCS AQ,2010,UTEP,0,1,1,0.0
vs. BCS non-AQ,2010,UTEP,5,6,11,0.45454545454545453
vs. FBS Power 5,2010,UTEP,0,1,1,0.0
vs. FBS non-Power 5,2010,UTEP,5,6,11,0.45454545454545453
in August/September,2010,UTEP,3,1,4,0.75
in October,2010,UTEP,2,3,5,0.4
in November,2010,UTEP,1,2,3,0.3333333333333333
in December/January,2010,UTEP,0,1,1,0.0
All Games,2011,UTEP,5,7,12,0.4166666666666667
at Home,2011,UTEP,3,3,6,0.5
on Road/Neutral Site,2011,UTEP,2,4,6,0.3333333333333333
vs. Conference,2011,UTEP,2,6,8,0.25
vs. Non-Conference,2011,UTEP,3,1,4,0.75
vs. Ranked (AP),2011,UTEP,0,2,2,0.0
vs. Unranked (AP),2011,UTEP,5,5,10,0.5
vs. FBS (I-A),2011,UTEP,4,7,11,0.36363636363636365
vs. FCS (I-AA),2011,UTEP,1,0,1,1.0
vs. FBS Winning,2011,UTEP,0,4,4,0.0
vs. FBS Non-Winning,2011,UTEP,4,3,7,0.5714285714285714
vs. BCS AQ,2011,UTEP,0,1,1,0.0
vs. BCS non-AQ,2011,UTEP,4,6,10,0.4
vs. FBS Power 5,2011,UTEP,0,0,0,
vs. FBS non-Power 5,2011,UTEP,4,7,11,0.36363636363636365
in August/September,2011,UTEP,2,3,5,0.4
in October,2011,UTEP,2,1,3,0.6666666666666666
in November,2011,UTEP,1,3,4,0.25
in December/January,2011,UTEP,0,0,0,
All Games,2012,UTEP,3,9,12,0.25
at Home,2012,UTEP,2,4,6,0.3333333333333333
on Road/Neutral Site,2012,UTEP,1,5,6,0.16666666666666666
vs. Conference,2012,UTEP,2,6,8,0.25
vs. Non-Conference,2012,UTEP,1,3,4,0.25
vs. Ranked (AP),2012,UTEP,0,1,1,0.0
vs. Unranked (AP),2012,UTEP,3,8,11,0.2727272727272727
vs. FBS (I-A),2012,UTEP,3,9,12,0.25
vs. FCS (I-AA),2012,UTEP,0,0,0,
vs. FBS Winning,2012,UTEP,0,8,8,0.0
vs. FBS Non-Winning,2012,UTEP,3,1,4,0.75
vs. BCS AQ,2012,UTEP,0,3,3,0.0
vs. BCS non-AQ,2012,UTEP,3,6,9,0.3333333333333333
vs. FBS Power 5,2012,UTEP,0,3,3,0.0
vs. FBS non-Power 5,2012,UTEP,3,6,9,0.3333333333333333
in August/September,2012,UTEP,1,4,5,0.2
in October,2012,UTEP,1,3,4,0.25
in November,2012,UTEP,1,2,3,0.3333333333333333
in December/January,2012,UTEP,0,0,0,
All Games,2013,UTEP,2,10,12,0.16666666666666666
at Home,2013,UTEP,1,4,5,0.2
on Road/Neutral Site,2013,UTEP,1,6,7,0.14285714285714285
vs. Conference,2013,UTEP,1,7,8,0.125
vs. Non-Conference,2013,UTEP,1,3,4,0.25
vs. Ranked (AP),2013,UTEP,0,1,1,0.0
vs. Unranked (AP),2013,UTEP,2,9,11,0.18181818181818182
vs. FBS (I-A),2013,UTEP,2,10,12,0.16666666666666666
vs. FCS (I-AA),2013,UTEP,0,0,0,
vs. FBS Winning,2013,UTEP,0,7,7,0.0
vs. FBS Non-Winning,2013,UTEP,2,3,5,0.4
vs. BCS AQ,2013,UTEP,0,1,1,0.0
vs. BCS non-AQ,2013,UTEP,2,9,11,0.18181818181818182
vs. FBS Power 5,2013,UTEP,0,1,1,0.0
vs. FBS non-Power 5,2013,UTEP,2,9,11,0.18181818181818182
in August/September,2013,UTEP,1,3,4,0.25
in October,2013,UTEP,0,3,3,0.0
in November,2013,UTEP,1,4,5,0.2
in December/January,2013,UTEP,0,0,0,
All Games,2014,UTEP,7,6,13,0.5384615384615384
at Home,2014,UTEP,5,1,6,0.8333333333333334
on Road/Neutral Site,2014,UTEP,2,5,7,0.2857142857142857
vs. Conference,2014,UTEP,5,3,8,0.625
vs. Non-Conference,2014,UTEP,2,3,5,0.4
vs. Ranked (AP),2014,UTEP,0,1,1,0.0
vs. Unranked (AP),2014,UTEP,7,5,12,0.5833333333333334
vs. FBS (I-A),2014,UTEP,7,6,13,0.5384615384615384
vs. FCS (I-AA),2014,UTEP,0,0,0,
vs. FBS Winning,2014,UTEP,0,5,5,0.0
vs. FBS Non-Winning,2014,UTEP,7,1,8,0.875
vs. BCS AQ,2014,UTEP,0,2,2,0.0
vs. BCS non-AQ,2014,UTEP,7,4,11,0.6363636363636364
vs. FBS Power 5,2014,UTEP,0,2,2,0.0
vs. FBS non-Power 5,2014,UTEP,7,4,11,0.6363636363636364
in August/September,2014,UTEP,2,2,4,0.5
in October,2014,UTEP,2,1,3,0.6666666666666666
in November,2014,UTEP,3,2,5,0.6
in December/January,2014,UTEP,0,1,1,0.0
All Games,2015,UTEP,5,7,12,0.4166666666666667
at Home,2015,UTEP,3,2,5,0.6
on Road/Neutral Site,2015,UTEP,2,5,7,0.2857142857142857
vs. Conference,2015,UTEP,3,5,8,0.375
vs. Non-Conference,2015,UTEP,2,2,4,0.5
vs. Ranked (AP),2015,UTEP,0,0,0,
vs. Unranked (AP),2015,UTEP,5,7,12,0.4166666666666667
vs. FBS (I-A),2015,UTEP,4,7,11,0.36363636363636365
vs. FCS (I-AA),2015,UTEP,1,0,1,1.0
vs. FBS Winning,2015,UTEP,0,4,4,0.0
vs. FBS Non-Winning,2015,UTEP,4,3,7,0.5714285714285714
vs. BCS AQ,2015,UTEP,0,2,2,0.0
vs. BCS non-AQ,2015,UTEP,4,5,9,0.4444444444444444
vs. FBS Power 5,2015,UTEP,0,2,2,0.0
vs. FBS non-Power 5,2015,UTEP,4,5,9,0.4444444444444444
in August/September,2015,UTEP,2,2,4,0.5
in October,2015,UTEP,1,3,4,0.25
in November,2015,UTEP,2,2,4,0.5
in December/January,2015,UTEP,0,0,0,
All Games,2016,UTEP,4,8,12,0.3333333333333333
at Home,2016,UTEP,3,4,7,0.42857142857142855
on Road/Neutral Site,2016,UTEP,1,4,5,0.2
vs. Conference,2016,UTEP,2,6,8,0.25
vs. Non-Conference,2016,UTEP,2,2,4,0.5
vs. Ranked (AP),2016,UTEP,0,0,0,
vs. Unranked (AP),2016,UTEP,4,8,12,0.3333333333333333
vs. FBS (I-A),2016,UTEP,3,8,11,0.2727272727272727
vs. FCS (I-AA),2016,UTEP,1,0,1,1.0
vs. FBS Winning,2016,UTEP,0,4,4,0.0
vs. FBS Non-Winning,2016,UTEP,3,4,7,0.42857142857142855
vs. BCS AQ,2016,UTEP,0,1,1,0.0
vs. BCS non-AQ,2016,UTEP,3,7,10,0.3
vs. FBS Power 5,2016,UTEP,0,1,1,0.0
vs. FBS non-Power 5,2016,UTEP,3,7,10,0.3
in August/September,2016,UTEP,1,3,4,0.25
in October,2016,UTEP,1,3,4,0.25
in November,2016,UTEP,2,2,4,0.5
in December/January,2016,UTEP,0,0,0,
All Games,2017,UTEP,0,12,12,0.0
at Home,2017,UTEP,0,5,5,0.0
on Road/Neutral Site,2017,UTEP,0,7,7,0.0
vs. Conference,2017,UTEP,0,8,8,0.0
vs. Non-Conference,2017,UTEP,0,4,4,0.0
vs. Ranked (AP),2017,UTEP,0,1,1,0.0
vs. Unranked (AP),2017,UTEP,0,11,11,0.0
vs. FBS (I-A),2017,UTEP,0,12,12,0.0
vs. FCS (I-AA),2017,UTEP,0,0,0,
vs. FBS Winning,2017,UTEP,0,10,10,0.0
vs. FBS Non-Winning,2017,UTEP,0,2,2,0.0
vs. BCS AQ,2017,UTEP,0,2,2,0.0
vs. BCS non-AQ,2017,UTEP,0,10,10,0.0
vs. FBS Power 5,2017,UTEP,0,2,2,0.0
vs. FBS non-Power 5,2017,UTEP,0,10,10,0.0
in August/September,2017,UTEP,0,5,5,0.0
in October,2017,UTEP,0,3,3,0.0
in November,2017,UTEP,0,4,4,0.0
in December/January,2017,UTEP,0,0,0,
All Games,2018,UTEP,1,11,12,0.08333333333333333
at Home,2018,UTEP,0,6,6,0.0
on Road/Neutral Site,2018,UTEP,1,5,6,0.16666666666666666
vs. Conference,2018,UTEP,1,7,8,0.125
vs. Non-Conference,2018,UTEP,0,4,4,0.0
vs. Ranked (AP),2018,UTEP,0,0,0,
vs. Unranked (AP),2018,UTEP,1,11,12,0.08333333333333333
vs. FBS (I-A),2018,UTEP,1,10,11,0.09090909090909091
vs. FCS (I-AA),2018,UTEP,0,1,1,0.0
vs. FBS Winning,2018,UTEP,0,5,5,0.0
vs. FBS Non-Winning,2018,UTEP,1,5,6,0.16666666666666666
vs. BCS AQ,2018,UTEP,0,1,1,0.0
vs. BCS non-AQ,2018,UTEP,1,9,10,0.1
vs. FBS Power 5,2018,UTEP,0,1,1,0.0
vs. FBS non-Power 5,2018,UTEP,1,9,10,0.1
in August/September,2018,UTEP,0,5,5,0.0
in October,2018,UTEP,0,3,3,0.0
in November,2018,UTEP,1,3,4,0.25
in December/January,2018,UTEP,0,0,0,
All Games,2019,UTEP,1,11,12,0.08333333333333333
at Home,2019,UTEP,1,5,6,0.16666666666666666
on Road/Neutral Site,2019,UTEP,0,6,6,0.0
vs. Conference,2019,UTEP,0,8,8,0.0
vs. Non-Conference,2019,UTEP,1,3,4,0.25
vs. Ranked (AP),2019,UTEP,0,0,0,
vs. Unranked (AP),2019,UTEP,1,11,12,0.08333333333333333
vs. FBS (I-A),2019,UTEP,0,11,11,0.0
vs. FCS (I-AA),2019,UTEP,1,0,1,1.0
vs. FBS Winning,2019,UTEP,0,5,5,0.0
vs. FBS Non-Winning,2019,UTEP,0,6,6,0.0
vs. BCS AQ,2019,UTEP,0,1,1,0.0
vs. BCS non-AQ,2019,UTEP,0,10,10,0.0
vs. FBS Power 5,2019,UTEP,0,1,1,0.0
vs. FBS non-Power 5,2019,UTEP,0,10,10,0.0
in August/September,2019,UTEP,1,3,4,0.25
in October,2019,UTEP,0,3,3,0.0
in November,2019,UTEP,0,5,5,0.0
in December/January,2019,UTEP,0,0,0,
All Games,2020,UTEP,3,5,8,0.375
at Home,2020,UTEP,2,1,3,0.6666666666666666
on Road/Neutral Site,2020,UTEP,1,4,5,0.2
vs. Conference,2020,UTEP,0,4,4,0.0
vs. Non-Conference,2020,UTEP,3,1,4,0.75
vs. Ranked (AP),2020,UTEP,0,1,1,0.0
vs. Unranked (AP),2020,UTEP,3,4,7,0.42857142857142855
vs. FBS (I-A),2020,UTEP,1,5,6,0.16666666666666666
vs. FCS (I-AA),2020,UTEP,2,0,2,1.0
vs. FBS Winning,2020,UTEP,0,2,2,0.0
vs. FBS Non-Winning,2020,UTEP,1,3,4,0.25
vs. BCS AQ,2020,UTEP,0,1,1,0.0
vs. BCS non-AQ,2020,UTEP,1,4,5,0.2
vs. FBS Power 5,2020,UTEP,0,1,1,0.0
vs. FBS non-Power 5,2020,UTEP,1,4,5,0.2
in August/September,2020,UTEP,3,1,4,0.75
in October,2020,UTEP,0,2,2,0.0
in November,2020,UTEP,0,1,1,0.0
in December/January,2020,UTEP,0,1,1,0.0
All Games,2021,UTEP,7,6,13,0.5384615384615384
at Home,2021,UTEP,5,1,6,0.8333333333333334
on Road/Neutral Site,2021,UTEP,2,5,7,0.2857142857142857
vs. Conference,2021,UTEP,4,4,8,0.5
vs. Non-Conference,2021,UTEP,3,2,5,0.6
vs. Ranked (AP),2021,UTEP,0,0,0,
vs. Unranked (AP),2021,UTEP,7,6,13,0.5384615384615384
vs. FBS (I-A),2021,UTEP,6,6,12,0.5
vs. FCS (I-AA),2021,UTEP,1,0,1,1.0
vs. FBS Winning,2021,UTEP,0,4,4,0.0
vs. FBS Non-Winning,2021,UTEP,6,2,8,0.75
vs. BCS AQ,2021,UTEP,0,0,0,
vs. BCS non-AQ,2021,UTEP,6,6,12,0.5
vs. FBS Power 5,2021,UTEP,0,0,0,
vs. FBS non-Power 5,2021,UTEP,6,6,12,0.5
in August/September,2021,UTEP,3,1,4,0.75
in October,2021,UTEP,3,1,4,0.75
in November,2021,UTEP,1,3,4,0.25
in December/January,2021,UTEP,0,1,1,0.0
All Games,2022,UTEP,5,7,12,0.4166666666666667
at Home,2022,UTEP,4,2,6,0.6666666666666666
on Road/Neutral Site,2022,UTEP,1,5,6,0.16666666666666666
vs. Conference,2022,UTEP,3,5,8,0.375
vs. Non-Conference,2022,UTEP,2,2,4,0.5
vs. Ranked (AP),2022,UTEP,0,0,0,
vs. Unranked (AP),2022,UTEP,5,7,12,0.4166666666666667
vs. FBS (I-A),2022,UTEP,5,7,12,0.4166666666666667
vs. FCS (I-AA),2022,UTEP,0,0,0,
vs. FBS Winning,2022,UTEP,2,2,4,0.5
vs. FBS Non-Winning,2022,UTEP,3,5,8,0.375
vs. BCS AQ,2022,UTEP,0,1,1,0.0
vs. BCS non-AQ,2022,UTEP,5,6,11,0.45454545454545453
vs. FBS Power 5,2022,UTEP,0,1,1,0.0
vs. FBS non-Power 5,2022,UTEP,5,6,11,0.45454545454545453
in August/September,2022,UTEP,2,3,5,0.4
in October,2022,UTEP,2,2,4,0.5
in November,2022,UTEP,1,2,3,0.3333333333333333
in December/January,2022,UTEP,0,0,0,
All Games,2012,UTSA,6,4,10,0.6
at Home,2012,UTSA,2,2,4,0.5
on Road/Neutral Site,2012,UTSA,4,2,6,0.6666666666666666
vs. Conference,2012,UTSA,3,3,6,0.5
vs. Non-Conference,2012,UTSA,3,1,4,0.75
vs. Ranked (AP),2012,UTSA,0,2,2,0.0
vs. Unranked (AP),2012,UTSA,6,2,8,0.75
vs. FBS (I-A),2012,UTSA,4,4,8,0.5
vs. FCS (I-AA),2012,UTSA,2,0,2,1.0
vs. FBS Winning,2012,UTSA,0,4,4,0.0
vs. FBS Non-Winning,2012,UTSA,4,0,4,1.0
vs. BCS AQ,2012,UTSA,0,0,0,
vs. BCS non-AQ,2012,UTSA,4,4,8,0.5
vs. FBS Power 5,2012,UTSA,0,0,0,
vs. FBS non-Power 5,2012,UTSA,4,4,8,0.5
in August/September,2012,UTSA,3,0,3,1.0
in October,2012,UTSA,0,3,3,0.0
in November,2012,UTSA,3,1,4,0.75
in December/January,2012,UTSA,0,0,0,
All Games,2013,UTSA,7,5,12,0.5833333333333334
at Home,2013,UTSA,3,3,6,0.5
on Road/Neutral Site,2013,UTSA,4,2,6,0.6666666666666666
vs. Conference,2013,UTSA,6,2,8,0.75
vs. Non-Conference,2013,UTSA,1,3,4,0.25
vs. Ranked (AP),2013,UTSA,0,1,1,0.0
vs. Unranked (AP),2013,UTSA,7,4,11,0.6363636363636364
vs. FBS (I-A),2013,UTSA,7,5,12,0.5833333333333334
vs. FCS (I-AA),2013,UTSA,0,0,0,
vs. FBS Winning,2013,UTSA,2,5,7,0.2857142857142857
vs. FBS Non-Winning,2013,UTSA,5,0,5,1.0
vs. BCS AQ,2013,UTSA,0,3,3,0.0
vs. BCS non-AQ,2013,UTSA,7,2,9,0.7777777777777778
vs. FBS Power 5,2013,UTSA,0,2,2,0.0
vs. FBS non-Power 5,2013,UTSA,7,3,10,0.7
in August/September,2013,UTSA,2,3,5,0.4
in October,2013,UTSA,1,2,3,0.3333333333333333
in November,2013,UTSA,4,0,4,1.0
in December/January,2013,UTSA,0,0,0,
All Games,2014,UTSA,4,8,12,0.3333333333333333
at Home,2014,UTSA,3,3,6,0.5
on Road/Neutral Site,2014,UTSA,1,5,6,0.16666666666666666
vs. Conference,2014,UTSA,3,5,8,0.375
vs. Non-Conference,2014,UTSA,1,3,4,0.25
vs. Ranked (AP),2014,UTSA,0,1,1,0.0
vs. Unranked (AP),2014,UTSA,4,7,11,0.36363636363636365
vs. FBS (I-A),2014,UTSA,4,8,12,0.3333333333333333
vs. FCS (I-AA),2014,UTSA,0,0,0,
vs. FBS Winning,2014,UTSA,1,6,7,0.14285714285714285
vs. FBS Non-Winning,2014,UTSA,3,2,5,0.6
vs. BCS AQ,2014,UTSA,1,2,3,0.3333333333333333
vs. BCS non-AQ,2014,UTSA,3,6,9,0.3333333333333333
vs. FBS Power 5,2014,UTSA,0,2,2,0.0
vs. FBS non-Power 5,2014,UTSA,4,6,10,0.4
in August/September,2014,UTSA,1,3,4,0.25
in October,2014,UTSA,1,3,4,0.25
in November,2014,UTSA,2,2,4,0.5
in December/January,2014,UTSA,0,0,0,
All Games,2015,UTSA,3,9,12,0.25
at Home,2015,UTSA,1,5,6,0.16666666666666666
on Road/Neutral Site,2015,UTSA,2,4,6,0.3333333333333333
vs. Conference,2015,UTSA,3,5,8,0.375
vs. Non-Conference,2015,UTSA,0,4,4,0.0
vs. Ranked (AP),2015,UTSA,0,1,1,0.0
vs. Unranked (AP),2015,UTSA,3,8,11,0.2727272727272727
vs. FBS (I-A),2015,UTSA,3,9,12,0.25
vs. FCS (I-AA),2015,UTSA,0,0,0,
vs. FBS Winning,2015,UTSA,0,6,6,0.0
vs. FBS Non-Winning,2015,UTSA,3,3,6,0.5
vs. BCS AQ,2015,UTSA,0,3,3,0.0
vs. BCS non-AQ,2015,UTSA,3,6,9,0.3333333333333333
vs. FBS Power 5,2015,UTSA,0,3,3,0.0
vs. FBS non-Power 5,2015,UTSA,3,6,9,0.3333333333333333
in August/September,2015,UTSA,0,4,4,0.0
in October,2015,UTSA,1,3,4,0.25
in November,2015,UTSA,2,2,4,0.5
in December/January,2015,UTSA,0,0,0,
All Games,2016,UTSA,6,7,13,0.46153846153846156
at Home,2016,UTSA,4,2,6,0.6666666666666666
on Road/Neutral Site,2016,UTSA,2,5,7,0.2857142857142857
vs. Conference,2016,UTSA,5,3,8,0.625
vs. Non-Conference,2016,UTSA,1,4,5,0.2
vs. Ranked (AP),2016,UTSA,0,0,0,
vs. Unranked (AP),2016,UTSA,6,7,13,0.46153846153846156
vs. FBS (I-A),2016,UTSA,5,7,12,0.4166666666666667
vs. FCS (I-AA),2016,UTSA,1,0,1,1.0
vs. FBS Winning,2016,UTSA,2,5,7,0.2857142857142857
vs. FBS Non-Winning,2016,UTSA,3,2,5,0.6
vs. BCS AQ,2016,UTSA,0,2,2,0.0
vs. BCS non-AQ,2016,UTSA,5,5,10,0.5
vs. FBS Power 5,2016,UTSA,0,2,2,0.0
vs. FBS non-Power 5,2016,UTSA,5,5,10,0.5
in August/September,2016,UTSA,1,3,4,0.25
in October,2016,UTSA,3,1,4,0.75
in November,2016,UTSA,2,2,4,0.5
in December/January,2016,UTSA,0,1,1,0.0
All Games,2017,UTSA,6,5,11,0.5454545454545454
at Home,2017,UTSA,3,2,5,0.6
on Road/Neutral Site,2017,UTSA,3,3,6,0.5
vs. Conference,2017,UTSA,3,5,8,0.375
vs. Non-Conference,2017,UTSA,3,0,3,1.0
vs. Ranked (AP),2017,UTSA,0,0,0,
vs. Unranked (AP),2017,UTSA,6,5,11,0.5454545454545454
vs. FBS (I-A),2017,UTSA,5,5,10,0.5
vs. FCS (I-AA),2017,UTSA,1,0,1,1.0
vs. FBS Winning,2017,UTSA,1,5,6,0.16666666666666666
vs. FBS Non-Winning,2017,UTSA,4,0,4,1.0
vs. BCS AQ,2017,UTSA,1,0,1,1.0
vs. BCS non-AQ,2017,UTSA,4,5,9,0.4444444444444444
vs. FBS Power 5,2017,UTSA,1,0,1,1.0
vs. FBS non-Power 5,2017,UTSA,4,5,9,0.4444444444444444
in August/September,2017,UTSA,3,0,3,1.0
in October,2017,UTSA,2,2,4,0.5
in November,2017,UTSA,1,3,4,0.25
in December/January,2017,UTSA,0,0,0,
All Games,2018,UTSA,3,9,12,0.25
at Home,2018,UTSA,2,4,6,0.3333333333333333
on Road/Neutral Site,2018,UTSA,1,5,6,0.16666666666666666
vs. Conference,2018,UTSA,2,6,8,0.25
vs. Non-Conference,2018,UTSA,1,3,4,0.25
vs. Ranked (AP),2018,UTSA,0,0,0,
vs. Unranked (AP),2018,UTSA,3,9,12,0.25
vs. FBS (I-A),2018,UTSA,3,9,12,0.25
vs. FCS (I-AA),2018,UTSA,0,0,0,
vs. FBS Winning,2018,UTSA,0,8,8,0.0
vs. FBS Non-Winning,2018,UTSA,3,1,4,0.75
vs. BCS AQ,2018,UTSA,0,3,3,0.0
vs. BCS non-AQ,2018,UTSA,3,6,9,0.3333333333333333
vs. FBS Power 5,2018,UTSA,0,3,3,0.0
vs. FBS non-Power 5,2018,UTSA,3,6,9,0.3333333333333333
in August/September,2018,UTSA,2,3,5,0.4
in October,2018,UTSA,1,2,3,0.3333333333333333
in November,2018,UTSA,0,4,4,0.0
in December/January,2018,UTSA,0,0,0,
All Games,2019,UTSA,4,8,12,0.3333333333333333
at Home,2019,UTSA,2,4,6,0.3333333333333333
on Road/Neutral Site,2019,UTSA,2,4,6,0.3333333333333333
vs. Conference,2019,UTSA,3,5,8,0.375
vs. Non-Conference,2019,UTSA,1,3,4,0.25
vs. Ranked (AP),2019,UTSA,0,1,1,0.0
vs. Unranked (AP),2019,UTSA,4,7,11,0.36363636363636365
vs. FBS (I-A),2019,UTSA,3,8,11,0.2727272727272727
vs. FCS (I-AA),2019,UTSA,1,0,1,1.0
vs. FBS Winning,2019,UTSA,0,6,6,0.0
vs. FBS Non-Winning,2019,UTSA,3,2,5,0.6
vs. BCS AQ,2019,UTSA,0,2,2,0.0
vs. BCS non-AQ,2019,UTSA,3,6,9,0.3333333333333333
vs. FBS Power 5,2019,UTSA,0,2,2,0.0
vs. FBS non-Power 5,2019,UTSA,3,6,9,0.3333333333333333
in August/September,2019,UTSA,1,3,4,0.25
in October,2019,UTSA,2,1,3,0.6666666666666666
in November,2019,UTSA,1,4,5,0.2
in December/January,2019,UTSA,0,0,0,
All Games,2020,UTSA,7,5,12,0.5833333333333334
at Home,2020,UTSA,5,1,6,0.8333333333333334
on Road/Neutral Site,2020,UTSA,2,4,6,0.3333333333333333
vs. Conference,2020,UTSA,5,2,7,0.7142857142857143
vs. Non-Conference,2020,UTSA,2,3,5,0.4
vs. Ranked (AP),2020,UTSA,0,2,2,0.0
vs. Unranked (AP),2020,UTSA,7,3,10,0.7
vs. FBS (I-A),2020,UTSA,6,5,11,0.5454545454545454
vs. FCS (I-AA),2020,UTSA,1,0,1,1.0
vs. FBS Winning,2020,UTSA,0,5,5,0.0
vs. FBS Non-Winning,2020,UTSA,6,0,6,1.0
vs. BCS AQ,2020,UTSA,0,0,0,
vs. BCS non-AQ,2020,UTSA,6,5,11,0.5454545454545454
vs. FBS Power 5,2020,UTSA,0,0,0,
vs. FBS non-Power 5,2020,UTSA,6,5,11,0.5454545454545454
in August/September,2020,UTSA,3,0,3,1.0
in October,2020,UTSA,1,4,5,0.2
in November,2020,UTSA,3,0,3,1.0
in December/January,2020,UTSA,0,1,1,0.0
All Games,2021,UTSA,12,2,14,0.8571428571428571
at Home,2021,UTSA,7,0,7,1.0
on Road/Neutral Site,2021,UTSA,5,2,7,0.7142857142857143
vs. Conference,2021,UTSA,8,1,9,0.8888888888888888
vs. Non-Conference,2021,UTSA,4,1,5,0.8
vs. Ranked (AP),2021,UTSA,0,1,1,0.0
vs. Unranked (AP),2021,UTSA,12,1,13,0.9230769230769231
vs. FBS (I-A),2021,UTSA,11,2,13,0.8461538461538461
vs. FCS (I-AA),2021,UTSA,1,0,1,1.0
vs. FBS Winning,2021,UTSA,5,1,6,0.8333333333333334
vs. FBS Non-Winning,2021,UTSA,6,1,7,0.8571428571428571
vs. BCS AQ,2021,UTSA,2,0,2,1.0
vs. BCS non-AQ,2021,UTSA,9,2,11,0.8181818181818182
vs. FBS Power 5,2021,UTSA,1,0,1,1.0
vs. FBS non-Power 5,2021,UTSA,10,2,12,0.8333333333333334
in August/September,2021,UTSA,4,0,4,1.0
in October,2021,UTSA,4,0,4,1.0
in November,2021,UTSA,3,1,4,0.75
in December/January,2021,UTSA,1,1,2,0.5
All Games,2022,UTSA,11,3,14,0.7857142857142857
at Home,2022,UTSA,6,1,7,0.8571428571428571
on Road/Neutral Site,2022,UTSA,5,2,7,0.7142857142857143
vs. Conference,2022,UTSA,9,0,9,1.0
vs. Non-Conference,2022,UTSA,2,3,5,0.4
vs. Ranked (AP),2022,UTSA,0,2,2,0.0
vs. Unranked (AP),2022,UTSA,11,1,12,0.9166666666666666
vs. FBS (I-A),2022,UTSA,10,3,13,0.7692307692307693
vs. FCS (I-AA),2022,UTSA,1,0,1,1.0
vs. FBS Winning,2022,UTSA,3,3,6,0.5
vs. FBS Non-Winning,2022,UTSA,7,0,7,1.0
vs. BCS AQ,2022,UTSA,0,2,2,0.0
vs. BCS non-AQ,2022,UTSA,10,1,11,0.9090909090909091
vs. FBS Power 5,2022,UTSA,0,1,1,0.0
vs. FBS non-Power 5,2022,UTSA,10,2,12,0.8333333333333334
in August/September,2022,UTSA,3,2,5,0.6
in October,2022,UTSA,3,0,3,1.0
in November,2022,UTSA,4,0,4,1.0
in December/January,2022,UTSA,1,1,2,0.5
All Games,2009,Utah,10,3,13,0.7692307692307693
at Home,2009,Utah,6,0,6,1.0
on Road/Neutral Site,2009,Utah,4,3,7,0.5714285714285714
vs. Conference,2009,Utah,6,2,8,0.75
vs. Non-Conference,2009,Utah,4,1,5,0.8
vs. Ranked (AP),2009,Utah,0,3,3,0.0
vs. Unranked (AP),2009,Utah,10,0,10,1.0
vs. FBS (I-A),2009,Utah,10,3,13,0.7692307692307693
vs. FCS (I-AA),2009,Utah,0,0,0,
vs. FBS Winning,2009,Utah,3,3,6,0.5
vs. FBS Non-Winning,2009,Utah,7,0,7,1.0
vs. BCS AQ,2009,Utah,2,1,3,0.6666666666666666
vs. BCS non-AQ,2009,Utah,8,2,10,0.8
vs. FBS Power 5,2009,Utah,1,1,2,0.5
vs. FBS non-Power 5,2009,Utah,9,2,11,0.8181818181818182
in August/September,2009,Utah,3,1,4,0.75
in October,2009,Utah,4,0,4,1.0
in November,2009,Utah,2,2,4,0.5
in December/January,2009,Utah,1,0,1,1.0
All Games,2010,Utah,10,3,13,0.7692307692307693
at Home,2010,Utah,5,1,6,0.8333333333333334
on Road/Neutral Site,2010,Utah,5,2,7,0.7142857142857143
vs. Conference,2010,Utah,7,1,8,0.875
vs. Non-Conference,2010,Utah,3,2,5,0.6
vs. Ranked (AP),2010,Utah,0,2,2,0.0
vs. Unranked (AP),2010,Utah,10,1,11,0.9090909090909091
vs. FBS (I-A),2010,Utah,10,3,13,0.7692307692307693
vs. FCS (I-AA),2010,Utah,0,0,0,
vs. FBS Winning,2010,Utah,4,3,7,0.5714285714285714
vs. FBS Non-Winning,2010,Utah,6,0,6,1.0
vs. BCS AQ,2010,Utah,2,1,3,0.6666666666666666
vs. BCS non-AQ,2010,Utah,8,2,10,0.8
vs. FBS Power 5,2010,Utah,1,0,1,1.0
vs. FBS non-Power 5,2010,Utah,9,3,12,0.75
in August/September,2010,Utah,4,0,4,1.0
in October,2010,Utah,4,0,4,1.0
in November,2010,Utah,2,2,4,0.5
in December/January,2010,Utah,0,1,1,0.0
All Games,2011,Utah,8,5,13,0.6153846153846154
at Home,2011,Utah,3,3,6,0.5
on Road/Neutral Site,2011,Utah,5,2,7,0.7142857142857143
vs. Conference,2011,Utah,4,5,9,0.4444444444444444
vs. Non-Conference,2011,Utah,4,0,4,1.0
vs. Ranked (AP),2011,Utah,0,1,1,0.0
vs. Unranked (AP),2011,Utah,8,4,12,0.6666666666666666
vs. FBS (I-A),2011,Utah,7,5,12,0.5833333333333334
vs. FCS (I-AA),2011,Utah,1,0,1,1.0
vs. FBS Winning,2011,Utah,2,3,5,0.4
vs. FBS Non-Winning,2011,Utah,5,2,7,0.7142857142857143
vs. BCS AQ,2011,Utah,6,5,11,0.5454545454545454
vs. BCS non-AQ,2011,Utah,1,0,1,1.0
vs. FBS Power 5,2011,Utah,5,5,10,0.5
vs. FBS non-Power 5,2011,Utah,2,0,2,1.0
in August/September,2011,Utah,2,1,3,0.6666666666666666
in October,2011,Utah,2,3,5,0.4
in November,2011,Utah,3,1,4,0.75
in December/January,2011,Utah,1,0,1,1.0
All Games,2012,Utah,5,7,12,0.4166666666666667
at Home,2012,Utah,4,2,6,0.6666666666666666
on Road/Neutral Site,2012,Utah,1,5,6,0.16666666666666666
vs. Conference,2012,Utah,3,6,9,0.3333333333333333
vs. Non-Conference,2012,Utah,2,1,3,0.6666666666666666
vs. Ranked (AP),2012,Utah,0,2,2,0.0
vs. Unranked (AP),2012,Utah,5,5,10,0.5
vs. FBS (I-A),2012,Utah,4,7,11,0.36363636363636365
vs. FCS (I-AA),2012,Utah,1,0,1,1.0
vs. FBS Winning,2012,Utah,1,7,8,0.125
vs. FBS Non-Winning,2012,Utah,3,0,3,1.0
vs. BCS AQ,2012,Utah,3,6,9,0.3333333333333333
vs. BCS non-AQ,2012,Utah,1,1,2,0.5
vs. FBS Power 5,2012,Utah,3,6,9,0.3333333333333333
vs. FBS non-Power 5,2012,Utah,1,1,2,0.5
in August/September,2012,Utah,2,2,4,0.5
in October,2012,Utah,1,3,4,0.25
in November,2012,Utah,2,2,4,0.5
in December/January,2012,Utah,0,0,0,
All Games,2013,Utah,5,7,12,0.4166666666666667
at Home,2013,Utah,4,3,7,0.5714285714285714
on Road/Neutral Site,2013,Utah,1,4,5,0.2
vs. Conference,2013,Utah,2,7,9,0.2222222222222222
vs. Non-Conference,2013,Utah,3,0,3,1.0
vs. Ranked (AP),2013,Utah,1,4,5,0.2
vs. Unranked (AP),2013,Utah,4,3,7,0.5714285714285714
vs. FBS (I-A),2013,Utah,4,7,11,0.36363636363636365
vs. FCS (I-AA),2013,Utah,1,0,1,1.0
vs. FBS Winning,2013,Utah,3,6,9,0.3333333333333333
vs. FBS Non-Winning,2013,Utah,1,1,2,0.5
vs. BCS AQ,2013,Utah,2,7,9,0.2222222222222222
vs. BCS non-AQ,2013,Utah,2,0,2,1.0
vs. FBS Power 5,2013,Utah,2,7,9,0.2222222222222222
vs. FBS non-Power 5,2013,Utah,2,0,2,1.0
in August/September,2013,Utah,3,1,4,0.75
in October,2013,Utah,1,3,4,0.25
in November,2013,Utah,1,3,4,0.25
in December/January,2013,Utah,0,0,0,
All Games,2014,Utah,9,4,13,0.6923076923076923
at Home,2014,Utah,3,3,6,0.5
on Road/Neutral Site,2014,Utah,6,1,7,0.8571428571428571
vs. Conference,2014,Utah,5,4,9,0.5555555555555556
vs. Non-Conference,2014,Utah,4,0,4,1.0
vs. Ranked (AP),2014,Utah,2,3,5,0.4
vs. Unranked (AP),2014,Utah,7,1,8,0.875
vs. FBS (I-A),2014,Utah,8,4,12,0.6666666666666666
vs. FCS (I-AA),2014,Utah,1,0,1,1.0
vs. FBS Winning,2014,Utah,4,3,7,0.5714285714285714
vs. FBS Non-Winning,2014,Utah,4,1,5,0.8
vs. BCS AQ,2014,Utah,6,4,10,0.6
vs. BCS non-AQ,2014,Utah,2,0,2,1.0
vs. FBS Power 5,2014,Utah,6,4,10,0.6
vs. FBS non-Power 5,2014,Utah,2,0,2,1.0
in August/September,2014,Utah,3,1,4,0.75
in October,2014,Utah,3,0,3,1.0
in November,2014,Utah,2,3,5,0.4
in December/January,2014,Utah,1,0,1,1.0
All Games,2015,Utah,10,3,13,0.7692307692307693
at Home,2015,Utah,6,1,7,0.8571428571428571
on Road/Neutral Site,2015,Utah,4,2,6,0.6666666666666666
vs. Conference,2015,Utah,6,3,9,0.6666666666666666
vs. Non-Conference,2015,Utah,4,0,4,1.0
vs. Ranked (AP),2015,Utah,2,0,2,1.0
vs. Unranked (AP),2015,Utah,8,3,11,0.7272727272727273
vs. FBS (I-A),2015,Utah,10,3,13,0.7692307692307693
vs. FCS (I-AA),2015,Utah,0,0,0,
vs. FBS Winning,2015,Utah,5,3,8,0.625
vs. FBS Non-Winning,2015,Utah,5,0,5,1.0
vs. BCS AQ,2015,Utah,7,3,10,0.7
vs. BCS non-AQ,2015,Utah,3,0,3,1.0
vs. FBS Power 5,2015,Utah,7,3,10,0.7
vs. FBS non-Power 5,2015,Utah,3,0,3,1.0
in August/September,2015,Utah,4,0,4,1.0
in October,2015,Utah,3,1,4,0.75
in November,2015,Utah,2,2,4,0.5
in December/January,2015,Utah,1,0,1,1.0
All Games,2016,Utah,9,4,13,0.6923076923076923
at Home,2016,Utah,4,2,6,0.6666666666666666
on Road/Neutral Site,2016,Utah,5,2,7,0.7142857142857143
vs. Conference,2016,Utah,5,4,9,0.5555555555555556
vs. Non-Conference,2016,Utah,4,0,4,1.0
vs. Ranked (AP),2016,Utah,1,2,3,0.3333333333333333
vs. Unranked (AP),2016,Utah,8,2,10,0.8
vs. FBS (I-A),2016,Utah,8,4,12,0.6666666666666666
vs. FCS (I-AA),2016,Utah,1,0,1,1.0
vs. FBS Winning,2016,Utah,2,2,4,0.5
vs. FBS Non-Winning,2016,Utah,6,2,8,0.75
vs. BCS AQ,2016,Utah,6,4,10,0.6
vs. BCS non-AQ,2016,Utah,2,0,2,1.0
vs. FBS Power 5,2016,Utah,6,4,10,0.6
vs. FBS non-Power 5,2016,Utah,2,0,2,1.0
in August/September,2016,Utah,4,0,4,1.0
in October,2016,Utah,3,2,5,0.6
in November,2016,Utah,1,2,3,0.3333333333333333
in December/January,2016,Utah,1,0,1,1.0
All Games,2017,Utah,7,6,13,0.5384615384615384
at Home,2017,Utah,4,3,7,0.5714285714285714
on Road/Neutral Site,2017,Utah,3,3,6,0.5
vs. Conference,2017,Utah,3,6,9,0.3333333333333333
vs. Non-Conference,2017,Utah,4,0,4,1.0
vs. Ranked (AP),2017,Utah,0,3,3,0.0
vs. Unranked (AP),2017,Utah,7,3,10,0.7
vs. FBS (I-A),2017,Utah,6,6,12,0.5
vs. FCS (I-AA),2017,Utah,1,0,1,1.0
vs. FBS Winning,2017,Utah,2,6,8,0.25
vs. FBS Non-Winning,2017,Utah,4,0,4,1.0
vs. BCS AQ,2017,Utah,4,6,10,0.4
vs. BCS non-AQ,2017,Utah,2,0,2,1.0
vs. FBS Power 5,2017,Utah,4,6,10,0.4
vs. FBS non-Power 5,2017,Utah,2,0,2,1.0
in August/September,2017,Utah,4,0,4,1.0
in October,2017,Utah,0,4,4,0.0
in November,2017,Utah,2,2,4,0.5
in December/January,2017,Utah,1,0,1,1.0
All Games,2018,Utah,9,5,14,0.6428571428571429
at Home,2018,Utah,5,1,6,0.8333333333333334
on Road/Neutral Site,2018,Utah,4,4,8,0.5
vs. Conference,2018,Utah,6,4,10,0.6
vs. Non-Conference,2018,Utah,3,1,4,0.75
vs. Ranked (AP),2018,Utah,0,4,4,0.0
vs. Unranked (AP),2018,Utah,9,1,10,0.9
vs. FBS (I-A),2018,Utah,8,5,13,0.6153846153846154
vs. FCS (I-AA),2018,Utah,1,0,1,1.0
vs. FBS Winning,2018,Utah,4,5,9,0.4444444444444444
vs. FBS Non-Winning,2018,Utah,4,0,4,1.0
vs. BCS AQ,2018,Utah,6,5,11,0.5454545454545454
vs. BCS non-AQ,2018,Utah,2,0,2,1.0
vs. FBS Power 5,2018,Utah,6,5,11,0.5454545454545454
vs. FBS non-Power 5,2018,Utah,2,0,2,1.0
in August/September,2018,Utah,2,2,4,0.5
in October,2018,Utah,4,0,4,1.0
in November,2018,Utah,3,2,5,0.6
in December/January,2018,Utah,0,1,1,0.0
All Games,2019,Utah,11,3,14,0.7857142857142857
at Home,2019,Utah,7,0,7,1.0
on Road/Neutral Site,2019,Utah,4,3,7,0.5714285714285714
vs. Conference,2019,Utah,8,2,10,0.8
vs. Non-Conference,2019,Utah,3,1,4,0.75
vs. Ranked (AP),2019,Utah,0,2,2,0.0
vs. Unranked (AP),2019,Utah,11,1,12,0.9166666666666666
vs. FBS (I-A),2019,Utah,10,3,13,0.7692307692307693
vs. FCS (I-AA),2019,Utah,1,0,1,1.0
vs. FBS Winning,2019,Utah,4,3,7,0.5714285714285714
vs. FBS Non-Winning,2019,Utah,6,0,6,1.0
vs. BCS AQ,2019,Utah,8,3,11,0.7272727272727273
vs. BCS non-AQ,2019,Utah,2,0,2,1.0
vs. FBS Power 5,2019,Utah,8,3,11,0.7272727272727273
vs. FBS non-Power 5,2019,Utah,2,0,2,1.0
in August/September,2019,Utah,4,1,5,0.8
in October,2019,Utah,3,0,3,1.0
in November,2019,Utah,4,0,4,1.0
in December/January,2019,Utah,0,2,2,0.0
All Games,2020,Utah,3,2,5,0.6
at Home,2020,Utah,2,1,3,0.6666666666666666
on Road/Neutral Site,2020,Utah,1,1,2,0.5
vs. Conference,2020,Utah,3,2,5,0.6
vs. Non-Conference,2020,Utah,0,0,0,
vs. Ranked (AP),2020,Utah,0,1,1,0.0
vs. Unranked (AP),2020,Utah,3,1,4,0.75
vs. FBS (I-A),2020,Utah,3,2,5,0.6
vs. FCS (I-AA),2020,Utah,0,0,0,
vs. FBS Winning,2020,Utah,1,2,3,0.3333333333333333
vs. FBS Non-Winning,2020,Utah,2,0,2,1.0
vs. BCS AQ,2020,Utah,3,2,5,0.6
vs. BCS non-AQ,2020,Utah,0,0,0,
vs. FBS Power 5,2020,Utah,3,2,5,0.6
vs. FBS non-Power 5,2020,Utah,0,0,0,
in August/September,2020,Utah,0,0,0,
in October,2020,Utah,0,0,0,
in November,2020,Utah,0,2,2,0.0
in December/January,2020,Utah,3,0,3,1.0
All Games,2021,Utah,10,4,14,0.7142857142857143
at Home,2021,Utah,6,0,6,1.0
on Road/Neutral Site,2021,Utah,4,4,8,0.5
vs. Conference,2021,Utah,9,1,10,0.9
vs. Non-Conference,2021,Utah,1,3,4,0.25
vs. Ranked (AP),2021,Utah,2,3,5,0.4
vs. Unranked (AP),2021,Utah,8,1,9,0.8888888888888888
vs. FBS (I-A),2021,Utah,9,4,13,0.6923076923076923
vs. FCS (I-AA),2021,Utah,1,0,1,1.0
vs. FBS Winning,2021,Utah,5,4,9,0.5555555555555556
vs. FBS Non-Winning,2021,Utah,4,0,4,1.0
vs. BCS AQ,2021,Utah,9,2,11,0.8181818181818182
vs. BCS non-AQ,2021,Utah,0,2,2,0.0
vs. FBS Power 5,2021,Utah,9,2,11,0.8181818181818182
vs. FBS non-Power 5,2021,Utah,0,2,2,0.0
in August/September,2021,Utah,2,2,4,0.5
in October,2021,Utah,3,1,4,0.75
in November,2021,Utah,4,0,4,1.0
in December/January,2021,Utah,1,1,2,0.5
All Games,2022,Utah,10,4,14,0.7142857142857143
at Home,2022,Utah,6,0,6,1.0
on Road/Neutral Site,2022,Utah,4,4,8,0.5
vs. Conference,2022,Utah,8,2,10,0.8
vs. Non-Conference,2022,Utah,2,2,4,0.5
vs. Ranked (AP),2022,Utah,3,3,6,0.5
vs. Unranked (AP),2022,Utah,7,1,8,0.875
vs. FBS (I-A),2022,Utah,9,4,13,0.6923076923076923
vs. FCS (I-AA),2022,Utah,1,0,1,1.0
vs. FBS Winning,2022,Utah,5,3,8,0.625
vs. FBS Non-Winning,2022,Utah,4,1,5,0.8
vs. BCS AQ,2022,Utah,8,4,12,0.6666666666666666
vs. BCS non-AQ,2022,Utah,1,0,1,1.0
vs. FBS Power 5,2022,Utah,8,4,12,0.6666666666666666
vs. FBS non-Power 5,2022,Utah,1,0,1,1.0
in August/September,2022,Utah,3,1,4,0.75
in October,2022,Utah,3,1,4,0.75
in November,2022,Utah,3,1,4,0.75
in December/January,2022,Utah,1,1,2,0.5
All Games,2009,Utah State,4,8,12,0.3333333333333333
at Home,2009,Utah State,3,2,5,0.6
on Road/Neutral Site,2009,Utah State,1,6,7,0.14285714285714285
vs. Conference,2009,Utah State,3,5,8,0.375
vs. Non-Conference,2009,Utah State,1,3,4,0.25
vs. Ranked (AP),2009,Utah State,0,3,3,0.0
vs. Unranked (AP),2009,Utah State,4,5,9,0.4444444444444444
vs. FBS (I-A),2009,Utah State,3,8,11,0.2727272727272727
vs. FCS (I-AA),2009,Utah State,1,0,1,1.0
vs. FBS Winning,2009,Utah State,1,5,6,0.16666666666666666
vs. FBS Non-Winning,2009,Utah State,2,3,5,0.4
vs. BCS AQ,2009,Utah State,0,1,1,0.0
vs. BCS non-AQ,2009,Utah State,3,7,10,0.3
vs. FBS Power 5,2009,Utah State,0,1,1,0.0
vs. FBS non-Power 5,2009,Utah State,3,7,10,0.3
in August/September,2009,Utah State,1,2,3,0.3333333333333333
in October,2009,Utah State,1,4,5,0.2
in November,2009,Utah State,2,2,4,0.5
in December/January,2009,Utah State,0,0,0,
All Games,2010,Utah State,4,8,12,0.3333333333333333
at Home,2010,Utah State,3,3,6,0.5
on Road/Neutral Site,2010,Utah State,1,5,6,0.16666666666666666
vs. Conference,2010,Utah State,2,6,8,0.25
vs. Non-Conference,2010,Utah State,2,2,4,0.5
vs. Ranked (AP),2010,Utah State,0,3,3,0.0
vs. Unranked (AP),2010,Utah State,4,5,9,0.4444444444444444
vs. FBS (I-A),2010,Utah State,3,8,11,0.2727272727272727
vs. FCS (I-AA),2010,Utah State,1,0,1,1.0
vs. FBS Winning,2010,Utah State,1,6,7,0.14285714285714285
vs. FBS Non-Winning,2010,Utah State,2,2,4,0.5
vs. BCS AQ,2010,Utah State,0,1,1,0.0
vs. BCS non-AQ,2010,Utah State,3,7,10,0.3
vs. FBS Power 5,2010,Utah State,0,1,1,0.0
vs. FBS non-Power 5,2010,Utah State,3,7,10,0.3
in August/September,2010,Utah State,1,3,4,0.25
in October,2010,Utah State,1,3,4,0.25
in November,2010,Utah State,2,1,3,0.6666666666666666
in December/January,2010,Utah State,0,1,1,0.0
All Games,2011,Utah State,7,6,13,0.5384615384615384
at Home,2011,Utah State,4,2,6,0.6666666666666666
on Road/Neutral Site,2011,Utah State,3,4,7,0.42857142857142855
vs. Conference,2011,Utah State,5,2,7,0.7142857142857143
vs. Non-Conference,2011,Utah State,2,4,6,0.3333333333333333
vs. Ranked (AP),2011,Utah State,0,0,0,
vs. Unranked (AP),2011,Utah State,7,6,13,0.5384615384615384
vs. FBS (I-A),2011,Utah State,6,6,12,0.5
vs. FCS (I-AA),2011,Utah State,1,0,1,1.0
vs. FBS Winning,2011,Utah State,2,4,6,0.3333333333333333
vs. FBS Non-Winning,2011,Utah State,4,2,6,0.6666666666666666
vs. BCS AQ,2011,Utah State,0,1,1,0.0
vs. BCS non-AQ,2011,Utah State,6,5,11,0.5454545454545454
vs. FBS Power 5,2011,Utah State,0,1,1,0.0
vs. FBS non-Power 5,2011,Utah State,6,5,11,0.5454545454545454
in August/September,2011,Utah State,1,3,4,0.25
in October,2011,Utah State,1,2,3,0.3333333333333333
in November,2011,Utah State,4,0,4,1.0
in December/January,2011,Utah State,1,1,2,0.5
All Games,2012,Utah State,11,2,13,0.8461538461538461
at Home,2012,Utah State,6,0,6,1.0
on Road/Neutral Site,2012,Utah State,5,2,7,0.7142857142857143
vs. Conference,2012,Utah State,6,0,6,1.0
vs. Non-Conference,2012,Utah State,5,2,7,0.7142857142857143
vs. Ranked (AP),2012,Utah State,1,0,1,1.0
vs. Unranked (AP),2012,Utah State,10,2,12,0.8333333333333334
vs. FBS (I-A),2012,Utah State,10,2,12,0.8333333333333334
vs. FCS (I-AA),2012,Utah State,1,0,1,1.0
vs. FBS Winning,2012,Utah State,4,2,6,0.6666666666666666
vs. FBS Non-Winning,2012,Utah State,6,0,6,1.0
vs. BCS AQ,2012,Utah State,1,1,2,0.5
vs. BCS non-AQ,2012,Utah State,9,1,10,0.9
vs. FBS Power 5,2012,Utah State,1,1,2,0.5
vs. FBS non-Power 5,2012,Utah State,9,1,10,0.9
in August/September,2012,Utah State,4,1,5,0.8
in October,2012,Utah State,3,1,4,0.75
in November,2012,Utah State,3,0,3,1.0
in December/January,2012,Utah State,1,0,1,1.0
All Games,2013,Utah State,9,5,14,0.6428571428571429
at Home,2013,Utah State,4,2,6,0.6666666666666666
on Road/Neutral Site,2013,Utah State,5,3,8,0.625
vs. Conference,2013,Utah State,7,2,9,0.7777777777777778
vs. Non-Conference,2013,Utah State,2,3,5,0.4
vs. Ranked (AP),2013,Utah State,0,1,1,0.0
vs. Unranked (AP),2013,Utah State,9,4,13,0.6923076923076923
vs. FBS (I-A),2013,Utah State,8,5,13,0.6153846153846154
vs. FCS (I-AA),2013,Utah State,1,0,1,1.0
vs. FBS Winning,2013,Utah State,3,4,7,0.42857142857142855
vs. FBS Non-Winning,2013,Utah State,5,1,6,0.8333333333333334
vs. BCS AQ,2013,Utah State,0,2,2,0.0
vs. BCS non-AQ,2013,Utah State,8,3,11,0.7272727272727273
vs. FBS Power 5,2013,Utah State,0,2,2,0.0
vs. FBS non-Power 5,2013,Utah State,8,3,11,0.7272727272727273
in August/September,2013,Utah State,3,2,5,0.6
in October,2013,Utah State,1,2,3,0.3333333333333333
in November,2013,Utah State,4,0,4,1.0
in December/January,2013,Utah State,1,1,2,0.5
All Games,2014,Utah State,10,4,14,0.7142857142857143
at Home,2014,Utah State,6,0,6,1.0
on Road/Neutral Site,2014,Utah State,4,4,8,0.5
vs. Conference,2014,Utah State,6,2,8,0.75
vs. Non-Conference,2014,Utah State,4,2,6,0.6666666666666666
vs. Ranked (AP),2014,Utah State,0,1,1,0.0
vs. Unranked (AP),2014,Utah State,10,3,13,0.7692307692307693
vs. FBS (I-A),2014,Utah State,9,4,13,0.6923076923076923
vs. FCS (I-AA),2014,Utah State,1,0,1,1.0
vs. FBS Winning,2014,Utah State,3,4,7,0.42857142857142855
vs. FBS Non-Winning,2014,Utah State,6,0,6,1.0
vs. BCS AQ,2014,Utah State,1,1,2,0.5
vs. BCS non-AQ,2014,Utah State,8,3,11,0.7272727272727273
vs. FBS Power 5,2014,Utah State,1,1,2,0.5
vs. FBS non-Power 5,2014,Utah State,8,3,11,0.7272727272727273
in August/September,2014,Utah State,2,2,4,0.5
in October,2014,Utah State,3,1,4,0.75
in November,2014,Utah State,4,1,5,0.8
in December/January,2014,Utah State,1,0,1,1.0
All Games,2015,Utah State,6,7,13,0.46153846153846156
at Home,2015,Utah State,5,1,6,0.8333333333333334
on Road/Neutral Site,2015,Utah State,1,6,7,0.14285714285714285
vs. Conference,2015,Utah State,5,3,8,0.625
vs. Non-Conference,2015,Utah State,1,4,5,0.2
vs. Ranked (AP),2015,Utah State,0,1,1,0.0
vs. Unranked (AP),2015,Utah State,6,6,12,0.5
vs. FBS (I-A),2015,Utah State,5,7,12,0.4166666666666667
vs. FCS (I-AA),2015,Utah State,1,0,1,1.0
vs. FBS Winning,2015,Utah State,3,7,10,0.3
vs. FBS Non-Winning,2015,Utah State,2,0,2,1.0
vs. BCS AQ,2015,Utah State,0,2,2,0.0
vs. BCS non-AQ,2015,Utah State,5,5,10,0.5
vs. FBS Power 5,2015,Utah State,0,2,2,0.0
vs. FBS non-Power 5,2015,Utah State,5,5,10,0.5
in August/September,2015,Utah State,1,2,3,0.3333333333333333
in October,2015,Utah State,4,1,5,0.8
in November,2015,Utah State,1,3,4,0.25
in December/January,2015,Utah State,0,1,1,0.0
All Games,2016,Utah State,3,9,12,0.25
at Home,2016,Utah State,3,3,6,0.5
on Road/Neutral Site,2016,Utah State,0,6,6,0.0
vs. Conference,2016,Utah State,1,7,8,0.125
vs. Non-Conference,2016,Utah State,2,2,4,0.5
vs. Ranked (AP),2016,Utah State,0,1,1,0.0
vs. Unranked (AP),2016,Utah State,3,8,11,0.2727272727272727
vs. FBS (I-A),2016,Utah State,2,9,11,0.18181818181818182
vs. FCS (I-AA),2016,Utah State,1,0,1,1.0
vs. FBS Winning,2016,Utah State,1,8,9,0.1111111111111111
vs. FBS Non-Winning,2016,Utah State,1,1,2,0.5
vs. BCS AQ,2016,Utah State,0,1,1,0.0
vs. BCS non-AQ,2016,Utah State,2,8,10,0.2
vs. FBS Power 5,2016,Utah State,0,1,1,0.0
vs. FBS non-Power 5,2016,Utah State,2,8,10,0.2
in August/September,2016,Utah State,2,2,4,0.5
in October,2016,Utah State,1,3,4,0.25
in November,2016,Utah State,0,4,4,0.0
in December/January,2016,Utah State,0,0,0,
All Games,2017,Utah State,6,7,13,0.46153846153846156
at Home,2017,Utah State,3,3,6,0.5
on Road/Neutral Site,2017,Utah State,3,4,7,0.42857142857142855
vs. Conference,2017,Utah State,4,4,8,0.5
vs. Non-Conference,2017,Utah State,2,3,5,0.4
vs. Ranked (AP),2017,Utah State,0,2,2,0.0
vs. Unranked (AP),2017,Utah State,6,5,11,0.5454545454545454
vs. FBS (I-A),2017,Utah State,5,7,12,0.4166666666666667
vs. FCS (I-AA),2017,Utah State,1,0,1,1.0
vs. FBS Winning,2017,Utah State,0,6,6,0.0
vs. FBS Non-Winning,2017,Utah State,5,1,6,0.8333333333333334
vs. BCS AQ,2017,Utah State,0,2,2,0.0
vs. BCS non-AQ,2017,Utah State,5,5,10,0.5
vs. FBS Power 5,2017,Utah State,0,2,2,0.0
vs. FBS non-Power 5,2017,Utah State,5,5,10,0.5
in August/September,2017,Utah State,3,2,5,0.6
in October,2017,Utah State,1,3,4,0.25
in November,2017,Utah State,2,1,3,0.6666666666666666
in December/January,2017,Utah State,0,1,1,0.0
All Games,2018,Utah State,11,2,13,0.8461538461538461
at Home,2018,Utah State,6,0,6,1.0
on Road/Neutral Site,2018,Utah State,5,2,7,0.7142857142857143
vs. Conference,2018,Utah State,7,1,8,0.875
vs. Non-Conference,2018,Utah State,4,1,5,0.8
vs. Ranked (AP),2018,Utah State,0,1,1,0.0
vs. Unranked (AP),2018,Utah State,11,1,12,0.9166666666666666
vs. FBS (I-A),2018,Utah State,10,2,12,0.8333333333333334
vs. FCS (I-AA),2018,Utah State,1,0,1,1.0
vs. FBS Winning,2018,Utah State,3,2,5,0.6
vs. FBS Non-Winning,2018,Utah State,7,0,7,1.0
vs. BCS AQ,2018,Utah State,0,1,1,0.0
vs. BCS non-AQ,2018,Utah State,10,1,11,0.9090909090909091
vs. FBS Power 5,2018,Utah State,0,1,1,0.0
vs. FBS non-Power 5,2018,Utah State,10,1,11,0.9090909090909091
in August/September,2018,Utah State,3,1,4,0.75
in October,2018,Utah State,4,0,4,1.0
in November,2018,Utah State,3,1,4,0.75
in December/January,2018,Utah State,1,0,1,1.0
All Games,2019,Utah State,7,6,13,0.5384615384615384
at Home,2019,Utah State,4,2,6,0.6666666666666666
on Road/Neutral Site,2019,Utah State,3,4,7,0.42857142857142855
vs. Conference,2019,Utah State,6,2,8,0.75
vs. Non-Conference,2019,Utah State,1,4,5,0.2
vs. Ranked (AP),2019,Utah State,0,3,3,0.0
vs. Unranked (AP),2019,Utah State,7,3,10,0.7
vs. FBS (I-A),2019,Utah State,6,6,12,0.5
vs. FCS (I-AA),2019,Utah State,1,0,1,1.0
vs. FBS Winning,2019,Utah State,3,6,9,0.3333333333333333
vs. FBS Non-Winning,2019,Utah State,3,0,3,1.0
vs. BCS AQ,2019,Utah State,0,2,2,0.0
vs. BCS non-AQ,2019,Utah State,6,4,10,0.6
vs. FBS Power 5,2019,Utah State,0,2,2,0.0
vs. FBS non-Power 5,2019,Utah State,6,4,10,0.6
in August/September,2019,Utah State,3,1,4,0.75
in October,2019,Utah State,1,2,3,0.3333333333333333
in November,2019,Utah State,3,2,5,0.6
in December/January,2019,Utah State,0,1,1,0.0
All Games,2020,Utah State,1,5,6,0.16666666666666666
at Home,2020,Utah State,1,3,4,0.25
on Road/Neutral Site,2020,Utah State,0,2,2,0.0
vs. Conference,2020,Utah State,1,5,6,0.16666666666666666
vs. Non-Conference,2020,Utah State,0,0,0,
vs. Ranked (AP),2020,Utah State,0,0,0,
vs. Unranked (AP),2020,Utah State,1,5,6,0.16666666666666666
vs. FBS (I-A),2020,Utah State,1,5,6,0.16666666666666666
vs. FCS (I-AA),2020,Utah State,0,0,0,
vs. FBS Winning,2020,Utah State,0,2,2,0.0
vs. FBS Non-Winning,2020,Utah State,1,3,4,0.25
vs. BCS AQ,2020,Utah State,0,0,0,
vs. BCS non-AQ,2020,Utah State,1,5,6,0.16666666666666666
vs. FBS Power 5,2020,Utah State,0,0,0,
vs. FBS non-Power 5,2020,Utah State,1,5,6,0.16666666666666666
in August/September,2020,Utah State,0,0,0,
in October,2020,Utah State,0,2,2,0.0
in November,2020,Utah State,1,2,3,0.3333333333333333
in December/January,2020,Utah State,0,1,1,0.0
All Games,2021,Utah State,11,3,14,0.7857142857142857
at Home,2021,Utah State,3,3,6,0.5
on Road/Neutral Site,2021,Utah State,8,0,8,1.0
vs. Conference,2021,Utah State,7,2,9,0.7777777777777778
vs. Non-Conference,2021,Utah State,4,1,5,0.8
vs. Ranked (AP),2021,Utah State,1,1,2,0.5
vs. Unranked (AP),2021,Utah State,10,2,12,0.8333333333333334
vs. FBS (I-A),2021,Utah State,10,3,13,0.7692307692307693
vs. FCS (I-AA),2021,Utah State,1,0,1,1.0
vs. FBS Winning,2021,Utah State,4,3,7,0.5714285714285714
vs. FBS Non-Winning,2021,Utah State,6,0,6,1.0
vs. BCS AQ,2021,Utah State,2,0,2,1.0
vs. BCS non-AQ,2021,Utah State,8,3,11,0.7272727272727273
vs. FBS Power 5,2021,Utah State,2,0,2,1.0
vs. FBS non-Power 5,2021,Utah State,8,3,11,0.7272727272727273
in August/September,2021,Utah State,3,1,4,0.75
in October,2021,Utah State,3,1,4,0.75
in November,2021,Utah State,3,1,4,0.75
in December/January,2021,Utah State,2,0,2,1.0
All Games,2022,Utah State,6,7,13,0.46153846153846156
at Home,2022,Utah State,4,2,6,0.6666666666666666
on Road/Neutral Site,2022,Utah State,2,5,7,0.2857142857142857
vs. Conference,2022,Utah State,5,3,8,0.625
vs. Non-Conference,2022,Utah State,1,4,5,0.2
vs. Ranked (AP),2022,Utah State,0,1,1,0.0
vs. Unranked (AP),2022,Utah State,6,6,12,0.5
vs. FBS (I-A),2022,Utah State,6,6,12,0.5
vs. FCS (I-AA),2022,Utah State,0,1,1,0.0
vs. FBS Winning,2022,Utah State,2,5,7,0.2857142857142857
vs. FBS Non-Winning,2022,Utah State,4,1,5,0.8
vs. BCS AQ,2022,Utah State,0,2,2,0.0
vs. BCS non-AQ,2022,Utah State,6,4,10,0.6
vs. FBS Power 5,2022,Utah State,0,1,1,0.0
vs. FBS non-Power 5,2022,Utah State,6,5,11,0.5454545454545454
in August/September,2022,Utah State,1,4,5,0.2
in October,2022,Utah State,2,1,3,0.6666666666666666
in November,2022,Utah State,3,1,4,0.75
in December/January,2022,Utah State,0,1,1,0.0
All Games,2009,Vanderbilt,2,10,12,0.16666666666666666
at Home,2009,Vanderbilt,1,5,6,0.16666666666666666
on Road/Neutral Site,2009,Vanderbilt,1,5,6,0.16666666666666666
vs. Conference,2009,Vanderbilt,0,8,8,0.0
vs. Non-Conference,2009,Vanderbilt,2,2,4,0.5
vs. Ranked (AP),2009,Vanderbilt,0,4,4,0.0
vs. Unranked (AP),2009,Vanderbilt,2,6,8,0.25
vs. FBS (I-A),2009,Vanderbilt,1,10,11,0.09090909090909091
vs. FCS (I-AA),2009,Vanderbilt,1,0,1,1.0
vs. FBS Winning,2009,Vanderbilt,0,8,8,0.0
vs. FBS Non-Winning,2009,Vanderbilt,1,2,3,0.3333333333333333
vs. BCS AQ,2009,Vanderbilt,0,9,9,0.0
vs. BCS non-AQ,2009,Vanderbilt,1,1,2,0.5
vs. FBS Power 5,2009,Vanderbilt,0,9,9,0.0
vs. FBS non-Power 5,2009,Vanderbilt,1,1,2,0.5
in August/September,2009,Vanderbilt,2,2,4,0.5
in October,2009,Vanderbilt,0,5,5,0.0
in November,2009,Vanderbilt,0,3,3,0.0
in December/January,2009,Vanderbilt,0,0,0,
All Games,2010,Vanderbilt,2,10,12,0.16666666666666666
at Home,2010,Vanderbilt,1,6,7,0.14285714285714285
on Road/Neutral Site,2010,Vanderbilt,1,4,5,0.2
vs. Conference,2010,Vanderbilt,1,7,8,0.125
vs. Non-Conference,2010,Vanderbilt,1,3,4,0.25
vs. Ranked (AP),2010,Vanderbilt,0,3,3,0.0
vs. Unranked (AP),2010,Vanderbilt,2,7,9,0.2222222222222222
vs. FBS (I-A),2010,Vanderbilt,2,10,12,0.16666666666666666
vs. FCS (I-AA),2010,Vanderbilt,0,0,0,
vs. FBS Winning,2010,Vanderbilt,0,6,6,0.0
vs. FBS Non-Winning,2010,Vanderbilt,2,4,6,0.3333333333333333
vs. BCS AQ,2010,Vanderbilt,1,10,11,0.09090909090909091
vs. BCS non-AQ,2010,Vanderbilt,1,0,1,1.0
vs. FBS Power 5,2010,Vanderbilt,1,9,10,0.1
vs. FBS non-Power 5,2010,Vanderbilt,1,1,2,0.5
in August/September,2010,Vanderbilt,1,2,3,0.3333333333333333
in October,2010,Vanderbilt,1,4,5,0.2
in November,2010,Vanderbilt,0,4,4,0.0
in December/January,2010,Vanderbilt,0,0,0,
All Games,2011,Vanderbilt,6,7,13,0.46153846153846156
at Home,2011,Vanderbilt,5,2,7,0.7142857142857143
on Road/Neutral Site,2011,Vanderbilt,1,5,6,0.16666666666666666
vs. Conference,2011,Vanderbilt,2,6,8,0.25
vs. Non-Conference,2011,Vanderbilt,4,1,5,0.8
vs. Ranked (AP),2011,Vanderbilt,0,5,5,0.0
vs. Unranked (AP),2011,Vanderbilt,6,2,8,0.75
vs. FBS (I-A),2011,Vanderbilt,5,7,12,0.4166666666666667
vs. FCS (I-AA),2011,Vanderbilt,1,0,1,1.0
vs. FBS Winning,2011,Vanderbilt,0,6,6,0.0
vs. FBS Non-Winning,2011,Vanderbilt,5,1,6,0.8333333333333334
vs. BCS AQ,2011,Vanderbilt,4,7,11,0.36363636363636365
vs. BCS non-AQ,2011,Vanderbilt,1,0,1,1.0
vs. FBS Power 5,2011,Vanderbilt,3,6,9,0.3333333333333333
vs. FBS non-Power 5,2011,Vanderbilt,2,1,3,0.6666666666666666
in August/September,2011,Vanderbilt,3,1,4,0.75
in October,2011,Vanderbilt,1,3,4,0.25
in November,2011,Vanderbilt,2,2,4,0.5
in December/January,2011,Vanderbilt,0,1,1,0.0
All Games,2012,Vanderbilt,9,4,13,0.6923076923076923
at Home,2012,Vanderbilt,4,2,6,0.6666666666666666
on Road/Neutral Site,2012,Vanderbilt,5,2,7,0.7142857142857143
vs. Conference,2012,Vanderbilt,5,3,8,0.625
vs. Non-Conference,2012,Vanderbilt,4,1,5,0.8
vs. Ranked (AP),2012,Vanderbilt,0,4,4,0.0
vs. Unranked (AP),2012,Vanderbilt,9,0,9,1.0
vs. FBS (I-A),2012,Vanderbilt,8,4,12,0.6666666666666666
vs. FCS (I-AA),2012,Vanderbilt,1,0,1,1.0
vs. FBS Winning,2012,Vanderbilt,2,4,6,0.3333333333333333
vs. FBS Non-Winning,2012,Vanderbilt,6,0,6,1.0
vs. BCS AQ,2012,Vanderbilt,7,4,11,0.6363636363636364
vs. BCS non-AQ,2012,Vanderbilt,1,0,1,1.0
vs. FBS Power 5,2012,Vanderbilt,7,4,11,0.6363636363636364
vs. FBS non-Power 5,2012,Vanderbilt,1,0,1,1.0
in August/September,2012,Vanderbilt,1,3,4,0.25
in October,2012,Vanderbilt,3,1,4,0.75
in November,2012,Vanderbilt,4,0,4,1.0
in December/January,2012,Vanderbilt,1,0,1,1.0
All Games,2013,Vanderbilt,9,4,13,0.6923076923076923
at Home,2013,Vanderbilt,5,2,7,0.7142857142857143
on Road/Neutral Site,2013,Vanderbilt,4,2,6,0.6666666666666666
vs. Conference,2013,Vanderbilt,4,4,8,0.5
vs. Non-Conference,2013,Vanderbilt,5,0,5,1.0
vs. Ranked (AP),2013,Vanderbilt,0,3,3,0.0
vs. Unranked (AP),2013,Vanderbilt,9,1,10,0.9
vs. FBS (I-A),2013,Vanderbilt,8,4,12,0.6666666666666666
vs. FCS (I-AA),2013,Vanderbilt,1,0,1,1.0
vs. FBS Winning,2013,Vanderbilt,2,4,6,0.3333333333333333
vs. FBS Non-Winning,2013,Vanderbilt,6,0,6,1.0
vs. BCS AQ,2013,Vanderbilt,6,4,10,0.6
vs. BCS non-AQ,2013,Vanderbilt,2,0,2,1.0
vs. FBS Power 5,2013,Vanderbilt,5,4,9,0.5555555555555556
vs. FBS non-Power 5,2013,Vanderbilt,3,0,3,1.0
in August/September,2013,Vanderbilt,3,2,5,0.6
in October,2013,Vanderbilt,1,2,3,0.3333333333333333
in November,2013,Vanderbilt,4,0,4,1.0
in December/January,2013,Vanderbilt,1,0,1,1.0
All Games,2014,Vanderbilt,3,9,12,0.25
at Home,2014,Vanderbilt,3,5,8,0.375
on Road/Neutral Site,2014,Vanderbilt,0,4,4,0.0
vs. Conference,2014,Vanderbilt,0,8,8,0.0
vs. Non-Conference,2014,Vanderbilt,3,1,4,0.75
vs. Ranked (AP),2014,Vanderbilt,0,4,4,0.0
vs. Unranked (AP),2014,Vanderbilt,3,5,8,0.375
vs. FBS (I-A),2014,Vanderbilt,2,9,11,0.18181818181818182
vs. FCS (I-AA),2014,Vanderbilt,1,0,1,1.0
vs. FBS Winning,2014,Vanderbilt,0,7,7,0.0
vs. FBS Non-Winning,2014,Vanderbilt,2,2,4,0.5
vs. BCS AQ,2014,Vanderbilt,0,9,9,0.0
vs. BCS non-AQ,2014,Vanderbilt,2,0,2,1.0
vs. FBS Power 5,2014,Vanderbilt,0,8,8,0.0
vs. FBS non-Power 5,2014,Vanderbilt,2,1,3,0.6666666666666666
in August/September,2014,Vanderbilt,1,4,5,0.2
in October,2014,Vanderbilt,1,2,3,0.3333333333333333
in November,2014,Vanderbilt,1,3,4,0.25
in December/January,2014,Vanderbilt,0,0,0,
All Games,2015,Vanderbilt,4,8,12,0.3333333333333333
at Home,2015,Vanderbilt,3,3,6,0.5
on Road/Neutral Site,2015,Vanderbilt,1,5,6,0.16666666666666666
vs. Conference,2015,Vanderbilt,2,6,8,0.25
vs. Non-Conference,2015,Vanderbilt,2,2,4,0.5
vs. Ranked (AP),2015,Vanderbilt,0,5,5,0.0
vs. Unranked (AP),2015,Vanderbilt,4,3,7,0.5714285714285714
vs. FBS (I-A),2015,Vanderbilt,3,8,11,0.2727272727272727
vs. FCS (I-AA),2015,Vanderbilt,1,0,1,1.0
vs. FBS Winning,2015,Vanderbilt,1,7,8,0.125
vs. FBS Non-Winning,2015,Vanderbilt,2,1,3,0.6666666666666666
vs. BCS AQ,2015,Vanderbilt,2,7,9,0.2222222222222222
vs. BCS non-AQ,2015,Vanderbilt,1,1,2,0.5
vs. FBS Power 5,2015,Vanderbilt,2,6,8,0.25
vs. FBS non-Power 5,2015,Vanderbilt,1,2,3,0.3333333333333333
in August/September,2015,Vanderbilt,1,3,4,0.25
in October,2015,Vanderbilt,2,2,4,0.5
in November,2015,Vanderbilt,1,3,4,0.25
in December/January,2015,Vanderbilt,0,0,0,
All Games,2016,Vanderbilt,6,7,13,0.46153846153846156
at Home,2016,Vanderbilt,4,2,6,0.6666666666666666
on Road/Neutral Site,2016,Vanderbilt,2,5,7,0.2857142857142857
vs. Conference,2016,Vanderbilt,3,5,8,0.375
vs. Non-Conference,2016,Vanderbilt,3,2,5,0.6
vs. Ranked (AP),2016,Vanderbilt,0,2,2,0.0
vs. Unranked (AP),2016,Vanderbilt,6,5,11,0.5454545454545454
vs. FBS (I-A),2016,Vanderbilt,5,7,12,0.4166666666666667
vs. FCS (I-AA),2016,Vanderbilt,1,0,1,1.0
vs. FBS Winning,2016,Vanderbilt,4,5,9,0.4444444444444444
vs. FBS Non-Winning,2016,Vanderbilt,1,2,3,0.3333333333333333
vs. BCS AQ,2016,Vanderbilt,3,7,10,0.3
vs. BCS non-AQ,2016,Vanderbilt,2,0,2,1.0
vs. FBS Power 5,2016,Vanderbilt,3,7,10,0.3
vs. FBS non-Power 5,2016,Vanderbilt,2,0,2,1.0
in August/September,2016,Vanderbilt,2,2,4,0.5
in October,2016,Vanderbilt,2,2,4,0.5
in November,2016,Vanderbilt,2,2,4,0.5
in December/January,2016,Vanderbilt,0,1,1,0.0
All Games,2017,Vanderbilt,5,7,12,0.4166666666666667
at Home,2017,Vanderbilt,3,4,7,0.42857142857142855
on Road/Neutral Site,2017,Vanderbilt,2,3,5,0.4
vs. Conference,2017,Vanderbilt,1,7,8,0.125
vs. Non-Conference,2017,Vanderbilt,4,0,4,1.0
vs. Ranked (AP),2017,Vanderbilt,0,2,2,0.0
vs. Unranked (AP),2017,Vanderbilt,5,5,10,0.5
vs. FBS (I-A),2017,Vanderbilt,4,7,11,0.36363636363636365
vs. FCS (I-AA),2017,Vanderbilt,1,0,1,1.0
vs. FBS Winning,2017,Vanderbilt,2,5,7,0.2857142857142857
vs. FBS Non-Winning,2017,Vanderbilt,2,2,4,0.5
vs. BCS AQ,2017,Vanderbilt,2,7,9,0.2222222222222222
vs. BCS non-AQ,2017,Vanderbilt,2,0,2,1.0
vs. FBS Power 5,2017,Vanderbilt,2,7,9,0.2222222222222222
vs. FBS non-Power 5,2017,Vanderbilt,2,0,2,1.0
in August/September,2017,Vanderbilt,3,2,5,0.6
in October,2017,Vanderbilt,0,3,3,0.0
in November,2017,Vanderbilt,2,2,4,0.5
in December/January,2017,Vanderbilt,0,0,0,
All Games,2018,Vanderbilt,6,7,13,0.46153846153846156
at Home,2018,Vanderbilt,5,2,7,0.7142857142857143
on Road/Neutral Site,2018,Vanderbilt,1,5,6,0.16666666666666666
vs. Conference,2018,Vanderbilt,3,5,8,0.375
vs. Non-Conference,2018,Vanderbilt,3,2,5,0.6
vs. Ranked (AP),2018,Vanderbilt,0,4,4,0.0
vs. Unranked (AP),2018,Vanderbilt,6,3,9,0.6666666666666666
vs. FBS (I-A),2018,Vanderbilt,5,7,12,0.4166666666666667
vs. FCS (I-AA),2018,Vanderbilt,1,0,1,1.0
vs. FBS Winning,2018,Vanderbilt,2,7,9,0.2222222222222222
vs. FBS Non-Winning,2018,Vanderbilt,3,0,3,1.0
vs. BCS AQ,2018,Vanderbilt,3,7,10,0.3
vs. BCS non-AQ,2018,Vanderbilt,2,0,2,1.0
vs. FBS Power 5,2018,Vanderbilt,3,6,9,0.3333333333333333
vs. FBS non-Power 5,2018,Vanderbilt,2,1,3,0.6666666666666666
in August/September,2018,Vanderbilt,3,2,5,0.6
in October,2018,Vanderbilt,1,3,4,0.25
in November,2018,Vanderbilt,2,1,3,0.6666666666666666
in December/January,2018,Vanderbilt,0,1,1,0.0
All Games,2019,Vanderbilt,3,9,12,0.25
at Home,2019,Vanderbilt,3,4,7,0.42857142857142855
on Road/Neutral Site,2019,Vanderbilt,0,5,5,0.0
vs. Conference,2019,Vanderbilt,1,7,8,0.125
vs. Non-Conference,2019,Vanderbilt,2,2,4,0.5
vs. Ranked (AP),2019,Vanderbilt,0,3,3,0.0
vs. Unranked (AP),2019,Vanderbilt,3,6,9,0.3333333333333333
vs. FBS (I-A),2019,Vanderbilt,2,9,11,0.18181818181818182
vs. FCS (I-AA),2019,Vanderbilt,1,0,1,1.0
vs. FBS Winning,2019,Vanderbilt,0,5,5,0.0
vs. FBS Non-Winning,2019,Vanderbilt,2,4,6,0.3333333333333333
vs. BCS AQ,2019,Vanderbilt,1,8,9,0.1111111111111111
vs. BCS non-AQ,2019,Vanderbilt,1,1,2,0.5
vs. FBS Power 5,2019,Vanderbilt,1,8,9,0.1111111111111111
vs. FBS non-Power 5,2019,Vanderbilt,1,1,2,0.5
in August/September,2019,Vanderbilt,1,3,4,0.25
in October,2019,Vanderbilt,1,2,3,0.3333333333333333
in November,2019,Vanderbilt,1,4,5,0.2
in December/January,2019,Vanderbilt,0,0,0,
All Games,2020,Vanderbilt,0,9,9,0.0
at Home,2020,Vanderbilt,0,5,5,0.0
on Road/Neutral Site,2020,Vanderbilt,0,4,4,0.0
vs. Conference,2020,Vanderbilt,0,9,9,0.0
vs. Non-Conference,2020,Vanderbilt,0,0,0,
vs. Ranked (AP),2020,Vanderbilt,0,2,2,0.0
vs. Unranked (AP),2020,Vanderbilt,0,7,7,0.0
vs. FBS (I-A),2020,Vanderbilt,0,9,9,0.0
vs. FCS (I-AA),2020,Vanderbilt,0,0,0,
vs. FBS Winning,2020,Vanderbilt,0,2,2,0.0
vs. FBS Non-Winning,2020,Vanderbilt,0,7,7,0.0
vs. BCS AQ,2020,Vanderbilt,0,9,9,0.0
vs. BCS non-AQ,2020,Vanderbilt,0,0,0,
vs. FBS Power 5,2020,Vanderbilt,0,9,9,0.0
vs. FBS non-Power 5,2020,Vanderbilt,0,0,0,
in August/September,2020,Vanderbilt,0,1,1,0.0
in October,2020,Vanderbilt,0,3,3,0.0
in November,2020,Vanderbilt,0,4,4,0.0
in December/January,2020,Vanderbilt,0,1,1,0.0
All Games,2021,Vanderbilt,2,10,12,0.16666666666666666
at Home,2021,Vanderbilt,1,6,7,0.14285714285714285
on Road/Neutral Site,2021,Vanderbilt,1,4,5,0.2
vs. Conference,2021,Vanderbilt,0,8,8,0.0
vs. Non-Conference,2021,Vanderbilt,2,2,4,0.5
vs. Ranked (AP),2021,Vanderbilt,0,3,3,0.0
vs. Unranked (AP),2021,Vanderbilt,2,7,9,0.2222222222222222
vs. FBS (I-A),2021,Vanderbilt,2,9,11,0.18181818181818182
vs. FCS (I-AA),2021,Vanderbilt,0,1,1,0.0
vs. FBS Winning,2021,Vanderbilt,0,6,6,0.0
vs. FBS Non-Winning,2021,Vanderbilt,2,3,5,0.4
vs. BCS AQ,2021,Vanderbilt,0,9,9,0.0
vs. BCS non-AQ,2021,Vanderbilt,2,0,2,1.0
vs. FBS Power 5,2021,Vanderbilt,0,9,9,0.0
vs. FBS non-Power 5,2021,Vanderbilt,2,0,2,1.0
in August/September,2021,Vanderbilt,1,3,4,0.25
in October,2021,Vanderbilt,1,4,5,0.2
in November,2021,Vanderbilt,0,3,3,0.0
in December/January,2021,Vanderbilt,0,0,0,
All Games,2022,Vanderbilt,5,7,12,0.4166666666666667
at Home,2022,Vanderbilt,2,4,6,0.3333333333333333
on Road/Neutral Site,2022,Vanderbilt,3,3,6,0.5
vs. Conference,2022,Vanderbilt,2,6,8,0.25
vs. Non-Conference,2022,Vanderbilt,3,1,4,0.75
vs. Ranked (AP),2022,Vanderbilt,0,4,4,0.0
vs. Unranked (AP),2022,Vanderbilt,5,3,8,0.625
vs. FBS (I-A),2022,Vanderbilt,4,7,11,0.36363636363636365
vs. FCS (I-AA),2022,Vanderbilt,1,0,1,1.0
vs. FBS Winning,2022,Vanderbilt,1,6,7,0.14285714285714285
vs. FBS Non-Winning,2022,Vanderbilt,3,1,4,0.75
vs. BCS AQ,2022,Vanderbilt,2,7,9,0.2222222222222222
vs. BCS non-AQ,2022,Vanderbilt,2,0,2,1.0
vs. FBS Power 5,2022,Vanderbilt,2,7,9,0.2222222222222222
vs. FBS non-Power 5,2022,Vanderbilt,2,0,2,1.0
in August/September,2022,Vanderbilt,3,2,5,0.6
in October,2022,Vanderbilt,0,3,3,0.0
in November,2022,Vanderbilt,2,2,4,0.5
in December/January,2022,Vanderbilt,0,0,0,
All Games,2009,Virginia,3,9,12,0.25
at Home,2009,Virginia,1,6,7,0.14285714285714285
on Road/Neutral Site,2009,Virginia,2,3,5,0.4
vs. Conference,2009,Virginia,2,6,8,0.25
vs. Non-Conference,2009,Virginia,1,3,4,0.25
vs. Ranked (AP),2009,Virginia,0,5,5,0.0
vs. Unranked (AP),2009,Virginia,3,4,7,0.42857142857142855
vs. FBS (I-A),2009,Virginia,3,8,11,0.2727272727272727
vs. FCS (I-AA),2009,Virginia,0,1,1,0.0
vs. FBS Winning,2009,Virginia,1,7,8,0.125
vs. FBS Non-Winning,2009,Virginia,2,1,3,0.6666666666666666
vs. BCS AQ,2009,Virginia,3,6,9,0.3333333333333333
vs. BCS non-AQ,2009,Virginia,0,2,2,0.0
vs. FBS Power 5,2009,Virginia,3,6,9,0.3333333333333333
vs. FBS non-Power 5,2009,Virginia,0,2,2,0.0
in August/September,2009,Virginia,0,3,3,0.0
in October,2009,Virginia,3,2,5,0.6
in November,2009,Virginia,0,4,4,0.0
in December/January,2009,Virginia,0,0,0,
All Games,2010,Virginia,4,8,12,0.3333333333333333
at Home,2010,Virginia,4,3,7,0.5714285714285714
on Road/Neutral Site,2010,Virginia,0,5,5,0.0
vs. Conference,2010,Virginia,1,7,8,0.125
vs. Non-Conference,2010,Virginia,3,1,4,0.75
vs. Ranked (AP),2010,Virginia,0,3,3,0.0
vs. Unranked (AP),2010,Virginia,4,5,9,0.4444444444444444
vs. FBS (I-A),2010,Virginia,2,8,10,0.2
vs. FCS (I-AA),2010,Virginia,2,0,2,1.0
vs. FBS Winning,2010,Virginia,1,6,7,0.14285714285714285
vs. FBS Non-Winning,2010,Virginia,1,2,3,0.3333333333333333
vs. BCS AQ,2010,Virginia,1,8,9,0.1111111111111111
vs. BCS non-AQ,2010,Virginia,1,0,1,1.0
vs. FBS Power 5,2010,Virginia,1,8,9,0.1111111111111111
vs. FBS non-Power 5,2010,Virginia,1,0,1,1.0
in August/September,2010,Virginia,2,1,3,0.6666666666666666
in October,2010,Virginia,2,3,5,0.4
in November,2010,Virginia,0,4,4,0.0
in December/January,2010,Virginia,0,0,0,
All Games,2011,Virginia,8,5,13,0.6153846153846154
at Home,2011,Virginia,4,3,7,0.5714285714285714
on Road/Neutral Site,2011,Virginia,4,2,6,0.6666666666666666
vs. Conference,2011,Virginia,5,3,8,0.625
vs. Non-Conference,2011,Virginia,3,2,5,0.6
vs. Ranked (AP),2011,Virginia,1,2,3,0.3333333333333333
vs. Unranked (AP),2011,Virginia,7,3,10,0.7
vs. FBS (I-A),2011,Virginia,7,5,12,0.5833333333333334
vs. FCS (I-AA),2011,Virginia,1,0,1,1.0
vs. FBS Winning,2011,Virginia,2,5,7,0.2857142857142857
vs. FBS Non-Winning,2011,Virginia,5,0,5,1.0
vs. BCS AQ,2011,Virginia,6,4,10,0.6
vs. BCS non-AQ,2011,Virginia,1,1,2,0.5
vs. FBS Power 5,2011,Virginia,6,4,10,0.6
vs. FBS non-Power 5,2011,Virginia,1,1,2,0.5
in August/September,2011,Virginia,2,2,4,0.5
in October,2011,Virginia,3,1,4,0.75
in November,2011,Virginia,3,1,4,0.75
in December/January,2011,Virginia,0,1,1,0.0
All Games,2012,Virginia,4,8,12,0.3333333333333333
at Home,2012,Virginia,3,4,7,0.42857142857142855
on Road/Neutral Site,2012,Virginia,1,4,5,0.2
vs. Conference,2012,Virginia,2,6,8,0.25
vs. Non-Conference,2012,Virginia,2,2,4,0.5
vs. Ranked (AP),2012,Virginia,0,0,0,
vs. Unranked (AP),2012,Virginia,4,8,12,0.3333333333333333
vs. FBS (I-A),2012,Virginia,3,8,11,0.2727272727272727
vs. FCS (I-AA),2012,Virginia,1,0,1,1.0
vs. FBS Winning,2012,Virginia,3,4,7,0.42857142857142855
vs. FBS Non-Winning,2012,Virginia,0,4,4,0.0
vs. BCS AQ,2012,Virginia,3,7,10,0.3
vs. BCS non-AQ,2012,Virginia,0,1,1,0.0
vs. FBS Power 5,2012,Virginia,3,7,10,0.3
vs. FBS non-Power 5,2012,Virginia,0,1,1,0.0
in August/September,2012,Virginia,2,3,5,0.4
in October,2012,Virginia,0,3,3,0.0
in November,2012,Virginia,2,2,4,0.5
in December/January,2012,Virginia,0,0,0,
All Games,2013,Virginia,2,10,12,0.16666666666666666
at Home,2013,Virginia,2,6,8,0.25
on Road/Neutral Site,2013,Virginia,0,4,4,0.0
vs. Conference,2013,Virginia,0,8,8,0.0
vs. Non-Conference,2013,Virginia,2,2,4,0.5
vs. Ranked (AP),2013,Virginia,0,3,3,0.0
vs. Unranked (AP),2013,Virginia,2,7,9,0.2222222222222222
vs. FBS (I-A),2013,Virginia,1,10,11,0.09090909090909091
vs. FCS (I-AA),2013,Virginia,1,0,1,1.0
vs. FBS Winning,2013,Virginia,1,10,11,0.09090909090909091
vs. FBS Non-Winning,2013,Virginia,0,0,0,
vs. BCS AQ,2013,Virginia,0,9,9,0.0
vs. BCS non-AQ,2013,Virginia,1,1,2,0.5
vs. FBS Power 5,2013,Virginia,0,9,9,0.0
vs. FBS non-Power 5,2013,Virginia,1,1,2,0.5
in August/September,2013,Virginia,2,2,4,0.5
in October,2013,Virginia,0,4,4,0.0
in November,2013,Virginia,0,4,4,0.0
in December/January,2013,Virginia,0,0,0,
All Games,2014,Virginia,5,7,12,0.4166666666666667
at Home,2014,Virginia,5,2,7,0.7142857142857143
on Road/Neutral Site,2014,Virginia,0,5,5,0.0
vs. Conference,2014,Virginia,3,5,8,0.375
vs. Non-Conference,2014,Virginia,2,2,4,0.5
vs. Ranked (AP),2014,Virginia,1,3,4,0.25
vs. Unranked (AP),2014,Virginia,4,4,8,0.5
vs. FBS (I-A),2014,Virginia,4,7,11,0.36363636363636365
vs. FCS (I-AA),2014,Virginia,1,0,1,1.0
vs. FBS Winning,2014,Virginia,1,6,7,0.14285714285714285
vs. FBS Non-Winning,2014,Virginia,3,1,4,0.75
vs. BCS AQ,2014,Virginia,3,6,9,0.3333333333333333
vs. BCS non-AQ,2014,Virginia,1,1,2,0.5
vs. FBS Power 5,2014,Virginia,3,6,9,0.3333333333333333
vs. FBS non-Power 5,2014,Virginia,1,1,2,0.5
in August/September,2014,Virginia,3,2,5,0.6
in October,2014,Virginia,1,2,3,0.3333333333333333
in November,2014,Virginia,1,3,4,0.25
in December/January,2014,Virginia,0,0,0,
All Games,2015,Virginia,4,8,12,0.3333333333333333
at Home,2015,Virginia,4,3,7,0.5714285714285714
on Road/Neutral Site,2015,Virginia,0,5,5,0.0
vs. Conference,2015,Virginia,3,5,8,0.375
vs. Non-Conference,2015,Virginia,1,3,4,0.25
vs. Ranked (AP),2015,Virginia,0,2,2,0.0
vs. Unranked (AP),2015,Virginia,4,6,10,0.4
vs. FBS (I-A),2015,Virginia,3,8,11,0.2727272727272727
vs. FCS (I-AA),2015,Virginia,1,0,1,1.0
vs. FBS Winning,2015,Virginia,1,8,9,0.1111111111111111
vs. FBS Non-Winning,2015,Virginia,2,0,2,1.0
vs. BCS AQ,2015,Virginia,3,7,10,0.3
vs. BCS non-AQ,2015,Virginia,0,1,1,0.0
vs. FBS Power 5,2015,Virginia,3,6,9,0.3333333333333333
vs. FBS non-Power 5,2015,Virginia,0,2,2,0.0
in August/September,2015,Virginia,1,3,4,0.25
in October,2015,Virginia,2,2,4,0.5
in November,2015,Virginia,1,3,4,0.25
in December/January,2015,Virginia,0,0,0,
All Games,2016,Virginia,2,10,12,0.16666666666666666
at Home,2016,Virginia,1,5,6,0.16666666666666666
on Road/Neutral Site,2016,Virginia,1,5,6,0.16666666666666666
vs. Conference,2016,Virginia,1,7,8,0.125
vs. Non-Conference,2016,Virginia,1,3,4,0.25
vs. Ranked (AP),2016,Virginia,0,3,3,0.0
vs. Unranked (AP),2016,Virginia,2,7,9,0.2222222222222222
vs. FBS (I-A),2016,Virginia,2,9,11,0.18181818181818182
vs. FCS (I-AA),2016,Virginia,0,1,1,0.0
vs. FBS Winning,2016,Virginia,0,7,7,0.0
vs. FBS Non-Winning,2016,Virginia,2,2,4,0.5
vs. BCS AQ,2016,Virginia,1,9,10,0.1
vs. BCS non-AQ,2016,Virginia,1,0,1,1.0
vs. FBS Power 5,2016,Virginia,1,8,9,0.1111111111111111
vs. FBS non-Power 5,2016,Virginia,1,1,2,0.5
in August/September,2016,Virginia,1,3,4,0.25
in October,2016,Virginia,1,3,4,0.25
in November,2016,Virginia,0,4,4,0.0
in December/January,2016,Virginia,0,0,0,
All Games,2017,Virginia,6,7,13,0.46153846153846156
at Home,2017,Virginia,4,3,7,0.5714285714285714
on Road/Neutral Site,2017,Virginia,2,4,6,0.3333333333333333
vs. Conference,2017,Virginia,3,5,8,0.375
vs. Non-Conference,2017,Virginia,3,2,5,0.6
vs. Ranked (AP),2017,Virginia,1,2,3,0.3333333333333333
vs. Unranked (AP),2017,Virginia,5,5,10,0.5
vs. FBS (I-A),2017,Virginia,5,7,12,0.4166666666666667
vs. FCS (I-AA),2017,Virginia,1,0,1,1.0
vs. FBS Winning,2017,Virginia,2,5,7,0.2857142857142857
vs. FBS Non-Winning,2017,Virginia,3,2,5,0.6
vs. BCS AQ,2017,Virginia,4,7,11,0.36363636363636365
vs. BCS non-AQ,2017,Virginia,1,0,1,1.0
vs. FBS Power 5,2017,Virginia,3,6,9,0.3333333333333333
vs. FBS non-Power 5,2017,Virginia,2,1,3,0.6666666666666666
in August/September,2017,Virginia,3,1,4,0.75
in October,2017,Virginia,2,2,4,0.5
in November,2017,Virginia,1,3,4,0.25
in December/January,2017,Virginia,0,1,1,0.0
All Games,2018,Virginia,8,5,13,0.6153846153846154
at Home,2018,Virginia,6,1,7,0.8571428571428571
on Road/Neutral Site,2018,Virginia,2,4,6,0.3333333333333333
vs. Conference,2018,Virginia,4,4,8,0.5
vs. Non-Conference,2018,Virginia,4,1,5,0.8
vs. Ranked (AP),2018,Virginia,0,0,0,
vs. Unranked (AP),2018,Virginia,8,5,13,0.6153846153846154
vs. FBS (I-A),2018,Virginia,7,5,12,0.5833333333333334
vs. FCS (I-AA),2018,Virginia,1,0,1,1.0
vs. FBS Winning,2018,Virginia,4,2,6,0.6666666666666666
vs. FBS Non-Winning,2018,Virginia,3,3,6,0.5
vs. BCS AQ,2018,Virginia,5,5,10,0.5
vs. BCS non-AQ,2018,Virginia,2,0,2,1.0
vs. FBS Power 5,2018,Virginia,5,5,10,0.5
vs. FBS non-Power 5,2018,Virginia,2,0,2,1.0
in August/September,2018,Virginia,3,2,5,0.6
in October,2018,Virginia,3,0,3,1.0
in November,2018,Virginia,1,3,4,0.25
in December/January,2018,Virginia,1,0,1,1.0
All Games,2019,Virginia,9,5,14,0.6428571428571429
at Home,2019,Virginia,7,0,7,1.0
on Road/Neutral Site,2019,Virginia,2,5,7,0.2857142857142857
vs. Conference,2019,Virginia,6,3,9,0.6666666666666666
vs. Non-Conference,2019,Virginia,3,2,5,0.6
vs. Ranked (AP),2019,Virginia,0,3,3,0.0
vs. Unranked (AP),2019,Virginia,9,2,11,0.8181818181818182
vs. FBS (I-A),2019,Virginia,8,5,13,0.6153846153846154
vs. FCS (I-AA),2019,Virginia,1,0,1,1.0
vs. FBS Winning,2019,Virginia,4,4,8,0.5
vs. FBS Non-Winning,2019,Virginia,4,1,5,0.8
vs. BCS AQ,2019,Virginia,6,5,11,0.5454545454545454
vs. BCS non-AQ,2019,Virginia,2,0,2,1.0
vs. FBS Power 5,2019,Virginia,6,4,10,0.6
vs. FBS non-Power 5,2019,Virginia,2,1,3,0.6666666666666666
in August/September,2019,Virginia,4,1,5,0.8
in October,2019,Virginia,1,2,3,0.3333333333333333
in November,2019,Virginia,4,0,4,1.0
in December/January,2019,Virginia,0,2,2,0.0
All Games,2020,Virginia,5,5,10,0.5
at Home,2020,Virginia,5,1,6,0.8333333333333334
on Road/Neutral Site,2020,Virginia,0,4,4,0.0
vs. Conference,2020,Virginia,4,5,9,0.4444444444444444
vs. Non-Conference,2020,Virginia,1,0,1,1.0
vs. Ranked (AP),2020,Virginia,1,3,4,0.25
vs. Unranked (AP),2020,Virginia,4,2,6,0.6666666666666666
vs. FBS (I-A),2020,Virginia,4,5,9,0.4444444444444444
vs. FCS (I-AA),2020,Virginia,1,0,1,1.0
vs. FBS Winning,2020,Virginia,2,3,5,0.4
vs. FBS Non-Winning,2020,Virginia,2,2,4,0.5
vs. BCS AQ,2020,Virginia,4,5,9,0.4444444444444444
vs. BCS non-AQ,2020,Virginia,0,0,0,
vs. FBS Power 5,2020,Virginia,4,5,9,0.4444444444444444
vs. FBS non-Power 5,2020,Virginia,0,0,0,
in August/September,2020,Virginia,1,0,1,1.0
in October,2020,Virginia,1,4,5,0.2
in November,2020,Virginia,2,0,2,1.0
in December/January,2020,Virginia,1,1,2,0.5
All Games,2021,Virginia,6,6,12,0.5
at Home,2021,Virginia,4,3,7,0.5714285714285714
on Road/Neutral Site,2021,Virginia,2,3,5,0.4
vs. Conference,2021,Virginia,4,4,8,0.5
vs. Non-Conference,2021,Virginia,2,2,4,0.5
vs. Ranked (AP),2021,Virginia,0,4,4,0.0
vs. Unranked (AP),2021,Virginia,6,2,8,0.75
vs. FBS (I-A),2021,Virginia,5,6,11,0.45454545454545453
vs. FCS (I-AA),2021,Virginia,1,0,1,1.0
vs. FBS Winning,2021,Virginia,1,4,5,0.2
vs. FBS Non-Winning,2021,Virginia,4,2,6,0.6666666666666666
vs. BCS AQ,2021,Virginia,5,5,10,0.5
vs. BCS non-AQ,2021,Virginia,0,1,1,0.0
vs. FBS Power 5,2021,Virginia,5,4,9,0.5555555555555556
vs. FBS non-Power 5,2021,Virginia,0,2,2,0.0
in August/September,2021,Virginia,3,2,5,0.6
in October,2021,Virginia,3,1,4,0.75
in November,2021,Virginia,0,3,3,0.0
in December/January,2021,Virginia,0,0,0,
All Games,2022,Virginia,3,7,10,0.3
at Home,2022,Virginia,2,4,6,0.3333333333333333
on Road/Neutral Site,2022,Virginia,1,3,4,0.25
vs. Conference,2022,Virginia,1,6,7,0.14285714285714285
vs. Non-Conference,2022,Virginia,2,1,3,0.6666666666666666
vs. Ranked (AP),2022,Virginia,0,1,1,0.0
vs. Unranked (AP),2022,Virginia,3,6,9,0.3333333333333333
vs. FBS (I-A),2022,Virginia,2,7,9,0.2222222222222222
vs. FCS (I-AA),2022,Virginia,1,0,1,1.0
vs. FBS Winning,2022,Virginia,0,6,6,0.0
vs. FBS Non-Winning,2022,Virginia,2,1,3,0.6666666666666666
vs. BCS AQ,2022,Virginia,1,7,8,0.125
vs. BCS non-AQ,2022,Virginia,1,0,1,1.0
vs. FBS Power 5,2022,Virginia,1,7,8,0.125
vs. FBS non-Power 5,2022,Virginia,1,0,1,1.0
in August/September,2022,Virginia,2,2,4,0.5
in October,2022,Virginia,1,3,4,0.25
in November,2022,Virginia,0,2,2,0.0
in December/January,2022,Virginia,0,0,0,
All Games,2009,Virginia Tech,10,3,13,0.7692307692307693
at Home,2009,Virginia Tech,5,1,6,0.8333333333333334
on Road/Neutral Site,2009,Virginia Tech,5,2,7,0.7142857142857143
vs. Conference,2009,Virginia Tech,6,2,8,0.75
vs. Non-Conference,2009,Virginia Tech,4,1,5,0.8
vs. Ranked (AP),2009,Virginia Tech,2,2,4,0.5
vs. Unranked (AP),2009,Virginia Tech,8,1,9,0.8888888888888888
vs. FBS (I-A),2009,Virginia Tech,10,3,13,0.7692307692307693
vs. FCS (I-AA),2009,Virginia Tech,0,0,0,
vs. FBS Winning,2009,Virginia Tech,6,3,9,0.6666666666666666
vs. FBS Non-Winning,2009,Virginia Tech,4,0,4,1.0
vs. BCS AQ,2009,Virginia Tech,8,3,11,0.7272727272727273
vs. BCS non-AQ,2009,Virginia Tech,2,0,2,1.0
vs. FBS Power 5,2009,Virginia Tech,8,3,11,0.7272727272727273
vs. FBS non-Power 5,2009,Virginia Tech,2,0,2,1.0
in August/September,2009,Virginia Tech,3,1,4,0.75
in October,2009,Virginia Tech,2,2,4,0.5
in November,2009,Virginia Tech,4,0,4,1.0
in December/January,2009,Virginia Tech,1,0,1,1.0
All Games,2010,Virginia Tech,11,3,14,0.7857142857142857
at Home,2010,Virginia Tech,6,1,7,0.8571428571428571
on Road/Neutral Site,2010,Virginia Tech,5,2,7,0.7142857142857143
vs. Conference,2010,Virginia Tech,9,0,9,1.0
vs. Non-Conference,2010,Virginia Tech,2,3,5,0.4
vs. Ranked (AP),2010,Virginia Tech,2,2,4,0.5
vs. Unranked (AP),2010,Virginia Tech,9,1,10,0.9
vs. FBS (I-A),2010,Virginia Tech,11,2,13,0.8461538461538461
vs. FCS (I-AA),2010,Virginia Tech,0,1,1,0.0
vs. FBS Winning,2010,Virginia Tech,5,2,7,0.7142857142857143
vs. FBS Non-Winning,2010,Virginia Tech,6,0,6,1.0
vs. BCS AQ,2010,Virginia Tech,9,1,10,0.9
vs. BCS non-AQ,2010,Virginia Tech,2,1,3,0.6666666666666666
vs. FBS Power 5,2010,Virginia Tech,9,1,10,0.9
vs. FBS non-Power 5,2010,Virginia Tech,2,1,3,0.6666666666666666
in August/September,2010,Virginia Tech,2,2,4,0.5
in October,2010,Virginia Tech,4,0,4,1.0
in November,2010,Virginia Tech,4,0,4,1.0
in December/January,2010,Virginia Tech,1,1,2,0.5
All Games,2011,Virginia Tech,11,3,14,0.7857142857142857
at Home,2011,Virginia Tech,5,1,6,0.8333333333333334
on Road/Neutral Site,2011,Virginia Tech,6,2,8,0.75
vs. Conference,2011,Virginia Tech,7,2,9,0.7777777777777778
vs. Non-Conference,2011,Virginia Tech,4,1,5,0.8
vs. Ranked (AP),2011,Virginia Tech,0,3,3,0.0
vs. Unranked (AP),2011,Virginia Tech,11,0,11,1.0
vs. FBS (I-A),2011,Virginia Tech,10,3,13,0.7692307692307693
vs. FCS (I-AA),2011,Virginia Tech,1,0,1,1.0
vs. FBS Winning,2011,Virginia Tech,5,3,8,0.625
vs. FBS Non-Winning,2011,Virginia Tech,5,0,5,1.0
vs. BCS AQ,2011,Virginia Tech,7,3,10,0.7
vs. BCS non-AQ,2011,Virginia Tech,3,0,3,1.0
vs. FBS Power 5,2011,Virginia Tech,7,3,10,0.7
vs. FBS non-Power 5,2011,Virginia Tech,3,0,3,1.0
in August/September,2011,Virginia Tech,4,0,4,1.0
in October,2011,Virginia Tech,4,1,5,0.8
in November,2011,Virginia Tech,3,0,3,1.0
in December/January,2011,Virginia Tech,0,2,2,0.0
All Games,2012,Virginia Tech,7,6,13,0.5384615384615384
at Home,2012,Virginia Tech,5,1,6,0.8333333333333334
on Road/Neutral Site,2012,Virginia Tech,2,5,7,0.2857142857142857
vs. Conference,2012,Virginia Tech,4,4,8,0.5
vs. Non-Conference,2012,Virginia Tech,3,2,5,0.6
vs. Ranked (AP),2012,Virginia Tech,0,2,2,0.0
vs. Unranked (AP),2012,Virginia Tech,7,4,11,0.6363636363636364
vs. FBS (I-A),2012,Virginia Tech,6,6,12,0.5
vs. FCS (I-AA),2012,Virginia Tech,1,0,1,1.0
vs. FBS Winning,2012,Virginia Tech,2,5,7,0.2857142857142857
vs. FBS Non-Winning,2012,Virginia Tech,4,1,5,0.8
vs. BCS AQ,2012,Virginia Tech,5,6,11,0.45454545454545453
vs. BCS non-AQ,2012,Virginia Tech,1,0,1,1.0
vs. FBS Power 5,2012,Virginia Tech,4,4,8,0.5
vs. FBS non-Power 5,2012,Virginia Tech,2,2,4,0.5
in August/September,2012,Virginia Tech,3,2,5,0.6
in October,2012,Virginia Tech,1,2,3,0.3333333333333333
in November,2012,Virginia Tech,2,2,4,0.5
in December/January,2012,Virginia Tech,1,0,1,1.0
All Games,2013,Virginia Tech,8,5,13,0.6153846153846154
at Home,2013,Virginia Tech,4,2,6,0.6666666666666666
on Road/Neutral Site,2013,Virginia Tech,4,3,7,0.5714285714285714
vs. Conference,2013,Virginia Tech,5,3,8,0.625
vs. Non-Conference,2013,Virginia Tech,3,2,5,0.6
vs. Ranked (AP),2013,Virginia Tech,0,3,3,0.0
vs. Unranked (AP),2013,Virginia Tech,8,2,10,0.8
vs. FBS (I-A),2013,Virginia Tech,7,5,12,0.5833333333333334
vs. FCS (I-AA),2013,Virginia Tech,1,0,1,1.0
vs. FBS Winning,2013,Virginia Tech,6,5,11,0.5454545454545454
vs. FBS Non-Winning,2013,Virginia Tech,1,0,1,1.0
vs. BCS AQ,2013,Virginia Tech,5,5,10,0.5
vs. BCS non-AQ,2013,Virginia Tech,2,0,2,1.0
vs. FBS Power 5,2013,Virginia Tech,5,5,10,0.5
vs. FBS non-Power 5,2013,Virginia Tech,2,0,2,1.0
in August/September,2013,Virginia Tech,4,1,5,0.8
in October,2013,Virginia Tech,2,1,3,0.6666666666666666
in November,2013,Virginia Tech,2,2,4,0.5
in December/January,2013,Virginia Tech,0,1,1,0.0
All Games,2014,Virginia Tech,7,6,13,0.5384615384615384
at Home,2014,Virginia Tech,3,4,7,0.42857142857142855
on Road/Neutral Site,2014,Virginia Tech,4,2,6,0.6666666666666666
vs. Conference,2014,Virginia Tech,3,5,8,0.375
vs. Non-Conference,2014,Virginia Tech,4,1,5,0.8
vs. Ranked (AP),2014,Virginia Tech,1,1,2,0.5
vs. Unranked (AP),2014,Virginia Tech,6,5,11,0.5454545454545454
vs. FBS (I-A),2014,Virginia Tech,6,6,12,0.5
vs. FCS (I-AA),2014,Virginia Tech,1,0,1,1.0
vs. FBS Winning,2014,Virginia Tech,4,3,7,0.5714285714285714
vs. FBS Non-Winning,2014,Virginia Tech,2,3,5,0.4
vs. BCS AQ,2014,Virginia Tech,5,6,11,0.45454545454545453
vs. BCS non-AQ,2014,Virginia Tech,1,0,1,1.0
vs. FBS Power 5,2014,Virginia Tech,4,5,9,0.4444444444444444
vs. FBS non-Power 5,2014,Virginia Tech,2,1,3,0.6666666666666666
in August/September,2014,Virginia Tech,3,2,5,0.6
in October,2014,Virginia Tech,1,2,3,0.3333333333333333
in November,2014,Virginia Tech,2,2,4,0.5
in December/January,2014,Virginia Tech,1,0,1,1.0
All Games,2015,Virginia Tech,7,6,13,0.5384615384615384
at Home,2015,Virginia Tech,2,4,6,0.3333333333333333
on Road/Neutral Site,2015,Virginia Tech,5,2,7,0.7142857142857143
vs. Conference,2015,Virginia Tech,4,4,8,0.5
vs. Non-Conference,2015,Virginia Tech,3,2,5,0.6
vs. Ranked (AP),2015,Virginia Tech,0,2,2,0.0
vs. Unranked (AP),2015,Virginia Tech,7,4,11,0.6363636363636364
vs. FBS (I-A),2015,Virginia Tech,6,6,12,0.5
vs. FCS (I-AA),2015,Virginia Tech,1,0,1,1.0
vs. FBS Winning,2015,Virginia Tech,1,5,6,0.16666666666666666
vs. FBS Non-Winning,2015,Virginia Tech,5,1,6,0.8333333333333334
vs. BCS AQ,2015,Virginia Tech,6,6,12,0.5
vs. BCS non-AQ,2015,Virginia Tech,0,0,0,
vs. FBS Power 5,2015,Virginia Tech,5,5,10,0.5
vs. FBS non-Power 5,2015,Virginia Tech,1,1,2,0.5
in August/September,2015,Virginia Tech,2,2,4,0.5
in October,2015,Virginia Tech,2,3,5,0.4
in November,2015,Virginia Tech,2,1,3,0.6666666666666666
in December/January,2015,Virginia Tech,1,0,1,1.0
All Games,2016,Virginia Tech,10,4,14,0.7142857142857143
at Home,2016,Virginia Tech,5,1,6,0.8333333333333334
on Road/Neutral Site,2016,Virginia Tech,5,3,8,0.625
vs. Conference,2016,Virginia Tech,6,3,9,0.6666666666666666
vs. Non-Conference,2016,Virginia Tech,4,1,5,0.8
vs. Ranked (AP),2016,Virginia Tech,1,1,2,0.5
vs. Unranked (AP),2016,Virginia Tech,9,3,12,0.75
vs. FBS (I-A),2016,Virginia Tech,9,4,13,0.6923076923076923
vs. FCS (I-AA),2016,Virginia Tech,1,0,1,1.0
vs. FBS Winning,2016,Virginia Tech,5,3,8,0.625
vs. FBS Non-Winning,2016,Virginia Tech,4,1,5,0.8
vs. BCS AQ,2016,Virginia Tech,9,4,13,0.6923076923076923
vs. BCS non-AQ,2016,Virginia Tech,0,0,0,
vs. FBS Power 5,2016,Virginia Tech,7,4,11,0.6363636363636364
vs. FBS non-Power 5,2016,Virginia Tech,2,0,2,1.0
in August/September,2016,Virginia Tech,3,1,4,0.75
in October,2016,Virginia Tech,3,1,4,0.75
in November,2016,Virginia Tech,3,1,4,0.75
in December/January,2016,Virginia Tech,1,1,2,0.5
All Games,2017,Virginia Tech,9,4,13,0.6923076923076923
at Home,2017,Virginia Tech,5,1,6,0.8333333333333334
on Road/Neutral Site,2017,Virginia Tech,4,3,7,0.5714285714285714
vs. Conference,2017,Virginia Tech,5,3,8,0.625
vs. Non-Conference,2017,Virginia Tech,4,1,5,0.8
vs. Ranked (AP),2017,Virginia Tech,0,3,3,0.0
vs. Unranked (AP),2017,Virginia Tech,9,1,10,0.9
vs. FBS (I-A),2017,Virginia Tech,8,4,12,0.6666666666666666
vs. FCS (I-AA),2017,Virginia Tech,1,0,1,1.0
vs. FBS Winning,2017,Virginia Tech,3,3,6,0.5
vs. FBS Non-Winning,2017,Virginia Tech,5,1,6,0.8333333333333334
vs. BCS AQ,2017,Virginia Tech,7,4,11,0.6363636363636364
vs. BCS non-AQ,2017,Virginia Tech,1,0,1,1.0
vs. FBS Power 5,2017,Virginia Tech,6,4,10,0.6
vs. FBS non-Power 5,2017,Virginia Tech,2,0,2,1.0
in August/September,2017,Virginia Tech,4,1,5,0.8
in October,2017,Virginia Tech,3,0,3,1.0
in November,2017,Virginia Tech,2,2,4,0.5
in December/January,2017,Virginia Tech,0,1,1,0.0
All Games,2018,Virginia Tech,6,7,13,0.46153846153846156
at Home,2018,Virginia Tech,3,4,7,0.42857142857142855
on Road/Neutral Site,2018,Virginia Tech,3,3,6,0.5
vs. Conference,2018,Virginia Tech,4,4,8,0.5
vs. Non-Conference,2018,Virginia Tech,2,3,5,0.4
vs. Ranked (AP),2018,Virginia Tech,0,2,2,0.0
vs. Unranked (AP),2018,Virginia Tech,6,5,11,0.5454545454545454
vs. FBS (I-A),2018,Virginia Tech,5,7,12,0.4166666666666667
vs. FCS (I-AA),2018,Virginia Tech,1,0,1,1.0
vs. FBS Winning,2018,Virginia Tech,3,5,8,0.375
vs. FBS Non-Winning,2018,Virginia Tech,2,2,4,0.5
vs. BCS AQ,2018,Virginia Tech,4,6,10,0.4
vs. BCS non-AQ,2018,Virginia Tech,1,1,2,0.5
vs. FBS Power 5,2018,Virginia Tech,4,4,8,0.5
vs. FBS non-Power 5,2018,Virginia Tech,1,3,4,0.25
in August/September,2018,Virginia Tech,3,1,4,0.75
in October,2018,Virginia Tech,1,2,3,0.3333333333333333
in November,2018,Virginia Tech,1,3,4,0.25
in December/January,2018,Virginia Tech,1,1,2,0.5
All Games,2019,Virginia Tech,8,5,13,0.6153846153846154
at Home,2019,Virginia Tech,6,1,7,0.8571428571428571
on Road/Neutral Site,2019,Virginia Tech,2,4,6,0.3333333333333333
vs. Conference,2019,Virginia Tech,5,3,8,0.625
vs. Non-Conference,2019,Virginia Tech,3,2,5,0.6
vs. Ranked (AP),2019,Virginia Tech,0,1,1,0.0
vs. Unranked (AP),2019,Virginia Tech,8,4,12,0.6666666666666666
vs. FBS (I-A),2019,Virginia Tech,6,5,11,0.5454545454545454
vs. FCS (I-AA),2019,Virginia Tech,2,0,2,1.0
vs. FBS Winning,2019,Virginia Tech,3,3,6,0.5
vs. FBS Non-Winning,2019,Virginia Tech,3,2,5,0.6
vs. BCS AQ,2019,Virginia Tech,5,5,10,0.5
vs. BCS non-AQ,2019,Virginia Tech,1,0,1,1.0
vs. FBS Power 5,2019,Virginia Tech,5,4,9,0.5555555555555556
vs. FBS non-Power 5,2019,Virginia Tech,1,1,2,0.5
in August/September,2019,Virginia Tech,2,2,4,0.5
in October,2019,Virginia Tech,3,0,3,1.0
in November,2019,Virginia Tech,3,2,5,0.6
in December/January,2019,Virginia Tech,0,1,1,0.0
All Games,2020,Virginia Tech,5,6,11,0.45454545454545453
at Home,2020,Virginia Tech,3,3,6,0.5
on Road/Neutral Site,2020,Virginia Tech,2,3,5,0.4
vs. Conference,2020,Virginia Tech,5,5,10,0.5
vs. Non-Conference,2020,Virginia Tech,0,1,1,0.0
vs. Ranked (AP),2020,Virginia Tech,1,4,5,0.2
vs. Unranked (AP),2020,Virginia Tech,4,2,6,0.6666666666666666
vs. FBS (I-A),2020,Virginia Tech,5,6,11,0.45454545454545453
vs. FCS (I-AA),2020,Virginia Tech,0,0,0,
vs. FBS Winning,2020,Virginia Tech,2,5,7,0.2857142857142857
vs. FBS Non-Winning,2020,Virginia Tech,3,1,4,0.75
vs. BCS AQ,2020,Virginia Tech,5,5,10,0.5
vs. BCS non-AQ,2020,Virginia Tech,0,1,1,0.0
vs. FBS Power 5,2020,Virginia Tech,5,5,10,0.5
vs. FBS non-Power 5,2020,Virginia Tech,0,1,1,0.0
in August/September,2020,Virginia Tech,1,0,1,1.0
in October,2020,Virginia Tech,3,2,5,0.6
in November,2020,Virginia Tech,0,3,3,0.0
in December/January,2020,Virginia Tech,1,1,2,0.5
All Games,2021,Virginia Tech,6,7,13,0.46153846153846156
at Home,2021,Virginia Tech,4,3,7,0.5714285714285714
on Road/Neutral Site,2021,Virginia Tech,2,4,6,0.3333333333333333
vs. Conference,2021,Virginia Tech,4,4,8,0.5
vs. Non-Conference,2021,Virginia Tech,2,3,5,0.4
vs. Ranked (AP),2021,Virginia Tech,0,2,2,0.0
vs. Unranked (AP),2021,Virginia Tech,6,5,11,0.5454545454545454
vs. FBS (I-A),2021,Virginia Tech,5,7,12,0.4166666666666667
vs. FCS (I-AA),2021,Virginia Tech,1,0,1,1.0
vs. FBS Winning,2021,Virginia Tech,1,4,5,0.2
vs. FBS Non-Winning,2021,Virginia Tech,4,3,7,0.5714285714285714
vs. BCS AQ,2021,Virginia Tech,4,7,11,0.36363636363636365
vs. BCS non-AQ,2021,Virginia Tech,1,0,1,1.0
vs. FBS Power 5,2021,Virginia Tech,4,6,10,0.4
vs. FBS non-Power 5,2021,Virginia Tech,1,1,2,0.5
in August/September,2021,Virginia Tech,3,1,4,0.75
in October,2021,Virginia Tech,1,3,4,0.25
in November,2021,Virginia Tech,2,2,4,0.5
in December/January,2021,Virginia Tech,0,1,1,0.0
All Games,2022,Virginia Tech,3,8,11,0.2727272727272727
at Home,2022,Virginia Tech,2,3,5,0.4
on Road/Neutral Site,2022,Virginia Tech,1,5,6,0.16666666666666666
vs. Conference,2022,Virginia Tech,1,6,7,0.14285714285714285
vs. Non-Conference,2022,Virginia Tech,2,2,4,0.5
vs. Ranked (AP),2022,Virginia Tech,0,1,1,0.0
vs. Unranked (AP),2022,Virginia Tech,3,7,10,0.3
vs. FBS (I-A),2022,Virginia Tech,2,8,10,0.2
vs. FCS (I-AA),2022,Virginia Tech,1,0,1,1.0
vs. FBS Winning,2022,Virginia Tech,1,4,5,0.2
vs. FBS Non-Winning,2022,Virginia Tech,1,4,5,0.2
vs. BCS AQ,2022,Virginia Tech,1,7,8,0.125
vs. BCS non-AQ,2022,Virginia Tech,1,1,2,0.5
vs. FBS Power 5,2022,Virginia Tech,1,7,8,0.125
vs. FBS non-Power 5,2022,Virginia Tech,1,1,2,0.5
in August/September,2022,Virginia Tech,2,2,4,0.5
in October,2022,Virginia Tech,0,4,4,0.0
in November,2022,Virginia Tech,1,2,3,0.3333333333333333
in December/January,2022,Virginia Tech,0,0,0,
All Games,2009,Wake Forest,5,7,12,0.4166666666666667
at Home,2009,Wake Forest,4,3,7,0.5714285714285714
on Road/Neutral Site,2009,Wake Forest,1,4,5,0.2
vs. Conference,2009,Wake Forest,3,5,8,0.375
vs. Non-Conference,2009,Wake Forest,2,2,4,0.5
vs. Ranked (AP),2009,Wake Forest,0,3,3,0.0
vs. Unranked (AP),2009,Wake Forest,5,4,9,0.5555555555555556
vs. FBS (I-A),2009,Wake Forest,4,7,11,0.36363636363636365
vs. FCS (I-AA),2009,Wake Forest,1,0,1,1.0
vs. FBS Winning,2009,Wake Forest,1,6,7,0.14285714285714285
vs. FBS Non-Winning,2009,Wake Forest,3,1,4,0.75
vs. BCS AQ,2009,Wake Forest,4,6,10,0.4
vs. BCS non-AQ,2009,Wake Forest,0,1,1,0.0
vs. FBS Power 5,2009,Wake Forest,4,6,10,0.4
vs. FBS non-Power 5,2009,Wake Forest,0,1,1,0.0
in August/September,2009,Wake Forest,2,2,4,0.5
in October,2009,Wake Forest,2,3,5,0.4
in November,2009,Wake Forest,1,2,3,0.3333333333333333
in December/January,2009,Wake Forest,0,0,0,
All Games,2010,Wake Forest,3,9,12,0.25
at Home,2010,Wake Forest,2,4,6,0.3333333333333333
on Road/Neutral Site,2010,Wake Forest,1,5,6,0.16666666666666666
vs. Conference,2010,Wake Forest,1,7,8,0.125
vs. Non-Conference,2010,Wake Forest,2,2,4,0.5
vs. Ranked (AP),2010,Wake Forest,0,5,5,0.0
vs. Unranked (AP),2010,Wake Forest,3,4,7,0.42857142857142855
vs. FBS (I-A),2010,Wake Forest,2,9,11,0.18181818181818182
vs. FCS (I-AA),2010,Wake Forest,1,0,1,1.0
vs. FBS Winning,2010,Wake Forest,0,7,7,0.0
vs. FBS Non-Winning,2010,Wake Forest,2,2,4,0.5
vs. BCS AQ,2010,Wake Forest,2,8,10,0.2
vs. BCS non-AQ,2010,Wake Forest,0,1,1,0.0
vs. FBS Power 5,2010,Wake Forest,2,8,10,0.2
vs. FBS non-Power 5,2010,Wake Forest,0,1,1,0.0
in August/September,2010,Wake Forest,2,2,4,0.5
in October,2010,Wake Forest,0,4,4,0.0
in November,2010,Wake Forest,1,3,4,0.25
in December/January,2010,Wake Forest,0,0,0,
All Games,2011,Wake Forest,6,7,13,0.46153846153846156
at Home,2011,Wake Forest,4,3,7,0.5714285714285714
on Road/Neutral Site,2011,Wake Forest,2,4,6,0.3333333333333333
vs. Conference,2011,Wake Forest,5,3,8,0.625
vs. Non-Conference,2011,Wake Forest,1,4,5,0.2
vs. Ranked (AP),2011,Wake Forest,1,2,3,0.3333333333333333
vs. Unranked (AP),2011,Wake Forest,5,5,10,0.5
vs. FBS (I-A),2011,Wake Forest,5,7,12,0.4166666666666667
vs. FCS (I-AA),2011,Wake Forest,1,0,1,1.0
vs. FBS Winning,2011,Wake Forest,2,5,7,0.2857142857142857
vs. FBS Non-Winning,2011,Wake Forest,3,2,5,0.6
vs. BCS AQ,2011,Wake Forest,5,7,12,0.4166666666666667
vs. BCS non-AQ,2011,Wake Forest,0,0,0,
vs. FBS Power 5,2011,Wake Forest,5,5,10,0.5
vs. FBS non-Power 5,2011,Wake Forest,0,2,2,0.0
in August/September,2011,Wake Forest,2,1,3,0.6666666666666666
in October,2011,Wake Forest,3,2,5,0.6
in November,2011,Wake Forest,1,3,4,0.25
in December/January,2011,Wake Forest,0,1,1,0.0
All Games,2012,Wake Forest,5,7,12,0.4166666666666667
at Home,2012,Wake Forest,4,3,7,0.5714285714285714
on Road/Neutral Site,2012,Wake Forest,1,4,5,0.2
vs. Conference,2012,Wake Forest,3,5,8,0.375
vs. Non-Conference,2012,Wake Forest,2,2,4,0.5
vs. Ranked (AP),2012,Wake Forest,0,4,4,0.0
vs. Unranked (AP),2012,Wake Forest,5,3,8,0.625
vs. FBS (I-A),2012,Wake Forest,4,7,11,0.36363636363636365
vs. FCS (I-AA),2012,Wake Forest,1,0,1,1.0
vs. FBS Winning,2012,Wake Forest,1,5,6,0.16666666666666666
vs. FBS Non-Winning,2012,Wake Forest,3,2,5,0.6
vs. BCS AQ,2012,Wake Forest,3,7,10,0.3
vs. BCS non-AQ,2012,Wake Forest,1,0,1,1.0
vs. FBS Power 5,2012,Wake Forest,3,6,9,0.3333333333333333
vs. FBS non-Power 5,2012,Wake Forest,1,1,2,0.5
in August/September,2012,Wake Forest,3,2,5,0.6
in October,2012,Wake Forest,1,2,3,0.3333333333333333
in November,2012,Wake Forest,1,3,4,0.25
in December/January,2012,Wake Forest,0,0,0,
All Games,2013,Wake Forest,4,8,12,0.3333333333333333
at Home,2013,Wake Forest,3,3,6,0.5
on Road/Neutral Site,2013,Wake Forest,1,5,6,0.16666666666666666
vs. Conference,2013,Wake Forest,2,6,8,0.25
vs. Non-Conference,2013,Wake Forest,2,2,4,0.5
vs. Ranked (AP),2013,Wake Forest,0,4,4,0.0
vs. Unranked (AP),2013,Wake Forest,4,4,8,0.5
vs. FBS (I-A),2013,Wake Forest,3,8,11,0.2727272727272727
vs. FCS (I-AA),2013,Wake Forest,1,0,1,1.0
vs. FBS Winning,2013,Wake Forest,1,7,8,0.125
vs. FBS Non-Winning,2013,Wake Forest,2,1,3,0.6666666666666666
vs. BCS AQ,2013,Wake Forest,2,7,9,0.2222222222222222
vs. BCS non-AQ,2013,Wake Forest,1,1,2,0.5
vs. FBS Power 5,2013,Wake Forest,2,7,9,0.2222222222222222
vs. FBS non-Power 5,2013,Wake Forest,1,1,2,0.5
in August/September,2013,Wake Forest,2,3,5,0.4
in October,2013,Wake Forest,2,1,3,0.6666666666666666
in November,2013,Wake Forest,0,4,4,0.0
in December/January,2013,Wake Forest,0,0,0,
All Games,2014,Wake Forest,3,9,12,0.25
at Home,2014,Wake Forest,3,3,6,0.5
on Road/Neutral Site,2014,Wake Forest,0,6,6,0.0
vs. Conference,2014,Wake Forest,1,7,8,0.125
vs. Non-Conference,2014,Wake Forest,2,2,4,0.5
vs. Ranked (AP),2014,Wake Forest,0,3,3,0.0
vs. Unranked (AP),2014,Wake Forest,3,6,9,0.3333333333333333
vs. FBS (I-A),2014,Wake Forest,2,9,11,0.18181818181818182
vs. FCS (I-AA),2014,Wake Forest,1,0,1,1.0
vs. FBS Winning,2014,Wake Forest,1,7,8,0.125
vs. FBS Non-Winning,2014,Wake Forest,1,2,3,0.3333333333333333
vs. BCS AQ,2014,Wake Forest,1,7,8,0.125
vs. BCS non-AQ,2014,Wake Forest,1,2,3,0.3333333333333333
vs. FBS Power 5,2014,Wake Forest,1,7,8,0.125
vs. FBS non-Power 5,2014,Wake Forest,1,2,3,0.3333333333333333
in August/September,2014,Wake Forest,2,3,5,0.4
in October,2014,Wake Forest,0,3,3,0.0
in November,2014,Wake Forest,1,3,4,0.25
in December/January,2014,Wake Forest,0,0,0,
All Games,2015,Wake Forest,3,9,12,0.25
at Home,2015,Wake Forest,1,5,6,0.16666666666666666
on Road/Neutral Site,2015,Wake Forest,2,4,6,0.3333333333333333
vs. Conference,2015,Wake Forest,1,7,8,0.125
vs. Non-Conference,2015,Wake Forest,2,2,4,0.5
vs. Ranked (AP),2015,Wake Forest,0,4,4,0.0
vs. Unranked (AP),2015,Wake Forest,3,5,8,0.375
vs. FBS (I-A),2015,Wake Forest,2,9,11,0.18181818181818182
vs. FCS (I-AA),2015,Wake Forest,1,0,1,1.0
vs. FBS Winning,2015,Wake Forest,0,7,7,0.0
vs. FBS Non-Winning,2015,Wake Forest,2,2,4,0.5
vs. BCS AQ,2015,Wake Forest,1,9,10,0.1
vs. BCS non-AQ,2015,Wake Forest,1,0,1,1.0
vs. FBS Power 5,2015,Wake Forest,1,8,9,0.1111111111111111
vs. FBS non-Power 5,2015,Wake Forest,1,1,2,0.5
in August/September,2015,Wake Forest,2,2,4,0.5
in October,2015,Wake Forest,1,4,5,0.2
in November,2015,Wake Forest,0,3,3,0.0
in December/January,2015,Wake Forest,0,0,0,
All Games,2016,Wake Forest,7,6,13,0.5384615384615384
at Home,2016,Wake Forest,4,3,7,0.5714285714285714
on Road/Neutral Site,2016,Wake Forest,3,3,6,0.5
vs. Conference,2016,Wake Forest,3,5,8,0.375
vs. Non-Conference,2016,Wake Forest,4,1,5,0.8
vs. Ranked (AP),2016,Wake Forest,1,3,4,0.25
vs. Unranked (AP),2016,Wake Forest,6,3,9,0.6666666666666666
vs. FBS (I-A),2016,Wake Forest,6,6,12,0.5
vs. FCS (I-AA),2016,Wake Forest,1,0,1,1.0
vs. FBS Winning,2016,Wake Forest,1,6,7,0.14285714285714285
vs. FBS Non-Winning,2016,Wake Forest,5,0,5,1.0
vs. BCS AQ,2016,Wake Forest,6,5,11,0.5454545454545454
vs. BCS non-AQ,2016,Wake Forest,0,1,1,0.0
vs. FBS Power 5,2016,Wake Forest,4,5,9,0.4444444444444444
vs. FBS non-Power 5,2016,Wake Forest,2,1,3,0.6666666666666666
in August/September,2016,Wake Forest,4,0,4,1.0
in October,2016,Wake Forest,1,3,4,0.25
in November,2016,Wake Forest,1,3,4,0.25
in December/January,2016,Wake Forest,1,0,1,1.0
All Games,2017,Wake Forest,8,5,13,0.6153846153846154
at Home,2017,Wake Forest,4,2,6,0.6666666666666666
on Road/Neutral Site,2017,Wake Forest,4,3,7,0.5714285714285714
vs. Conference,2017,Wake Forest,4,4,8,0.5
vs. Non-Conference,2017,Wake Forest,4,1,5,0.8
vs. Ranked (AP),2017,Wake Forest,1,2,3,0.3333333333333333
vs. Unranked (AP),2017,Wake Forest,7,3,10,0.7
vs. FBS (I-A),2017,Wake Forest,7,5,12,0.5833333333333334
vs. FCS (I-AA),2017,Wake Forest,1,0,1,1.0
vs. FBS Winning,2017,Wake Forest,5,4,9,0.5555555555555556
vs. FBS Non-Winning,2017,Wake Forest,2,1,3,0.6666666666666666
vs. BCS AQ,2017,Wake Forest,5,5,10,0.5
vs. BCS non-AQ,2017,Wake Forest,2,0,2,1.0
vs. FBS Power 5,2017,Wake Forest,5,4,9,0.5555555555555556
vs. FBS non-Power 5,2017,Wake Forest,2,1,3,0.6666666666666666
in August/September,2017,Wake Forest,4,1,5,0.8
in October,2017,Wake Forest,1,2,3,0.3333333333333333
in November,2017,Wake Forest,2,2,4,0.5
in December/January,2017,Wake Forest,1,0,1,1.0
All Games,2018,Wake Forest,7,6,13,0.5384615384615384
at Home,2018,Wake Forest,2,5,7,0.2857142857142857
on Road/Neutral Site,2018,Wake Forest,5,1,6,0.8333333333333334
vs. Conference,2018,Wake Forest,3,5,8,0.375
vs. Non-Conference,2018,Wake Forest,4,1,5,0.8
vs. Ranked (AP),2018,Wake Forest,0,3,3,0.0
vs. Unranked (AP),2018,Wake Forest,7,3,10,0.7
vs. FBS (I-A),2018,Wake Forest,6,6,12,0.5
vs. FCS (I-AA),2018,Wake Forest,1,0,1,1.0
vs. FBS Winning,2018,Wake Forest,4,4,8,0.5
vs. FBS Non-Winning,2018,Wake Forest,2,2,4,0.5
vs. BCS AQ,2018,Wake Forest,5,6,11,0.45454545454545453
vs. BCS non-AQ,2018,Wake Forest,1,0,1,1.0
vs. FBS Power 5,2018,Wake Forest,3,5,8,0.375
vs. FBS non-Power 5,2018,Wake Forest,3,1,4,0.75
in August/September,2018,Wake Forest,3,2,5,0.6
in October,2018,Wake Forest,1,2,3,0.3333333333333333
in November,2018,Wake Forest,2,2,4,0.5
in December/January,2018,Wake Forest,1,0,1,1.0
All Games,2019,Wake Forest,8,5,13,0.6153846153846154
at Home,2019,Wake Forest,6,1,7,0.8571428571428571
on Road/Neutral Site,2019,Wake Forest,2,4,6,0.3333333333333333
vs. Conference,2019,Wake Forest,5,4,9,0.5555555555555556
vs. Non-Conference,2019,Wake Forest,3,1,4,0.75
vs. Ranked (AP),2019,Wake Forest,0,1,1,0.0
vs. Unranked (AP),2019,Wake Forest,8,4,12,0.6666666666666666
vs. FBS (I-A),2019,Wake Forest,7,5,12,0.5833333333333334
vs. FCS (I-AA),2019,Wake Forest,1,0,1,1.0
vs. FBS Winning,2019,Wake Forest,2,4,6,0.3333333333333333
vs. FBS Non-Winning,2019,Wake Forest,5,1,6,0.8333333333333334
vs. BCS AQ,2019,Wake Forest,5,5,10,0.5
vs. BCS non-AQ,2019,Wake Forest,2,0,2,1.0
vs. FBS Power 5,2019,Wake Forest,5,5,10,0.5
vs. FBS non-Power 5,2019,Wake Forest,2,0,2,1.0
in August/September,2019,Wake Forest,5,0,5,1.0
in October,2019,Wake Forest,1,1,2,0.5
in November,2019,Wake Forest,2,3,5,0.4
in December/January,2019,Wake Forest,0,1,1,0.0
All Games,2020,Wake Forest,4,5,9,0.4444444444444444
at Home,2020,Wake Forest,3,1,4,0.75
on Road/Neutral Site,2020,Wake Forest,1,4,5,0.2
vs. Conference,2020,Wake Forest,3,4,7,0.42857142857142855
vs. Non-Conference,2020,Wake Forest,1,1,2,0.5
vs. Ranked (AP),2020,Wake Forest,0,3,3,0.0
vs. Unranked (AP),2020,Wake Forest,4,2,6,0.6666666666666666
vs. FBS (I-A),2020,Wake Forest,3,5,8,0.375
vs. FCS (I-AA),2020,Wake Forest,1,0,1,1.0
vs. FBS Winning,2020,Wake Forest,0,4,4,0.0
vs. FBS Non-Winning,2020,Wake Forest,3,1,4,0.75
vs. BCS AQ,2020,Wake Forest,3,5,8,0.375
vs. BCS non-AQ,2020,Wake Forest,0,0,0,
vs. FBS Power 5,2020,Wake Forest,3,5,8,0.375
vs. FBS non-Power 5,2020,Wake Forest,0,0,0,
in August/September,2020,Wake Forest,0,2,2,0.0
in October,2020,Wake Forest,4,0,4,1.0
in November,2020,Wake Forest,0,1,1,0.0
in December/January,2020,Wake Forest,0,2,2,0.0
All Games,2021,Wake Forest,11,3,14,0.7857142857142857
at Home,2021,Wake Forest,6,0,6,1.0
on Road/Neutral Site,2021,Wake Forest,5,3,8,0.625
vs. Conference,2021,Wake Forest,7,3,10,0.7
vs. Non-Conference,2021,Wake Forest,4,0,4,1.0
vs. Ranked (AP),2021,Wake Forest,1,2,3,0.3333333333333333
vs. Unranked (AP),2021,Wake Forest,10,1,11,0.9090909090909091
vs. FBS (I-A),2021,Wake Forest,10,3,13,0.7692307692307693
vs. FCS (I-AA),2021,Wake Forest,1,0,1,1.0
vs. FBS Winning,2021,Wake Forest,2,2,4,0.5
vs. FBS Non-Winning,2021,Wake Forest,8,1,9,0.8888888888888888
vs. BCS AQ,2021,Wake Forest,8,3,11,0.7272727272727273
vs. BCS non-AQ,2021,Wake Forest,2,0,2,1.0
vs. FBS Power 5,2021,Wake Forest,8,3,11,0.7272727272727273
vs. FBS non-Power 5,2021,Wake Forest,2,0,2,1.0
in August/September,2021,Wake Forest,4,0,4,1.0
in October,2021,Wake Forest,4,0,4,1.0
in November,2021,Wake Forest,2,2,4,0.5
in December/January,2021,Wake Forest,1,1,2,0.5
All Games,2022,Wake Forest,8,5,13,0.6153846153846154
at Home,2022,Wake Forest,5,2,7,0.7142857142857143
on Road/Neutral Site,2022,Wake Forest,3,3,6,0.5
vs. Conference,2022,Wake Forest,3,5,8,0.375
vs. Non-Conference,2022,Wake Forest,5,0,5,1.0
vs. Ranked (AP),2022,Wake Forest,1,1,2,0.5
vs. Unranked (AP),2022,Wake Forest,7,4,11,0.6363636363636364
vs. FBS (I-A),2022,Wake Forest,7,5,12,0.5833333333333334
vs. FCS (I-AA),2022,Wake Forest,1,0,1,1.0
vs. FBS Winning,2022,Wake Forest,3,5,8,0.375
vs. FBS Non-Winning,2022,Wake Forest,4,0,4,1.0
vs. BCS AQ,2022,Wake Forest,5,5,10,0.5
vs. BCS non-AQ,2022,Wake Forest,2,0,2,1.0
vs. FBS Power 5,2022,Wake Forest,5,5,10,0.5
vs. FBS non-Power 5,2022,Wake Forest,2,0,2,1.0
in August/September,2022,Wake Forest,3,1,4,0.75
in October,2022,Wake Forest,3,1,4,0.75
in November,2022,Wake Forest,1,3,4,0.25
in December/January,2022,Wake Forest,1,0,1,1.0
All Games,2009,Washington,5,7,12,0.4166666666666667
at Home,2009,Washington,5,2,7,0.7142857142857143
on Road/Neutral Site,2009,Washington,0,5,5,0.0
vs. Conference,2009,Washington,4,5,9,0.4444444444444444
vs. Non-Conference,2009,Washington,1,2,3,0.3333333333333333
vs. Ranked (AP),2009,Washington,1,2,3,0.3333333333333333
vs. Unranked (AP),2009,Washington,4,5,9,0.4444444444444444
vs. FBS (I-A),2009,Washington,5,7,12,0.4166666666666667
vs. FCS (I-AA),2009,Washington,0,0,0,
vs. FBS Winning,2009,Washington,4,5,9,0.4444444444444444
vs. FBS Non-Winning,2009,Washington,1,2,3,0.3333333333333333
vs. BCS AQ,2009,Washington,4,7,11,0.36363636363636365
vs. BCS non-AQ,2009,Washington,1,0,1,1.0
vs. FBS Power 5,2009,Washington,4,6,10,0.4
vs. FBS non-Power 5,2009,Washington,1,1,2,0.5
in August/September,2009,Washington,2,2,4,0.5
in October,2009,Washington,1,3,4,0.25
in November,2009,Washington,1,2,3,0.3333333333333333
in December/January,2009,Washington,1,0,1,1.0
All Games,2010,Washington,7,6,13,0.5384615384615384
at Home,2010,Washington,3,3,6,0.5
on Road/Neutral Site,2010,Washington,4,3,7,0.5714285714285714
vs. Conference,2010,Washington,5,4,9,0.5555555555555556
vs. Non-Conference,2010,Washington,2,2,4,0.5
vs. Ranked (AP),2010,Washington,1,3,4,0.25
vs. Unranked (AP),2010,Washington,6,3,9,0.6666666666666666
vs. FBS (I-A),2010,Washington,7,6,13,0.5384615384615384
vs. FCS (I-AA),2010,Washington,0,0,0,
vs. FBS Winning,2010,Washington,3,5,8,0.375
vs. FBS Non-Winning,2010,Washington,4,1,5,0.8
vs. BCS AQ,2010,Washington,7,5,12,0.5833333333333334
vs. BCS non-AQ,2010,Washington,0,1,1,0.0
vs. FBS Power 5,2010,Washington,6,5,11,0.5454545454545454
vs. FBS non-Power 5,2010,Washington,1,1,2,0.5
in August/September,2010,Washington,1,2,3,0.3333333333333333
in October,2010,Washington,2,3,5,0.4
in November,2010,Washington,2,1,3,0.6666666666666666
in December/January,2010,Washington,2,0,2,1.0
All Games,2011,Washington,7,6,13,0.5384615384615384
at Home,2011,Washington,5,1,6,0.8333333333333334
on Road/Neutral Site,2011,Washington,2,5,7,0.2857142857142857
vs. Conference,2011,Washington,5,4,9,0.5555555555555556
vs. Non-Conference,2011,Washington,2,2,4,0.5
vs. Ranked (AP),2011,Washington,0,5,5,0.0
vs. Unranked (AP),2011,Washington,7,1,8,0.875
vs. FBS (I-A),2011,Washington,6,6,12,0.5
vs. FCS (I-AA),2011,Washington,1,0,1,1.0
vs. FBS Winning,2011,Washington,2,5,7,0.2857142857142857
vs. FBS Non-Winning,2011,Washington,4,1,5,0.8
vs. BCS AQ,2011,Washington,5,6,11,0.45454545454545453
vs. BCS non-AQ,2011,Washington,1,0,1,1.0
vs. FBS Power 5,2011,Washington,5,6,11,0.45454545454545453
vs. FBS non-Power 5,2011,Washington,1,0,1,1.0
in August/September,2011,Washington,3,1,4,0.75
in October,2011,Washington,3,1,4,0.75
in November,2011,Washington,1,3,4,0.25
in December/January,2011,Washington,0,1,1,0.0
All Games,2012,Washington,7,6,13,0.5384615384615384
at Home,2012,Washington,5,1,6,0.8333333333333334
on Road/Neutral Site,2012,Washington,2,5,7,0.2857142857142857
vs. Conference,2012,Washington,5,4,9,0.5555555555555556
vs. Non-Conference,2012,Washington,2,2,4,0.5
vs. Ranked (AP),2012,Washington,2,3,5,0.4
vs. Unranked (AP),2012,Washington,5,3,8,0.625
vs. FBS (I-A),2012,Washington,6,6,12,0.5
vs. FCS (I-AA),2012,Washington,1,0,1,1.0
vs. FBS Winning,2012,Washington,3,5,8,0.375
vs. FBS Non-Winning,2012,Washington,3,1,4,0.75
vs. BCS AQ,2012,Washington,5,5,10,0.5
vs. BCS non-AQ,2012,Washington,1,1,2,0.5
vs. FBS Power 5,2012,Washington,5,5,10,0.5
vs. FBS non-Power 5,2012,Washington,1,1,2,0.5
in August/September,2012,Washington,3,1,4,0.75
in October,2012,Washington,1,3,4,0.25
in November,2012,Washington,3,1,4,0.75
in December/January,2012,Washington,0,1,1,0.0
All Games,2013,Washington,9,4,13,0.6923076923076923
at Home,2013,Washington,6,1,7,0.8571428571428571
on Road/Neutral Site,2013,Washington,3,3,6,0.5
vs. Conference,2013,Washington,5,4,9,0.5555555555555556
vs. Non-Conference,2013,Washington,4,0,4,1.0
vs. Ranked (AP),2013,Washington,0,4,4,0.0
vs. Unranked (AP),2013,Washington,9,0,9,1.0
vs. FBS (I-A),2013,Washington,8,4,12,0.6666666666666666
vs. FCS (I-AA),2013,Washington,1,0,1,1.0
vs. FBS Winning,2013,Washington,4,4,8,0.5
vs. FBS Non-Winning,2013,Washington,4,0,4,1.0
vs. BCS AQ,2013,Washington,6,4,10,0.6
vs. BCS non-AQ,2013,Washington,2,0,2,1.0
vs. FBS Power 5,2013,Washington,6,4,10,0.6
vs. FBS non-Power 5,2013,Washington,2,0,2,1.0
in August/September,2013,Washington,4,0,4,1.0
in October,2013,Washington,1,3,4,0.25
in November,2013,Washington,3,1,4,0.75
in December/January,2013,Washington,1,0,1,1.0
All Games,2014,Washington,8,6,14,0.5714285714285714
at Home,2014,Washington,4,3,7,0.5714285714285714
on Road/Neutral Site,2014,Washington,4,3,7,0.5714285714285714
vs. Conference,2014,Washington,4,5,9,0.4444444444444444
vs. Non-Conference,2014,Washington,4,1,5,0.8
vs. Ranked (AP),2014,Washington,0,4,4,0.0
vs. Unranked (AP),2014,Washington,8,2,10,0.8
vs. FBS (I-A),2014,Washington,7,6,13,0.5384615384615384
vs. FCS (I-AA),2014,Washington,1,0,1,1.0
vs. FBS Winning,2014,Washington,0,6,6,0.0
vs. FBS Non-Winning,2014,Washington,7,0,7,1.0
vs. BCS AQ,2014,Washington,5,6,11,0.45454545454545453
vs. BCS non-AQ,2014,Washington,2,0,2,1.0
vs. FBS Power 5,2014,Washington,5,6,11,0.45454545454545453
vs. FBS non-Power 5,2014,Washington,2,0,2,1.0
in August/September,2014,Washington,4,1,5,0.8
in October,2014,Washington,1,2,3,0.3333333333333333
in November,2014,Washington,3,2,5,0.6
in December/January,2014,Washington,0,1,1,0.0
All Games,2015,Washington,7,6,13,0.5384615384615384
at Home,2015,Washington,4,3,7,0.5714285714285714
on Road/Neutral Site,2015,Washington,3,3,6,0.5
vs. Conference,2015,Washington,4,5,9,0.4444444444444444
vs. Non-Conference,2015,Washington,3,1,4,0.75
vs. Ranked (AP),2015,Washington,0,3,3,0.0
vs. Unranked (AP),2015,Washington,7,3,10,0.7
vs. FBS (I-A),2015,Washington,6,6,12,0.5
vs. FCS (I-AA),2015,Washington,1,0,1,1.0
vs. FBS Winning,2015,Washington,4,5,9,0.4444444444444444
vs. FBS Non-Winning,2015,Washington,2,1,3,0.6666666666666666
vs. BCS AQ,2015,Washington,4,5,9,0.4444444444444444
vs. BCS non-AQ,2015,Washington,2,1,3,0.6666666666666666
vs. FBS Power 5,2015,Washington,4,5,9,0.4444444444444444
vs. FBS non-Power 5,2015,Washington,2,1,3,0.6666666666666666
in August/September,2015,Washington,2,2,4,0.5
in October,2015,Washington,2,2,4,0.5
in November,2015,Washington,2,2,4,0.5
in December/January,2015,Washington,1,0,1,1.0
All Games,2016,Washington,12,2,14,0.8571428571428571
at Home,2016,Washington,6,1,7,0.8571428571428571
on Road/Neutral Site,2016,Washington,6,1,7,0.8571428571428571
vs. Conference,2016,Washington,9,1,10,0.9
vs. Non-Conference,2016,Washington,3,1,4,0.75
vs. Ranked (AP),2016,Washington,2,2,4,0.5
vs. Unranked (AP),2016,Washington,10,0,10,1.0
vs. FBS (I-A),2016,Washington,11,2,13,0.8461538461538461
vs. FCS (I-AA),2016,Washington,1,0,1,1.0
vs. FBS Winning,2016,Washington,5,2,7,0.7142857142857143
vs. FBS Non-Winning,2016,Washington,6,0,6,1.0
vs. BCS AQ,2016,Washington,10,2,12,0.8333333333333334
vs. BCS non-AQ,2016,Washington,1,0,1,1.0
vs. FBS Power 5,2016,Washington,10,2,12,0.8333333333333334
vs. FBS non-Power 5,2016,Washington,1,0,1,1.0
in August/September,2016,Washington,5,0,5,1.0
in October,2016,Washington,3,0,3,1.0
in November,2016,Washington,3,1,4,0.75
in December/January,2016,Washington,1,1,2,0.5
All Games,2017,Washington,10,3,13,0.7692307692307693
at Home,2017,Washington,7,0,7,1.0
on Road/Neutral Site,2017,Washington,3,3,6,0.5
vs. Conference,2017,Washington,7,2,9,0.7777777777777778
vs. Non-Conference,2017,Washington,3,1,4,0.75
vs. Ranked (AP),2017,Washington,0,2,2,0.0
vs. Unranked (AP),2017,Washington,10,1,11,0.9090909090909091
vs. FBS (I-A),2017,Washington,9,3,12,0.75
vs. FCS (I-AA),2017,Washington,1,0,1,1.0
vs. FBS Winning,2017,Washington,4,3,7,0.5714285714285714
vs. FBS Non-Winning,2017,Washington,5,0,5,1.0
vs. BCS AQ,2017,Washington,8,3,11,0.7272727272727273
vs. BCS non-AQ,2017,Washington,1,0,1,1.0
vs. FBS Power 5,2017,Washington,8,3,11,0.7272727272727273
vs. FBS non-Power 5,2017,Washington,1,0,1,1.0
in August/September,2017,Washington,5,0,5,1.0
in October,2017,Washington,2,1,3,0.6666666666666666
in November,2017,Washington,3,1,4,0.75
in December/January,2017,Washington,0,1,1,0.0
All Games,2018,Washington,10,4,14,0.7142857142857143
at Home,2018,Washington,6,0,6,1.0
on Road/Neutral Site,2018,Washington,4,4,8,0.5
vs. Conference,2018,Washington,8,2,10,0.8
vs. Non-Conference,2018,Washington,2,2,4,0.5
vs. Ranked (AP),2018,Washington,1,1,2,0.5
vs. Unranked (AP),2018,Washington,9,3,12,0.75
vs. FBS (I-A),2018,Washington,9,4,13,0.6923076923076923
vs. FCS (I-AA),2018,Washington,1,0,1,1.0
vs. FBS Winning,2018,Washington,6,4,10,0.6
vs. FBS Non-Winning,2018,Washington,3,0,3,1.0
vs. BCS AQ,2018,Washington,8,4,12,0.6666666666666666
vs. BCS non-AQ,2018,Washington,1,0,1,1.0
vs. FBS Power 5,2018,Washington,8,4,12,0.6666666666666666
vs. FBS non-Power 5,2018,Washington,1,0,1,1.0
in August/September,2018,Washington,4,1,5,0.8
in October,2018,Washington,2,2,4,0.5
in November,2018,Washington,4,0,4,1.0
in December/January,2018,Washington,0,1,1,0.0
All Games,2019,Washington,8,5,13,0.6153846153846154
at Home,2019,Washington,4,3,7,0.5714285714285714
on Road/Neutral Site,2019,Washington,4,2,6,0.6666666666666666
vs. Conference,2019,Washington,4,5,9,0.4444444444444444
vs. Non-Conference,2019,Washington,4,0,4,1.0
vs. Ranked (AP),2019,Washington,1,2,3,0.3333333333333333
vs. Unranked (AP),2019,Washington,7,3,10,0.7
vs. FBS (I-A),2019,Washington,7,5,12,0.5833333333333334
vs. FCS (I-AA),2019,Washington,1,0,1,1.0
vs. FBS Winning,2019,Washington,4,3,7,0.5714285714285714
vs. FBS Non-Winning,2019,Washington,3,2,5,0.6
vs. BCS AQ,2019,Washington,4,5,9,0.4444444444444444
vs. BCS non-AQ,2019,Washington,3,0,3,1.0
vs. FBS Power 5,2019,Washington,4,5,9,0.4444444444444444
vs. FBS non-Power 5,2019,Washington,3,0,3,1.0
in August/September,2019,Washington,4,1,5,0.8
in October,2019,Washington,1,2,3,0.3333333333333333
in November,2019,Washington,2,2,4,0.5
in December/January,2019,Washington,1,0,1,1.0
All Games,2020,Washington,3,1,4,0.75
at Home,2020,Washington,3,1,4,0.75
on Road/Neutral Site,2020,Washington,0,0,0,
vs. Conference,2020,Washington,3,1,4,0.75
vs. Non-Conference,2020,Washington,0,0,0,
vs. Ranked (AP),2020,Washington,0,0,0,
vs. Unranked (AP),2020,Washington,3,1,4,0.75
vs. FBS (I-A),2020,Washington,3,1,4,0.75
vs. FCS (I-AA),2020,Washington,0,0,0,
vs. FBS Winning,2020,Washington,1,1,2,0.5
vs. FBS Non-Winning,2020,Washington,2,0,2,1.0
vs. BCS AQ,2020,Washington,3,1,4,0.75
vs. BCS non-AQ,2020,Washington,0,0,0,
vs. FBS Power 5,2020,Washington,3,1,4,0.75
vs. FBS non-Power 5,2020,Washington,0,0,0,
in August/September,2020,Washington,0,0,0,
in October,2020,Washington,0,0,0,
in November,2020,Washington,3,0,3,1.0
in December/January,2020,Washington,0,1,1,0.0
All Games,2021,Washington,4,8,12,0.3333333333333333
at Home,2021,Washington,2,5,7,0.2857142857142857
on Road/Neutral Site,2021,Washington,2,3,5,0.4
vs. Conference,2021,Washington,3,6,9,0.3333333333333333
vs. Non-Conference,2021,Washington,1,2,3,0.3333333333333333
vs. Ranked (AP),2021,Washington,0,2,2,0.0
vs. Unranked (AP),2021,Washington,4,6,10,0.4
vs. FBS (I-A),2021,Washington,4,7,11,0.36363636363636365
vs. FCS (I-AA),2021,Washington,0,1,1,0.0
vs. FBS Winning,2021,Washington,0,6,6,0.0
vs. FBS Non-Winning,2021,Washington,4,1,5,0.8
vs. BCS AQ,2021,Washington,3,7,10,0.3
vs. BCS non-AQ,2021,Washington,1,0,1,1.0
vs. FBS Power 5,2021,Washington,3,7,10,0.3
vs. FBS non-Power 5,2021,Washington,1,0,1,1.0
in August/September,2021,Washington,2,2,4,0.5
in October,2021,Washington,2,2,4,0.5
in November,2021,Washington,0,4,4,0.0
in December/January,2021,Washington,0,0,0,
All Games,2022,Washington,11,2,13,0.8461538461538461
at Home,2022,Washington,7,0,7,1.0
on Road/Neutral Site,2022,Washington,4,2,6,0.6666666666666666
vs. Conference,2022,Washington,7,2,9,0.7777777777777778
vs. Non-Conference,2022,Washington,4,0,4,1.0
vs. Ranked (AP),2022,Washington,3,1,4,0.75
vs. Unranked (AP),2022,Washington,8,1,9,0.8888888888888888
vs. FBS (I-A),2022,Washington,10,2,12,0.8333333333333334
vs. FCS (I-AA),2022,Washington,1,0,1,1.0
vs. FBS Winning,2022,Washington,4,1,5,0.8
vs. FBS Non-Winning,2022,Washington,6,1,7,0.8571428571428571
vs. BCS AQ,2022,Washington,9,2,11,0.8181818181818182
vs. BCS non-AQ,2022,Washington,1,0,1,1.0
vs. FBS Power 5,2022,Washington,9,2,11,0.8181818181818182
vs. FBS non-Power 5,2022,Washington,1,0,1,1.0
in August/September,2022,Washington,4,1,5,0.8
in October,2022,Washington,2,1,3,0.6666666666666666
in November,2022,Washington,4,0,4,1.0
in December/January,2022,Washington,1,0,1,1.0
All Games,2009,Washington State,1,11,12,0.08333333333333333
at Home,2009,Washington State,1,4,5,0.2
on Road/Neutral Site,2009,Washington State,0,7,7,0.0
vs. Conference,2009,Washington State,0,9,9,0.0
vs. Non-Conference,2009,Washington State,1,2,3,0.3333333333333333
vs. Ranked (AP),2009,Washington State,0,2,2,0.0
vs. Unranked (AP),2009,Washington State,1,9,10,0.1
vs. FBS (I-A),2009,Washington State,1,11,12,0.08333333333333333
vs. FCS (I-AA),2009,Washington State,0,0,0,
vs. FBS Winning,2009,Washington State,1,7,8,0.125
vs. FBS Non-Winning,2009,Washington State,0,4,4,0.0
vs. BCS AQ,2009,Washington State,0,10,10,0.0
vs. BCS non-AQ,2009,Washington State,1,1,2,0.5
vs. FBS Power 5,2009,Washington State,0,9,9,0.0
vs. FBS non-Power 5,2009,Washington State,1,2,3,0.3333333333333333
in August/September,2009,Washington State,1,3,4,0.25
in October,2009,Washington State,0,4,4,0.0
in November,2009,Washington State,0,4,4,0.0
in December/January,2009,Washington State,0,0,0,
All Games,2010,Washington State,2,10,12,0.16666666666666666
at Home,2010,Washington State,1,5,6,0.16666666666666666
on Road/Neutral Site,2010,Washington State,1,5,6,0.16666666666666666
vs. Conference,2010,Washington State,1,8,9,0.1111111111111111
vs. Non-Conference,2010,Washington State,1,2,3,0.3333333333333333
vs. Ranked (AP),2010,Washington State,0,3,3,0.0
vs. Unranked (AP),2010,Washington State,2,7,9,0.2222222222222222
vs. FBS (I-A),2010,Washington State,1,10,11,0.09090909090909091
vs. FCS (I-AA),2010,Washington State,1,0,1,1.0
vs. FBS Winning,2010,Washington State,0,6,6,0.0
vs. FBS Non-Winning,2010,Washington State,1,4,5,0.2
vs. BCS AQ,2010,Washington State,1,9,10,0.1
vs. BCS non-AQ,2010,Washington State,0,1,1,0.0
vs. FBS Power 5,2010,Washington State,1,9,10,0.1
vs. FBS non-Power 5,2010,Washington State,0,1,1,0.0
in August/September,2010,Washington State,1,3,4,0.25
in October,2010,Washington State,0,5,5,0.0
in November,2010,Washington State,1,1,2,0.5
in December/January,2010,Washington State,0,1,1,0.0
All Games,2011,Washington State,4,8,12,0.3333333333333333
at Home,2011,Washington State,3,3,6,0.5
on Road/Neutral Site,2011,Washington State,1,5,6,0.16666666666666666
vs. Conference,2011,Washington State,2,7,9,0.2222222222222222
vs. Non-Conference,2011,Washington State,2,1,3,0.6666666666666666
vs. Ranked (AP),2011,Washington State,0,2,2,0.0
vs. Unranked (AP),2011,Washington State,4,6,10,0.4
vs. FBS (I-A),2011,Washington State,3,8,11,0.2727272727272727
vs. FCS (I-AA),2011,Washington State,1,0,1,1.0
vs. FBS Winning,2011,Washington State,0,6,6,0.0
vs. FBS Non-Winning,2011,Washington State,3,2,5,0.6
vs. BCS AQ,2011,Washington State,2,7,9,0.2222222222222222
vs. BCS non-AQ,2011,Washington State,1,1,2,0.5
vs. FBS Power 5,2011,Washington State,2,7,9,0.2222222222222222
vs. FBS non-Power 5,2011,Washington State,1,1,2,0.5
in August/September,2011,Washington State,2,1,3,0.6666666666666666
in October,2011,Washington State,1,4,5,0.2
in November,2011,Washington State,1,3,4,0.25
in December/January,2011,Washington State,0,0,0,
All Games,2012,Washington State,3,9,12,0.25
at Home,2012,Washington State,2,3,5,0.4
on Road/Neutral Site,2012,Washington State,1,6,7,0.14285714285714285
vs. Conference,2012,Washington State,1,8,9,0.1111111111111111
vs. Non-Conference,2012,Washington State,2,1,3,0.6666666666666666
vs. Ranked (AP),2012,Washington State,0,3,3,0.0
vs. Unranked (AP),2012,Washington State,3,6,9,0.3333333333333333
vs. FBS (I-A),2012,Washington State,2,9,11,0.18181818181818182
vs. FCS (I-AA),2012,Washington State,1,0,1,1.0
vs. FBS Winning,2012,Washington State,1,6,7,0.14285714285714285
vs. FBS Non-Winning,2012,Washington State,1,3,4,0.25
vs. BCS AQ,2012,Washington State,1,8,9,0.1111111111111111
vs. BCS non-AQ,2012,Washington State,1,1,2,0.5
vs. FBS Power 5,2012,Washington State,1,8,9,0.1111111111111111
vs. FBS non-Power 5,2012,Washington State,1,1,2,0.5
in August/September,2012,Washington State,2,3,5,0.4
in October,2012,Washington State,0,3,3,0.0
in November,2012,Washington State,1,3,4,0.25
in December/January,2012,Washington State,0,0,0,
All Games,2013,Washington State,6,7,13,0.46153846153846156
at Home,2013,Washington State,3,2,5,0.6
on Road/Neutral Site,2013,Washington State,3,5,8,0.375
vs. Conference,2013,Washington State,4,5,9,0.4444444444444444
vs. Non-Conference,2013,Washington State,2,2,4,0.5
vs. Ranked (AP),2013,Washington State,1,5,6,0.16666666666666666
vs. Unranked (AP),2013,Washington State,5,2,7,0.7142857142857143
vs. FBS (I-A),2013,Washington State,5,7,12,0.4166666666666667
vs. FCS (I-AA),2013,Washington State,1,0,1,1.0
vs. FBS Winning,2013,Washington State,2,7,9,0.2222222222222222
vs. FBS Non-Winning,2013,Washington State,3,0,3,1.0
vs. BCS AQ,2013,Washington State,4,6,10,0.4
vs. BCS non-AQ,2013,Washington State,1,1,2,0.5
vs. FBS Power 5,2013,Washington State,4,6,10,0.4
vs. FBS non-Power 5,2013,Washington State,1,1,2,0.5
in August/September,2013,Washington State,3,2,5,0.6
in October,2013,Washington State,1,3,4,0.25
in November,2013,Washington State,2,1,3,0.6666666666666666
in December/January,2013,Washington State,0,1,1,0.0
All Games,2014,Washington State,3,9,12,0.25
at Home,2014,Washington State,1,5,6,0.16666666666666666
on Road/Neutral Site,2014,Washington State,2,4,6,0.3333333333333333
vs. Conference,2014,Washington State,2,7,9,0.2222222222222222
vs. Non-Conference,2014,Washington State,1,2,3,0.3333333333333333
vs. Ranked (AP),2014,Washington State,1,4,5,0.2
vs. Unranked (AP),2014,Washington State,2,5,7,0.2857142857142857
vs. FBS (I-A),2014,Washington State,2,9,11,0.18181818181818182
vs. FCS (I-AA),2014,Washington State,1,0,1,1.0
vs. FBS Winning,2014,Washington State,1,8,9,0.1111111111111111
vs. FBS Non-Winning,2014,Washington State,1,1,2,0.5
vs. BCS AQ,2014,Washington State,2,8,10,0.2
vs. BCS non-AQ,2014,Washington State,0,1,1,0.0
vs. FBS Power 5,2014,Washington State,2,8,10,0.2
vs. FBS non-Power 5,2014,Washington State,0,1,1,0.0
in August/September,2014,Washington State,2,3,5,0.4
in October,2014,Washington State,0,3,3,0.0
in November,2014,Washington State,1,3,4,0.25
in December/January,2014,Washington State,0,0,0,
All Games,2015,Washington State,9,4,13,0.6923076923076923
at Home,2015,Washington State,4,2,6,0.6666666666666666
on Road/Neutral Site,2015,Washington State,5,2,7,0.7142857142857143
vs. Conference,2015,Washington State,6,3,9,0.6666666666666666
vs. Non-Conference,2015,Washington State,3,1,4,0.75
vs. Ranked (AP),2015,Washington State,1,1,2,0.5
vs. Unranked (AP),2015,Washington State,8,3,11,0.7272727272727273
vs. FBS (I-A),2015,Washington State,9,3,12,0.75
vs. FCS (I-AA),2015,Washington State,0,1,1,0.0
vs. FBS Winning,2015,Washington State,4,3,7,0.5714285714285714
vs. FBS Non-Winning,2015,Washington State,5,0,5,1.0
vs. BCS AQ,2015,Washington State,8,3,11,0.7272727272727273
vs. BCS non-AQ,2015,Washington State,1,0,1,1.0
vs. FBS Power 5,2015,Washington State,8,3,11,0.7272727272727273
vs. FBS non-Power 5,2015,Washington State,1,0,1,1.0
in August/September,2015,Washington State,2,1,3,0.6666666666666666
in October,2015,Washington State,3,2,5,0.6
in November,2015,Washington State,3,1,4,0.75
in December/January,2015,Washington State,1,0,1,1.0
All Games,2016,Washington State,8,5,13,0.6153846153846154
at Home,2016,Washington State,5,2,7,0.7142857142857143
on Road/Neutral Site,2016,Washington State,3,3,6,0.5
vs. Conference,2016,Washington State,7,2,9,0.7777777777777778
vs. Non-Conference,2016,Washington State,1,3,4,0.25
vs. Ranked (AP),2016,Washington State,1,2,3,0.3333333333333333
vs. Unranked (AP),2016,Washington State,7,3,10,0.7
vs. FBS (I-A),2016,Washington State,8,4,12,0.6666666666666666
vs. FCS (I-AA),2016,Washington State,0,1,1,0.0
vs. FBS Winning,2016,Washington State,2,4,6,0.3333333333333333
vs. FBS Non-Winning,2016,Washington State,6,0,6,1.0
vs. BCS AQ,2016,Washington State,7,3,10,0.7
vs. BCS non-AQ,2016,Washington State,1,1,2,0.5
vs. FBS Power 5,2016,Washington State,7,3,10,0.7
vs. FBS non-Power 5,2016,Washington State,1,1,2,0.5
in August/September,2016,Washington State,1,2,3,0.3333333333333333
in October,2016,Washington State,5,0,5,1.0
in November,2016,Washington State,2,2,4,0.5
in December/January,2016,Washington State,0,1,1,0.0
All Games,2017,Washington State,9,4,13,0.6923076923076923
at Home,2017,Washington State,7,0,7,1.0
on Road/Neutral Site,2017,Washington State,2,4,6,0.3333333333333333
vs. Conference,2017,Washington State,6,3,9,0.6666666666666666
vs. Non-Conference,2017,Washington State,3,1,4,0.75
vs. Ranked (AP),2017,Washington State,3,2,5,0.6
vs. Unranked (AP),2017,Washington State,6,2,8,0.75
vs. FBS (I-A),2017,Washington State,8,4,12,0.6666666666666666
vs. FCS (I-AA),2017,Washington State,1,0,1,1.0
vs. FBS Winning,2017,Washington State,5,3,8,0.625
vs. FBS Non-Winning,2017,Washington State,3,1,4,0.75
vs. BCS AQ,2017,Washington State,6,4,10,0.6
vs. BCS non-AQ,2017,Washington State,2,0,2,1.0
vs. FBS Power 5,2017,Washington State,6,4,10,0.6
vs. FBS non-Power 5,2017,Washington State,2,0,2,1.0
in August/September,2017,Washington State,5,0,5,1.0
in October,2017,Washington State,2,2,4,0.5
in November,2017,Washington State,2,1,3,0.6666666666666666
in December/January,2017,Washington State,0,1,1,0.0
All Games,2018,Washington State,11,2,13,0.8461538461538461
at Home,2018,Washington State,6,1,7,0.8571428571428571
on Road/Neutral Site,2018,Washington State,5,1,6,0.8333333333333334
vs. Conference,2018,Washington State,7,2,9,0.7777777777777778
vs. Non-Conference,2018,Washington State,4,0,4,1.0
vs. Ranked (AP),2018,Washington State,0,1,1,0.0
vs. Unranked (AP),2018,Washington State,11,1,12,0.9166666666666666
vs. FBS (I-A),2018,Washington State,10,2,12,0.8333333333333334
vs. FCS (I-AA),2018,Washington State,1,0,1,1.0
vs. FBS Winning,2018,Washington State,5,1,6,0.8333333333333334
vs. FBS Non-Winning,2018,Washington State,5,1,6,0.8333333333333334
vs. BCS AQ,2018,Washington State,8,2,10,0.8
vs. BCS non-AQ,2018,Washington State,2,0,2,1.0
vs. FBS Power 5,2018,Washington State,8,2,10,0.8
vs. FBS non-Power 5,2018,Washington State,2,0,2,1.0
in August/September,2018,Washington State,4,1,5,0.8
in October,2018,Washington State,3,0,3,1.0
in November,2018,Washington State,3,1,4,0.75
in December/January,2018,Washington State,1,0,1,1.0
All Games,2019,Washington State,6,7,13,0.46153846153846156
at Home,2019,Washington State,5,1,6,0.8333333333333334
on Road/Neutral Site,2019,Washington State,1,6,7,0.14285714285714285
vs. Conference,2019,Washington State,3,6,9,0.3333333333333333
vs. Non-Conference,2019,Washington State,3,1,4,0.75
vs. Ranked (AP),2019,Washington State,0,3,3,0.0
vs. Unranked (AP),2019,Washington State,6,4,10,0.6
vs. FBS (I-A),2019,Washington State,5,7,12,0.4166666666666667
vs. FCS (I-AA),2019,Washington State,1,0,1,1.0
vs. FBS Winning,2019,Washington State,0,6,6,0.0
vs. FBS Non-Winning,2019,Washington State,5,1,6,0.8333333333333334
vs. BCS AQ,2019,Washington State,4,6,10,0.4
vs. BCS non-AQ,2019,Washington State,1,1,2,0.5
vs. FBS Power 5,2019,Washington State,3,6,9,0.3333333333333333
vs. FBS non-Power 5,2019,Washington State,2,1,3,0.6666666666666666
in August/September,2019,Washington State,3,2,5,0.6
in October,2019,Washington State,1,2,3,0.3333333333333333
in November,2019,Washington State,2,2,4,0.5
in December/January,2019,Washington State,0,1,1,0.0
All Games,2020,Washington State,1,3,4,0.25
at Home,2020,Washington State,0,1,1,0.0
on Road/Neutral Site,2020,Washington State,1,2,3,0.3333333333333333
vs. Conference,2020,Washington State,1,3,4,0.25
vs. Non-Conference,2020,Washington State,0,0,0,
vs. Ranked (AP),2020,Washington State,0,2,2,0.0
vs. Unranked (AP),2020,Washington State,1,1,2,0.5
vs. FBS (I-A),2020,Washington State,1,3,4,0.25
vs. FCS (I-AA),2020,Washington State,0,0,0,
vs. FBS Winning,2020,Washington State,0,3,3,0.0
vs. FBS Non-Winning,2020,Washington State,1,0,1,1.0
vs. BCS AQ,2020,Washington State,1,3,4,0.25
vs. BCS non-AQ,2020,Washington State,0,0,0,
vs. FBS Power 5,2020,Washington State,1,3,4,0.25
vs. FBS non-Power 5,2020,Washington State,0,0,0,
in August/September,2020,Washington State,0,0,0,
in October,2020,Washington State,0,0,0,
in November,2020,Washington State,1,1,2,0.5
in December/January,2020,Washington State,0,2,2,0.0
All Games,2021,Washington State,7,6,13,0.5384615384615384
at Home,2021,Washington State,4,3,7,0.5714285714285714
on Road/Neutral Site,2021,Washington State,3,3,6,0.5
vs. Conference,2021,Washington State,6,3,9,0.6666666666666666
vs. Non-Conference,2021,Washington State,1,3,4,0.25
vs. Ranked (AP),2021,Washington State,0,4,4,0.0
vs. Unranked (AP),2021,Washington State,7,2,9,0.7777777777777778
vs. FBS (I-A),2021,Washington State,6,6,12,0.5
vs. FCS (I-AA),2021,Washington State,1,0,1,1.0
vs. FBS Winning,2021,Washington State,2,5,7,0.2857142857142857
vs. FBS Non-Winning,2021,Washington State,4,1,5,0.8
vs. BCS AQ,2021,Washington State,6,3,9,0.6666666666666666
vs. BCS non-AQ,2021,Washington State,0,3,3,0.0
vs. FBS Power 5,2021,Washington State,6,3,9,0.6666666666666666
vs. FBS non-Power 5,2021,Washington State,0,3,3,0.0
in August/September,2021,Washington State,1,3,4,0.25
in October,2021,Washington State,4,1,5,0.8
in November,2021,Washington State,2,1,3,0.6666666666666666
in December/January,2021,Washington State,0,1,1,0.0
All Games,2022,Washington State,7,6,13,0.5384615384615384
at Home,2022,Washington State,4,3,7,0.5714285714285714
on Road/Neutral Site,2022,Washington State,3,3,6,0.5
vs. Conference,2022,Washington State,4,5,9,0.4444444444444444
vs. Non-Conference,2022,Washington State,3,1,4,0.75
vs. Ranked (AP),2022,Washington State,0,6,6,0.0
vs. Unranked (AP),2022,Washington State,7,0,7,1.0
vs. FBS (I-A),2022,Washington State,6,6,12,0.5
vs. FCS (I-AA),2022,Washington State,1,0,1,1.0
vs. FBS Winning,2022,Washington State,1,6,7,0.14285714285714285
vs. FBS Non-Winning,2022,Washington State,5,0,5,1.0
vs. BCS AQ,2022,Washington State,5,5,10,0.5
vs. BCS non-AQ,2022,Washington State,1,1,2,0.5
vs. FBS Power 5,2022,Washington State,5,5,10,0.5
vs. FBS non-Power 5,2022,Washington State,1,1,2,0.5
in August/September,2022,Washington State,3,1,4,0.75
in October,2022,Washington State,1,3,4,0.25
in November,2022,Washington State,3,1,4,0.75
in December/January,2022,Washington State,0,1,1,0.0
All Games,2009,West Virginia,9,4,13,0.6923076923076923
at Home,2009,West Virginia,7,0,7,1.0
on Road/Neutral Site,2009,West Virginia,2,4,6,0.3333333333333333
vs. Conference,2009,West Virginia,5,2,7,0.7142857142857143
vs. Non-Conference,2009,West Virginia,4,2,6,0.6666666666666666
vs. Ranked (AP),2009,West Virginia,1,1,2,0.5
vs. Unranked (AP),2009,West Virginia,8,3,11,0.7272727272727273
vs. FBS (I-A),2009,West Virginia,8,4,12,0.6666666666666666
vs. FCS (I-AA),2009,West Virginia,1,0,1,1.0
vs. FBS Winning,2009,West Virginia,5,4,9,0.5555555555555556
vs. FBS Non-Winning,2009,West Virginia,3,0,3,1.0
vs. BCS AQ,2009,West Virginia,6,4,10,0.6
vs. BCS non-AQ,2009,West Virginia,2,0,2,1.0
vs. FBS Power 5,2009,West Virginia,1,2,3,0.3333333333333333
vs. FBS non-Power 5,2009,West Virginia,7,2,9,0.7777777777777778
in August/September,2009,West Virginia,2,1,3,0.6666666666666666
in October,2009,West Virginia,4,1,5,0.8
in November,2009,West Virginia,2,1,3,0.6666666666666666
in December/January,2009,West Virginia,1,1,2,0.5
All Games,2010,West Virginia,9,4,13,0.6923076923076923
at Home,2010,West Virginia,6,1,7,0.8571428571428571
on Road/Neutral Site,2010,West Virginia,3,3,6,0.5
vs. Conference,2010,West Virginia,5,2,7,0.7142857142857143
vs. Non-Conference,2010,West Virginia,4,2,6,0.6666666666666666
vs. Ranked (AP),2010,West Virginia,1,2,3,0.3333333333333333
vs. Unranked (AP),2010,West Virginia,8,2,10,0.8
vs. FBS (I-A),2010,West Virginia,8,4,12,0.6666666666666666
vs. FCS (I-AA),2010,West Virginia,1,0,1,1.0
vs. FBS Winning,2010,West Virginia,4,4,8,0.5
vs. FBS Non-Winning,2010,West Virginia,4,0,4,1.0
vs. BCS AQ,2010,West Virginia,6,4,10,0.6
vs. BCS non-AQ,2010,West Virginia,2,0,2,1.0
vs. FBS Power 5,2010,West Virginia,1,2,3,0.3333333333333333
vs. FBS non-Power 5,2010,West Virginia,7,2,9,0.7777777777777778
in August/September,2010,West Virginia,3,1,4,0.75
in October,2010,West Virginia,2,2,4,0.5
in November,2010,West Virginia,3,0,3,1.0
in December/January,2010,West Virginia,1,1,2,0.5
All Games,2011,West Virginia,10,3,13,0.7692307692307693
at Home,2011,West Virginia,5,2,7,0.7142857142857143
on Road/Neutral Site,2011,West Virginia,5,1,6,0.8333333333333334
vs. Conference,2011,West Virginia,5,2,7,0.7142857142857143
vs. Non-Conference,2011,West Virginia,5,1,6,0.8333333333333334
vs. Ranked (AP),2011,West Virginia,2,1,3,0.6666666666666666
vs. Unranked (AP),2011,West Virginia,8,2,10,0.8
vs. FBS (I-A),2011,West Virginia,9,3,12,0.75
vs. FCS (I-AA),2011,West Virginia,1,0,1,1.0
vs. FBS Winning,2011,West Virginia,4,2,6,0.6666666666666666
vs. FBS Non-Winning,2011,West Virginia,5,1,6,0.8333333333333334
vs. BCS AQ,2011,West Virginia,7,3,10,0.7
vs. BCS non-AQ,2011,West Virginia,2,0,2,1.0
vs. FBS Power 5,2011,West Virginia,2,1,3,0.6666666666666666
vs. FBS non-Power 5,2011,West Virginia,7,2,9,0.7777777777777778
in August/September,2011,West Virginia,3,1,4,0.75
in October,2011,West Virginia,3,1,4,0.75
in November,2011,West Virginia,2,1,3,0.6666666666666666
in December/January,2011,West Virginia,2,0,2,1.0
All Games,2012,West Virginia,7,6,13,0.5384615384615384
at Home,2012,West Virginia,4,3,7,0.5714285714285714
on Road/Neutral Site,2012,West Virginia,3,3,6,0.5
vs. Conference,2012,West Virginia,4,5,9,0.4444444444444444
vs. Non-Conference,2012,West Virginia,3,1,4,0.75
vs. Ranked (AP),2012,West Virginia,1,2,3,0.3333333333333333
vs. Unranked (AP),2012,West Virginia,6,4,10,0.6
vs. FBS (I-A),2012,West Virginia,6,6,12,0.5
vs. FCS (I-AA),2012,West Virginia,1,0,1,1.0
vs. FBS Winning,2012,West Virginia,2,6,8,0.25
vs. FBS Non-Winning,2012,West Virginia,4,0,4,1.0
vs. BCS AQ,2012,West Virginia,5,6,11,0.45454545454545453
vs. BCS non-AQ,2012,West Virginia,1,0,1,1.0
vs. FBS Power 5,2012,West Virginia,5,5,10,0.5
vs. FBS non-Power 5,2012,West Virginia,1,1,2,0.5
in August/September,2012,West Virginia,4,0,4,1.0
in October,2012,West Virginia,1,2,3,0.3333333333333333
in November,2012,West Virginia,1,3,4,0.25
in December/January,2012,West Virginia,1,1,2,0.5
All Games,2013,West Virginia,4,8,12,0.3333333333333333
at Home,2013,West Virginia,3,3,6,0.5
on Road/Neutral Site,2013,West Virginia,1,5,6,0.16666666666666666
vs. Conference,2013,West Virginia,2,7,9,0.2222222222222222
vs. Non-Conference,2013,West Virginia,2,1,3,0.6666666666666666
vs. Ranked (AP),2013,West Virginia,1,2,3,0.3333333333333333
vs. Unranked (AP),2013,West Virginia,3,6,9,0.3333333333333333
vs. FBS (I-A),2013,West Virginia,3,8,11,0.2727272727272727
vs. FCS (I-AA),2013,West Virginia,1,0,1,1.0
vs. FBS Winning,2013,West Virginia,1,6,7,0.14285714285714285
vs. FBS Non-Winning,2013,West Virginia,2,2,4,0.5
vs. BCS AQ,2013,West Virginia,2,8,10,0.2
vs. BCS non-AQ,2013,West Virginia,1,0,1,1.0
vs. FBS Power 5,2013,West Virginia,2,8,10,0.2
vs. FBS non-Power 5,2013,West Virginia,1,0,1,1.0
in August/September,2013,West Virginia,3,2,5,0.6
in October,2013,West Virginia,0,3,3,0.0
in November,2013,West Virginia,1,3,4,0.25
in December/January,2013,West Virginia,0,0,0,
All Games,2014,West Virginia,7,6,13,0.5384615384615384
at Home,2014,West Virginia,3,3,6,0.5
on Road/Neutral Site,2014,West Virginia,4,3,7,0.5714285714285714
vs. Conference,2014,West Virginia,5,4,9,0.5555555555555556
vs. Non-Conference,2014,West Virginia,2,2,4,0.5
vs. Ranked (AP),2014,West Virginia,1,3,4,0.25
vs. Unranked (AP),2014,West Virginia,6,3,9,0.6666666666666666
vs. FBS (I-A),2014,West Virginia,6,6,12,0.5
vs. FCS (I-AA),2014,West Virginia,1,0,1,1.0
vs. FBS Winning,2014,West Virginia,3,5,8,0.375
vs. FBS Non-Winning,2014,West Virginia,3,1,4,0.75
vs. BCS AQ,2014,West Virginia,6,6,12,0.5
vs. BCS non-AQ,2014,West Virginia,0,0,0,
vs. FBS Power 5,2014,West Virginia,6,6,12,0.5
vs. FBS non-Power 5,2014,West Virginia,0,0,0,
in August/September,2014,West Virginia,2,2,4,0.5
in October,2014,West Virginia,4,0,4,1.0
in November,2014,West Virginia,1,3,4,0.25
in December/January,2014,West Virginia,0,1,1,0.0
All Games,2015,West Virginia,8,5,13,0.6153846153846154
at Home,2015,West Virginia,6,1,7,0.8571428571428571
on Road/Neutral Site,2015,West Virginia,2,4,6,0.3333333333333333
vs. Conference,2015,West Virginia,4,5,9,0.4444444444444444
vs. Non-Conference,2015,West Virginia,4,0,4,1.0
vs. Ranked (AP),2015,West Virginia,0,4,4,0.0
vs. Unranked (AP),2015,West Virginia,8,1,9,0.8888888888888888
vs. FBS (I-A),2015,West Virginia,7,5,12,0.5833333333333334
vs. FCS (I-AA),2015,West Virginia,1,0,1,1.0
vs. FBS Winning,2015,West Virginia,2,4,6,0.3333333333333333
vs. FBS Non-Winning,2015,West Virginia,5,1,6,0.8333333333333334
vs. BCS AQ,2015,West Virginia,6,5,11,0.5454545454545454
vs. BCS non-AQ,2015,West Virginia,1,0,1,1.0
vs. FBS Power 5,2015,West Virginia,6,5,11,0.5454545454545454
vs. FBS non-Power 5,2015,West Virginia,1,0,1,1.0
in August/September,2015,West Virginia,3,0,3,1.0
in October,2015,West Virginia,0,4,4,0.0
in November,2015,West Virginia,4,0,4,1.0
in December/January,2015,West Virginia,1,1,2,0.5
All Games,2016,West Virginia,10,3,13,0.7692307692307693
at Home,2016,West Virginia,6,1,7,0.8571428571428571
on Road/Neutral Site,2016,West Virginia,4,2,6,0.6666666666666666
vs. Conference,2016,West Virginia,7,2,9,0.7777777777777778
vs. Non-Conference,2016,West Virginia,3,1,4,0.75
vs. Ranked (AP),2016,West Virginia,0,2,2,0.0
vs. Unranked (AP),2016,West Virginia,10,1,11,0.9090909090909091
vs. FBS (I-A),2016,West Virginia,9,3,12,0.75
vs. FCS (I-AA),2016,West Virginia,1,0,1,1.0
vs. FBS Winning,2016,West Virginia,3,3,6,0.5
vs. FBS Non-Winning,2016,West Virginia,6,0,6,1.0
vs. BCS AQ,2016,West Virginia,8,3,11,0.7272727272727273
vs. BCS non-AQ,2016,West Virginia,1,0,1,1.0
vs. FBS Power 5,2016,West Virginia,8,3,11,0.7272727272727273
vs. FBS non-Power 5,2016,West Virginia,1,0,1,1.0
in August/September,2016,West Virginia,3,0,3,1.0
in October,2016,West Virginia,3,1,4,0.75
in November,2016,West Virginia,3,1,4,0.75
in December/January,2016,West Virginia,1,1,2,0.5
All Games,2017,West Virginia,7,6,13,0.5384615384615384
at Home,2017,West Virginia,4,2,6,0.6666666666666666
on Road/Neutral Site,2017,West Virginia,3,4,7,0.42857142857142855
vs. Conference,2017,West Virginia,5,4,9,0.5555555555555556
vs. Non-Conference,2017,West Virginia,2,2,4,0.5
vs. Ranked (AP),2017,West Virginia,0,4,4,0.0
vs. Unranked (AP),2017,West Virginia,7,2,9,0.7777777777777778
vs. FBS (I-A),2017,West Virginia,6,6,12,0.5
vs. FCS (I-AA),2017,West Virginia,1,0,1,1.0
vs. FBS Winning,2017,West Virginia,2,6,8,0.25
vs. FBS Non-Winning,2017,West Virginia,4,0,4,1.0
vs. BCS AQ,2017,West Virginia,6,6,12,0.5
vs. BCS non-AQ,2017,West Virginia,0,0,0,
vs. FBS Power 5,2017,West Virginia,5,6,11,0.45454545454545453
vs. FBS non-Power 5,2017,West Virginia,1,0,1,1.0
in August/September,2017,West Virginia,3,1,4,0.75
in October,2017,West Virginia,2,2,4,0.5
in November,2017,West Virginia,2,2,4,0.5
in December/January,2017,West Virginia,0,1,1,0.0
All Games,2018,West Virginia,8,4,12,0.6666666666666666
at Home,2018,West Virginia,5,1,6,0.8333333333333334
on Road/Neutral Site,2018,West Virginia,3,3,6,0.5
vs. Conference,2018,West Virginia,6,3,9,0.6666666666666666
vs. Non-Conference,2018,West Virginia,2,1,3,0.6666666666666666
vs. Ranked (AP),2018,West Virginia,1,2,3,0.3333333333333333
vs. Unranked (AP),2018,West Virginia,7,2,9,0.7777777777777778
vs. FBS (I-A),2018,West Virginia,7,4,11,0.6363636363636364
vs. FCS (I-AA),2018,West Virginia,1,0,1,1.0
vs. FBS Winning,2018,West Virginia,3,4,7,0.42857142857142855
vs. FBS Non-Winning,2018,West Virginia,4,0,4,1.0
vs. BCS AQ,2018,West Virginia,7,4,11,0.6363636363636364
vs. BCS non-AQ,2018,West Virginia,0,0,0,
vs. FBS Power 5,2018,West Virginia,7,4,11,0.6363636363636364
vs. FBS non-Power 5,2018,West Virginia,0,0,0,
in August/September,2018,West Virginia,4,0,4,1.0
in October,2018,West Virginia,2,1,3,0.6666666666666666
in November,2018,West Virginia,2,2,4,0.5
in December/January,2018,West Virginia,0,1,1,0.0
All Games,2019,West Virginia,5,7,12,0.4166666666666667
at Home,2019,West Virginia,2,4,6,0.3333333333333333
on Road/Neutral Site,2019,West Virginia,3,3,6,0.5
vs. Conference,2019,West Virginia,3,6,9,0.3333333333333333
vs. Non-Conference,2019,West Virginia,2,1,3,0.6666666666666666
vs. Ranked (AP),2019,West Virginia,0,3,3,0.0
vs. Unranked (AP),2019,West Virginia,5,4,9,0.5555555555555556
vs. FBS (I-A),2019,West Virginia,4,7,11,0.36363636363636365
vs. FCS (I-AA),2019,West Virginia,1,0,1,1.0
vs. FBS Winning,2019,West Virginia,1,5,6,0.16666666666666666
vs. FBS Non-Winning,2019,West Virginia,3,2,5,0.6
vs. BCS AQ,2019,West Virginia,4,7,11,0.36363636363636365
vs. BCS non-AQ,2019,West Virginia,0,0,0,
vs. FBS Power 5,2019,West Virginia,4,7,11,0.36363636363636365
vs. FBS non-Power 5,2019,West Virginia,0,0,0,
in August/September,2019,West Virginia,3,1,4,0.75
in October,2019,West Virginia,0,4,4,0.0
in November,2019,West Virginia,2,2,4,0.5
in December/January,2019,West Virginia,0,0,0,
All Games,2020,West Virginia,6,4,10,0.6
at Home,2020,West Virginia,5,0,5,1.0
on Road/Neutral Site,2020,West Virginia,1,4,5,0.2
vs. Conference,2020,West Virginia,4,4,8,0.5
vs. Non-Conference,2020,West Virginia,2,0,2,1.0
vs. Ranked (AP),2020,West Virginia,0,2,2,0.0
vs. Unranked (AP),2020,West Virginia,6,2,8,0.75
vs. FBS (I-A),2020,West Virginia,5,4,9,0.5555555555555556
vs. FCS (I-AA),2020,West Virginia,1,0,1,1.0
vs. FBS Winning,2020,West Virginia,2,3,5,0.4
vs. FBS Non-Winning,2020,West Virginia,3,1,4,0.75
vs. BCS AQ,2020,West Virginia,4,4,8,0.5
vs. BCS non-AQ,2020,West Virginia,1,0,1,1.0
vs. FBS Power 5,2020,West Virginia,4,4,8,0.5
vs. FBS non-Power 5,2020,West Virginia,1,0,1,1.0
in August/September,2020,West Virginia,1,1,2,0.5
in October,2020,West Virginia,3,1,4,0.75
in November,2020,West Virginia,1,1,2,0.5
in December/January,2020,West Virginia,1,1,2,0.5
All Games,2021,West Virginia,6,7,13,0.46153846153846156
at Home,2021,West Virginia,4,2,6,0.6666666666666666
on Road/Neutral Site,2021,West Virginia,2,5,7,0.2857142857142857
vs. Conference,2021,West Virginia,4,5,9,0.4444444444444444
vs. Non-Conference,2021,West Virginia,2,2,4,0.5
vs. Ranked (AP),2021,West Virginia,0,3,3,0.0
vs. Unranked (AP),2021,West Virginia,6,4,10,0.6
vs. FBS (I-A),2021,West Virginia,5,7,12,0.4166666666666667
vs. FCS (I-AA),2021,West Virginia,1,0,1,1.0
vs. FBS Winning,2021,West Virginia,1,7,8,0.125
vs. FBS Non-Winning,2021,West Virginia,4,0,4,1.0
vs. BCS AQ,2021,West Virginia,5,7,12,0.4166666666666667
vs. BCS non-AQ,2021,West Virginia,0,0,0,
vs. FBS Power 5,2021,West Virginia,5,7,12,0.4166666666666667
vs. FBS non-Power 5,2021,West Virginia,0,0,0,
in August/September,2021,West Virginia,2,2,4,0.5
in October,2021,West Virginia,2,2,4,0.5
in November,2021,West Virginia,2,2,4,0.5
in December/January,2021,West Virginia,0,1,1,0.0
All Games,2022,West Virginia,5,7,12,0.4166666666666667
at Home,2022,West Virginia,3,3,6,0.5
on Road/Neutral Site,2022,West Virginia,2,4,6,0.3333333333333333
vs. Conference,2022,West Virginia,3,6,9,0.3333333333333333
vs. Non-Conference,2022,West Virginia,2,1,3,0.6666666666666666
vs. Ranked (AP),2022,West Virginia,0,4,4,0.0
vs. Unranked (AP),2022,West Virginia,5,3,8,0.625
vs. FBS (I-A),2022,West Virginia,4,7,11,0.36363636363636365
vs. FCS (I-AA),2022,West Virginia,1,0,1,1.0
vs. FBS Winning,2022,West Virginia,1,5,6,0.16666666666666666
vs. FBS Non-Winning,2022,West Virginia,3,2,5,0.6
vs. BCS AQ,2022,West Virginia,4,7,11,0.36363636363636365
vs. BCS non-AQ,2022,West Virginia,0,0,0,
vs. FBS Power 5,2022,West Virginia,4,7,11,0.36363636363636365
vs. FBS non-Power 5,2022,West Virginia,0,0,0,
in August/September,2022,West Virginia,2,2,4,0.5
in October,2022,West Virginia,1,3,4,0.25
in November,2022,West Virginia,2,2,4,0.5
in December/January,2022,West Virginia,0,0,0,
All Games,2009,Western Kentucky,0,12,12,0.0
at Home,2009,Western Kentucky,0,6,6,0.0
on Road/Neutral Site,2009,Western Kentucky,0,6,6,0.0
vs. Conference,2009,Western Kentucky,0,8,8,0.0
vs. Non-Conference,2009,Western Kentucky,0,4,4,0.0
vs. Ranked (AP),2009,Western Kentucky,0,0,0,
vs. Unranked (AP),2009,Western Kentucky,0,12,12,0.0
vs. FBS (I-A),2009,Western Kentucky,0,11,11,0.0
vs. FCS (I-AA),2009,Western Kentucky,0,1,1,0.0
vs. FBS Winning,2009,Western Kentucky,0,5,5,0.0
vs. FBS Non-Winning,2009,Western Kentucky,0,6,6,0.0
vs. BCS AQ,2009,Western Kentucky,0,2,2,0.0
vs. BCS non-AQ,2009,Western Kentucky,0,9,9,0.0
vs. FBS Power 5,2009,Western Kentucky,0,1,1,0.0
vs. FBS non-Power 5,2009,Western Kentucky,0,10,10,0.0
in August/September,2009,Western Kentucky,0,4,4,0.0
in October,2009,Western Kentucky,0,4,4,0.0
in November,2009,Western Kentucky,0,3,3,0.0
in December/January,2009,Western Kentucky,0,1,1,0.0
All Games,2010,Western Kentucky,2,10,12,0.16666666666666666
at Home,2010,Western Kentucky,0,5,5,0.0
on Road/Neutral Site,2010,Western Kentucky,2,5,7,0.2857142857142857
vs. Conference,2010,Western Kentucky,2,6,8,0.25
vs. Non-Conference,2010,Western Kentucky,0,4,4,0.0
vs. Ranked (AP),2010,Western Kentucky,0,1,1,0.0
vs. Unranked (AP),2010,Western Kentucky,2,9,11,0.18181818181818182
vs. FBS (I-A),2010,Western Kentucky,2,10,12,0.16666666666666666
vs. FCS (I-AA),2010,Western Kentucky,0,0,0,
vs. FBS Winning,2010,Western Kentucky,0,4,4,0.0
vs. FBS Non-Winning,2010,Western Kentucky,2,6,8,0.25
vs. BCS AQ,2010,Western Kentucky,0,4,4,0.0
vs. BCS non-AQ,2010,Western Kentucky,2,6,8,0.25
vs. FBS Power 5,2010,Western Kentucky,0,3,3,0.0
vs. FBS non-Power 5,2010,Western Kentucky,2,7,9,0.2222222222222222
in August/September,2010,Western Kentucky,0,4,4,0.0
in October,2010,Western Kentucky,1,3,4,0.25
in November,2010,Western Kentucky,1,3,4,0.25
in December/January,2010,Western Kentucky,0,0,0,
All Games,2011,Western Kentucky,7,5,12,0.5833333333333334
at Home,2011,Western Kentucky,3,3,6,0.5
on Road/Neutral Site,2011,Western Kentucky,4,2,6,0.6666666666666666
vs. Conference,2011,Western Kentucky,7,1,8,0.875
vs. Non-Conference,2011,Western Kentucky,0,4,4,0.0
vs. Ranked (AP),2011,Western Kentucky,0,1,1,0.0
vs. Unranked (AP),2011,Western Kentucky,7,4,11,0.6363636363636364
vs. FBS (I-A),2011,Western Kentucky,7,4,11,0.6363636363636364
vs. FCS (I-AA),2011,Western Kentucky,0,1,1,0.0
vs. FBS Winning,2011,Western Kentucky,2,2,4,0.5
vs. FBS Non-Winning,2011,Western Kentucky,5,2,7,0.7142857142857143
vs. BCS AQ,2011,Western Kentucky,0,2,2,0.0
vs. BCS non-AQ,2011,Western Kentucky,7,2,9,0.7777777777777778
vs. FBS Power 5,2011,Western Kentucky,0,2,2,0.0
vs. FBS non-Power 5,2011,Western Kentucky,7,2,9,0.7777777777777778
in August/September,2011,Western Kentucky,0,3,3,0.0
in October,2011,Western Kentucky,4,1,5,0.8
in November,2011,Western Kentucky,3,1,4,0.75
in December/January,2011,Western Kentucky,0,0,0,
All Games,2012,Western Kentucky,7,6,13,0.5384615384615384
at Home,2012,Western Kentucky,3,3,6,0.5
on Road/Neutral Site,2012,Western Kentucky,4,3,7,0.5714285714285714
vs. Conference,2012,Western Kentucky,4,4,8,0.5
vs. Non-Conference,2012,Western Kentucky,3,2,5,0.6
vs. Ranked (AP),2012,Western Kentucky,0,1,1,0.0
vs. Unranked (AP),2012,Western Kentucky,7,5,12,0.5833333333333334
vs. FBS (I-A),2012,Western Kentucky,6,6,12,0.5
vs. FCS (I-AA),2012,Western Kentucky,1,0,1,1.0
vs. FBS Winning,2012,Western Kentucky,1,5,6,0.16666666666666666
vs. FBS Non-Winning,2012,Western Kentucky,5,1,6,0.8333333333333334
vs. BCS AQ,2012,Western Kentucky,1,1,2,0.5
vs. BCS non-AQ,2012,Western Kentucky,5,5,10,0.5
vs. FBS Power 5,2012,Western Kentucky,1,1,2,0.5
vs. FBS non-Power 5,2012,Western Kentucky,5,5,10,0.5
in August/September,2012,Western Kentucky,4,1,5,0.8
in October,2012,Western Kentucky,2,1,3,0.6666666666666666
in November,2012,Western Kentucky,1,3,4,0.25
in December/January,2012,Western Kentucky,0,1,1,0.0
All Games,2013,Western Kentucky,8,4,12,0.6666666666666666
at Home,2013,Western Kentucky,3,2,5,0.6
on Road/Neutral Site,2013,Western Kentucky,5,2,7,0.7142857142857143
vs. Conference,2013,Western Kentucky,4,3,7,0.5714285714285714
vs. Non-Conference,2013,Western Kentucky,4,1,5,0.8
vs. Ranked (AP),2013,Western Kentucky,0,0,0,
vs. Unranked (AP),2013,Western Kentucky,8,4,12,0.6666666666666666
vs. FBS (I-A),2013,Western Kentucky,7,4,11,0.6363636363636364
vs. FCS (I-AA),2013,Western Kentucky,1,0,1,1.0
vs. FBS Winning,2013,Western Kentucky,2,1,3,0.6666666666666666
vs. FBS Non-Winning,2013,Western Kentucky,5,3,8,0.625
vs. BCS AQ,2013,Western Kentucky,1,1,2,0.5
vs. BCS non-AQ,2013,Western Kentucky,6,3,9,0.6666666666666666
vs. FBS Power 5,2013,Western Kentucky,1,1,2,0.5
vs. FBS non-Power 5,2013,Western Kentucky,6,3,9,0.6666666666666666
in August/September,2013,Western Kentucky,3,2,5,0.6
in October,2013,Western Kentucky,1,2,3,0.3333333333333333
in November,2013,Western Kentucky,4,0,4,1.0
in December/January,2013,Western Kentucky,0,0,0,
All Games,2014,Western Kentucky,8,5,13,0.6153846153846154
at Home,2014,Western Kentucky,5,1,6,0.8333333333333334
on Road/Neutral Site,2014,Western Kentucky,3,4,7,0.42857142857142855
vs. Conference,2014,Western Kentucky,4,4,8,0.5
vs. Non-Conference,2014,Western Kentucky,4,1,5,0.8
vs. Ranked (AP),2014,Western Kentucky,1,0,1,1.0
vs. Unranked (AP),2014,Western Kentucky,7,5,12,0.5833333333333334
vs. FBS (I-A),2014,Western Kentucky,8,5,13,0.6153846153846154
vs. FCS (I-AA),2014,Western Kentucky,0,0,0,
vs. FBS Winning,2014,Western Kentucky,5,1,6,0.8333333333333334
vs. FBS Non-Winning,2014,Western Kentucky,3,4,7,0.42857142857142855
vs. BCS AQ,2014,Western Kentucky,0,1,1,0.0
vs. BCS non-AQ,2014,Western Kentucky,8,4,12,0.6666666666666666
vs. FBS Power 5,2014,Western Kentucky,0,1,1,0.0
vs. FBS non-Power 5,2014,Western Kentucky,8,4,12,0.6666666666666666
in August/September,2014,Western Kentucky,2,2,4,0.5
in October,2014,Western Kentucky,1,2,3,0.3333333333333333
in November,2014,Western Kentucky,4,1,5,0.8
in December/January,2014,Western Kentucky,1,0,1,1.0
All Games,2015,Western Kentucky,12,2,14,0.8571428571428571
at Home,2015,Western Kentucky,6,0,6,1.0
on Road/Neutral Site,2015,Western Kentucky,6,2,8,0.75
vs. Conference,2015,Western Kentucky,9,0,9,1.0
vs. Non-Conference,2015,Western Kentucky,3,2,5,0.6
vs. Ranked (AP),2015,Western Kentucky,0,1,1,0.0
vs. Unranked (AP),2015,Western Kentucky,12,1,13,0.9230769230769231
vs. FBS (I-A),2015,Western Kentucky,12,2,14,0.8571428571428571
vs. FCS (I-AA),2015,Western Kentucky,0,0,0,
vs. FBS Winning,2015,Western Kentucky,5,1,6,0.8333333333333334
vs. FBS Non-Winning,2015,Western Kentucky,7,1,8,0.875
vs. BCS AQ,2015,Western Kentucky,2,2,4,0.5
vs. BCS non-AQ,2015,Western Kentucky,10,0,10,1.0
vs. FBS Power 5,2015,Western Kentucky,1,2,3,0.3333333333333333
vs. FBS non-Power 5,2015,Western Kentucky,11,0,11,1.0
in August/September,2015,Western Kentucky,3,1,4,0.75
in October,2015,Western Kentucky,4,1,5,0.8
in November,2015,Western Kentucky,3,0,3,1.0
in December/January,2015,Western Kentucky,2,0,2,1.0
All Games,2016,Western Kentucky,11,3,14,0.7857142857142857
at Home,2016,Western Kentucky,6,1,7,0.8571428571428571
on Road/Neutral Site,2016,Western Kentucky,5,2,7,0.7142857142857143
vs. Conference,2016,Western Kentucky,8,1,9,0.8888888888888888
vs. Non-Conference,2016,Western Kentucky,3,2,5,0.6
vs. Ranked (AP),2016,Western Kentucky,0,1,1,0.0
vs. Unranked (AP),2016,Western Kentucky,11,2,13,0.8461538461538461
vs. FBS (I-A),2016,Western Kentucky,10,3,13,0.7692307692307693
vs. FCS (I-AA),2016,Western Kentucky,1,0,1,1.0
vs. FBS Winning,2016,Western Kentucky,4,2,6,0.6666666666666666
vs. FBS Non-Winning,2016,Western Kentucky,6,1,7,0.8571428571428571
vs. BCS AQ,2016,Western Kentucky,1,2,3,0.3333333333333333
vs. BCS non-AQ,2016,Western Kentucky,9,1,10,0.9
vs. FBS Power 5,2016,Western Kentucky,0,2,2,0.0
vs. FBS non-Power 5,2016,Western Kentucky,10,1,11,0.9090909090909091
in August/September,2016,Western Kentucky,2,2,4,0.5
in October,2016,Western Kentucky,4,1,5,0.8
in November,2016,Western Kentucky,3,0,3,1.0
in December/January,2016,Western Kentucky,2,0,2,1.0
All Games,2017,Western Kentucky,6,7,13,0.46153846153846156
at Home,2017,Western Kentucky,4,2,6,0.6666666666666666
on Road/Neutral Site,2017,Western Kentucky,2,5,7,0.2857142857142857
vs. Conference,2017,Western Kentucky,4,4,8,0.5
vs. Non-Conference,2017,Western Kentucky,2,3,5,0.4
vs. Ranked (AP),2017,Western Kentucky,0,0,0,
vs. Unranked (AP),2017,Western Kentucky,6,7,13,0.46153846153846156
vs. FBS (I-A),2017,Western Kentucky,5,7,12,0.4166666666666667
vs. FCS (I-AA),2017,Western Kentucky,1,0,1,1.0
vs. FBS Winning,2017,Western Kentucky,1,5,6,0.16666666666666666
vs. FBS Non-Winning,2017,Western Kentucky,4,2,6,0.6666666666666666
vs. BCS AQ,2017,Western Kentucky,0,2,2,0.0
vs. BCS non-AQ,2017,Western Kentucky,5,5,10,0.5
vs. FBS Power 5,2017,Western Kentucky,0,2,2,0.0
vs. FBS non-Power 5,2017,Western Kentucky,5,5,10,0.5
in August/September,2017,Western Kentucky,2,2,4,0.5
in October,2017,Western Kentucky,3,1,4,0.75
in November,2017,Western Kentucky,1,3,4,0.25
in December/January,2017,Western Kentucky,0,1,1,0.0
All Games,2018,Western Kentucky,3,9,12,0.25
at Home,2018,Western Kentucky,1,4,5,0.2
on Road/Neutral Site,2018,Western Kentucky,2,5,7,0.2857142857142857
vs. Conference,2018,Western Kentucky,2,6,8,0.25
vs. Non-Conference,2018,Western Kentucky,1,3,4,0.25
vs. Ranked (AP),2018,Western Kentucky,0,0,0,
vs. Unranked (AP),2018,Western Kentucky,3,9,12,0.25
vs. FBS (I-A),2018,Western Kentucky,3,8,11,0.2727272727272727
vs. FCS (I-AA),2018,Western Kentucky,0,1,1,0.0
vs. FBS Winning,2018,Western Kentucky,1,4,5,0.2
vs. FBS Non-Winning,2018,Western Kentucky,2,4,6,0.3333333333333333
vs. BCS AQ,2018,Western Kentucky,0,2,2,0.0
vs. BCS non-AQ,2018,Western Kentucky,3,6,9,0.3333333333333333
vs. FBS Power 5,2018,Western Kentucky,0,2,2,0.0
vs. FBS non-Power 5,2018,Western Kentucky,3,6,9,0.3333333333333333
in August/September,2018,Western Kentucky,1,4,5,0.2
in October,2018,Western Kentucky,0,3,3,0.0
in November,2018,Western Kentucky,2,2,4,0.5
in December/January,2018,Western Kentucky,0,0,0,
All Games,2019,Western Kentucky,9,4,13,0.6923076923076923
at Home,2019,Western Kentucky,4,2,6,0.6666666666666666
on Road/Neutral Site,2019,Western Kentucky,5,2,7,0.7142857142857143
vs. Conference,2019,Western Kentucky,6,2,8,0.75
vs. Non-Conference,2019,Western Kentucky,3,2,5,0.6
vs. Ranked (AP),2019,Western Kentucky,0,0,0,
vs. Unranked (AP),2019,Western Kentucky,9,4,13,0.6923076923076923
vs. FBS (I-A),2019,Western Kentucky,9,3,12,0.75
vs. FCS (I-AA),2019,Western Kentucky,0,1,1,0.0
vs. FBS Winning,2019,Western Kentucky,4,3,7,0.5714285714285714
vs. FBS Non-Winning,2019,Western Kentucky,5,0,5,1.0
vs. BCS AQ,2019,Western Kentucky,1,1,2,0.5
vs. BCS non-AQ,2019,Western Kentucky,8,2,10,0.8
vs. FBS Power 5,2019,Western Kentucky,1,1,2,0.5
vs. FBS non-Power 5,2019,Western Kentucky,8,2,10,0.8
in August/September,2019,Western Kentucky,2,2,4,0.5
in October,2019,Western Kentucky,3,1,4,0.75
in November,2019,Western Kentucky,3,1,4,0.75
in December/January,2019,Western Kentucky,1,0,1,1.0
All Games,2020,Western Kentucky,5,7,12,0.4166666666666667
at Home,2020,Western Kentucky,3,2,5,0.6
on Road/Neutral Site,2020,Western Kentucky,2,5,7,0.2857142857142857
vs. Conference,2020,Western Kentucky,4,3,7,0.5714285714285714
vs. Non-Conference,2020,Western Kentucky,1,4,5,0.2
vs. Ranked (AP),2020,Western Kentucky,0,2,2,0.0
vs. Unranked (AP),2020,Western Kentucky,5,5,10,0.5
vs. FBS (I-A),2020,Western Kentucky,4,7,11,0.36363636363636365
vs. FCS (I-AA),2020,Western Kentucky,1,0,1,1.0
vs. FBS Winning,2020,Western Kentucky,0,6,6,0.0
vs. FBS Non-Winning,2020,Western Kentucky,4,1,5,0.8
vs. BCS AQ,2020,Western Kentucky,0,1,1,0.0
vs. BCS non-AQ,2020,Western Kentucky,4,6,10,0.4
vs. FBS Power 5,2020,Western Kentucky,0,1,1,0.0
vs. FBS non-Power 5,2020,Western Kentucky,4,6,10,0.4
in August/September,2020,Western Kentucky,0,2,2,0.0
in October,2020,Western Kentucky,2,3,5,0.4
in November,2020,Western Kentucky,2,1,3,0.6666666666666666
in December/January,2020,Western Kentucky,1,1,2,0.5
All Games,2021,Western Kentucky,9,5,14,0.6428571428571429
at Home,2021,Western Kentucky,4,2,6,0.6666666666666666
on Road/Neutral Site,2021,Western Kentucky,5,3,8,0.625
vs. Conference,2021,Western Kentucky,7,2,9,0.7777777777777778
vs. Non-Conference,2021,Western Kentucky,2,3,5,0.4
vs. Ranked (AP),2021,Western Kentucky,0,1,1,0.0
vs. Unranked (AP),2021,Western Kentucky,9,4,13,0.6923076923076923
vs. FBS (I-A),2021,Western Kentucky,8,5,13,0.6153846153846154
vs. FCS (I-AA),2021,Western Kentucky,1,0,1,1.0
vs. FBS Winning,2021,Western Kentucky,3,4,7,0.42857142857142855
vs. FBS Non-Winning,2021,Western Kentucky,5,1,6,0.8333333333333334
vs. BCS AQ,2021,Western Kentucky,0,2,2,0.0
vs. BCS non-AQ,2021,Western Kentucky,8,3,11,0.7272727272727273
vs. FBS Power 5,2021,Western Kentucky,0,2,2,0.0
vs. FBS non-Power 5,2021,Western Kentucky,8,3,11,0.7272727272727273
in August/September,2021,Western Kentucky,1,2,3,0.3333333333333333
in October,2021,Western Kentucky,3,2,5,0.6
in November,2021,Western Kentucky,4,0,4,1.0
in December/January,2021,Western Kentucky,1,1,2,0.5
All Games,2022,Western Kentucky,9,5,14,0.6428571428571429
at Home,2022,Western Kentucky,4,2,6,0.6666666666666666
on Road/Neutral Site,2022,Western Kentucky,5,3,8,0.625
vs. Conference,2022,Western Kentucky,6,2,8,0.75
vs. Non-Conference,2022,Western Kentucky,3,3,6,0.5
vs. Ranked (AP),2022,Western Kentucky,0,1,1,0.0
vs. Unranked (AP),2022,Western Kentucky,9,4,13,0.6923076923076923
vs. FBS (I-A),2022,Western Kentucky,8,5,13,0.6153846153846154
vs. FCS (I-AA),2022,Western Kentucky,1,0,1,1.0
vs. FBS Winning,2022,Western Kentucky,3,2,5,0.6
vs. FBS Non-Winning,2022,Western Kentucky,5,3,8,0.625
vs. BCS AQ,2022,Western Kentucky,0,2,2,0.0
vs. BCS non-AQ,2022,Western Kentucky,8,3,11,0.7272727272727273
vs. FBS Power 5,2022,Western Kentucky,0,2,2,0.0
vs. FBS non-Power 5,2022,Western Kentucky,8,3,11,0.7272727272727273
in August/September,2022,Western Kentucky,3,1,4,0.75
in October,2022,Western Kentucky,2,3,5,0.4
in November,2022,Western Kentucky,3,1,4,0.75
in December/January,2022,Western Kentucky,1,0,1,1.0
All Games,2009,Western Michigan,5,7,12,0.4166666666666667
at Home,2009,Western Michigan,3,2,5,0.6
on Road/Neutral Site,2009,Western Michigan,2,5,7,0.2857142857142857
vs. Conference,2009,Western Michigan,4,4,8,0.5
vs. Non-Conference,2009,Western Michigan,1,3,4,0.25
vs. Ranked (AP),2009,Western Michigan,0,1,1,0.0
vs. Unranked (AP),2009,Western Michigan,5,6,11,0.45454545454545453
vs. FBS (I-A),2009,Western Michigan,4,7,11,0.36363636363636365
vs. FCS (I-AA),2009,Western Michigan,1,0,1,1.0
vs. FBS Winning,2009,Western Michigan,0,2,2,0.0
vs. FBS Non-Winning,2009,Western Michigan,4,5,9,0.4444444444444444
vs. BCS AQ,2009,Western Michigan,0,3,3,0.0
vs. BCS non-AQ,2009,Western Michigan,4,4,8,0.5
vs. FBS Power 5,2009,Western Michigan,0,3,3,0.0
vs. FBS non-Power 5,2009,Western Michigan,4,4,8,0.5
in August/September,2009,Western Michigan,2,2,4,0.5
in October,2009,Western Michigan,2,3,5,0.4
in November,2009,Western Michigan,1,2,3,0.3333333333333333
in December/January,2009,Western Michigan,0,0,0,
All Games,2010,Western Michigan,6,6,12,0.5
at Home,2010,Western Michigan,3,3,6,0.5
on Road/Neutral Site,2010,Western Michigan,3,3,6,0.5
vs. Conference,2010,Western Michigan,5,3,8,0.625
vs. Non-Conference,2010,Western Michigan,1,3,4,0.25
vs. Ranked (AP),2010,Western Michigan,0,1,1,0.0
vs. Unranked (AP),2010,Western Michigan,6,5,11,0.5454545454545454
vs. FBS (I-A),2010,Western Michigan,5,6,11,0.45454545454545453
vs. FCS (I-AA),2010,Western Michigan,1,0,1,1.0
vs. FBS Winning,2010,Western Michigan,0,4,4,0.0
vs. FBS Non-Winning,2010,Western Michigan,5,2,7,0.7142857142857143
vs. BCS AQ,2010,Western Michigan,0,2,2,0.0
vs. BCS non-AQ,2010,Western Michigan,5,4,9,0.5555555555555556
vs. FBS Power 5,2010,Western Michigan,0,1,1,0.0
vs. FBS non-Power 5,2010,Western Michigan,5,5,10,0.5
in August/September,2010,Western Michigan,1,2,3,0.3333333333333333
in October,2010,Western Michigan,2,3,5,0.4
in November,2010,Western Michigan,3,1,4,0.75
in December/January,2010,Western Michigan,0,0,0,
All Games,2011,Western Michigan,7,6,13,0.5384615384615384
at Home,2011,Western Michigan,5,0,5,1.0
on Road/Neutral Site,2011,Western Michigan,2,6,8,0.25
vs. Conference,2011,Western Michigan,5,3,8,0.625
vs. Non-Conference,2011,Western Michigan,2,3,5,0.4
vs. Ranked (AP),2011,Western Michigan,0,1,1,0.0
vs. Unranked (AP),2011,Western Michigan,7,5,12,0.5833333333333334
vs. FBS (I-A),2011,Western Michigan,6,6,12,0.5
vs. FCS (I-AA),2011,Western Michigan,1,0,1,1.0
vs. FBS Winning,2011,Western Michigan,0,5,5,0.0
vs. FBS Non-Winning,2011,Western Michigan,6,1,7,0.8571428571428571
vs. BCS AQ,2011,Western Michigan,1,3,4,0.25
vs. BCS non-AQ,2011,Western Michigan,5,3,8,0.625
vs. FBS Power 5,2011,Western Michigan,0,3,3,0.0
vs. FBS non-Power 5,2011,Western Michigan,6,3,9,0.6666666666666666
in August/September,2011,Western Michigan,2,2,4,0.5
in October,2011,Western Michigan,3,2,5,0.6
in November,2011,Western Michigan,2,1,3,0.6666666666666666
in December/January,2011,Western Michigan,0,1,1,0.0
All Games,2012,Western Michigan,4,8,12,0.3333333333333333
at Home,2012,Western Michigan,3,3,6,0.5
on Road/Neutral Site,2012,Western Michigan,1,5,6,0.16666666666666666
vs. Conference,2012,Western Michigan,2,6,8,0.25
vs. Non-Conference,2012,Western Michigan,2,2,4,0.5
vs. Ranked (AP),2012,Western Michigan,0,1,1,0.0
vs. Unranked (AP),2012,Western Michigan,4,7,11,0.36363636363636365
vs. FBS (I-A),2012,Western Michigan,3,8,11,0.2727272727272727
vs. FCS (I-AA),2012,Western Michigan,1,0,1,1.0
vs. FBS Winning,2012,Western Michigan,1,4,5,0.2
vs. FBS Non-Winning,2012,Western Michigan,2,4,6,0.3333333333333333
vs. BCS AQ,2012,Western Michigan,1,2,3,0.3333333333333333
vs. BCS non-AQ,2012,Western Michigan,2,6,8,0.25
vs. FBS Power 5,2012,Western Michigan,0,2,2,0.0
vs. FBS non-Power 5,2012,Western Michigan,3,6,9,0.3333333333333333
in August/September,2012,Western Michigan,2,3,5,0.4
in October,2012,Western Michigan,1,3,4,0.25
in November,2012,Western Michigan,1,2,3,0.3333333333333333
in December/January,2012,Western Michigan,0,0,0,
All Games,2013,Western Michigan,1,11,12,0.08333333333333333
at Home,2013,Western Michigan,0,5,5,0.0
on Road/Neutral Site,2013,Western Michigan,1,6,7,0.14285714285714285
vs. Conference,2013,Western Michigan,1,7,8,0.125
vs. Non-Conference,2013,Western Michigan,0,4,4,0.0
vs. Ranked (AP),2013,Western Michigan,0,1,1,0.0
vs. Unranked (AP),2013,Western Michigan,1,10,11,0.09090909090909091
vs. FBS (I-A),2013,Western Michigan,1,10,11,0.09090909090909091
vs. FCS (I-AA),2013,Western Michigan,0,1,1,0.0
vs. FBS Winning,2013,Western Michigan,0,6,6,0.0
vs. FBS Non-Winning,2013,Western Michigan,1,4,5,0.2
vs. BCS AQ,2013,Western Michigan,0,3,3,0.0
vs. BCS non-AQ,2013,Western Michigan,1,7,8,0.125
vs. FBS Power 5,2013,Western Michigan,0,3,3,0.0
vs. FBS non-Power 5,2013,Western Michigan,1,7,8,0.125
in August/September,2013,Western Michigan,0,5,5,0.0
in October,2013,Western Michigan,1,3,4,0.25
in November,2013,Western Michigan,0,3,3,0.0
in December/January,2013,Western Michigan,0,0,0,
All Games,2014,Western Michigan,8,5,13,0.6153846153846154
at Home,2014,Western Michigan,3,2,5,0.6
on Road/Neutral Site,2014,Western Michigan,5,3,8,0.625
vs. Conference,2014,Western Michigan,6,2,8,0.75
vs. Non-Conference,2014,Western Michigan,2,3,5,0.4
vs. Ranked (AP),2014,Western Michigan,0,0,0,
vs. Unranked (AP),2014,Western Michigan,8,5,13,0.6153846153846154
vs. FBS (I-A),2014,Western Michigan,7,5,12,0.5833333333333334
vs. FCS (I-AA),2014,Western Michigan,1,0,1,1.0
vs. FBS Winning,2014,Western Michigan,2,4,6,0.3333333333333333
vs. FBS Non-Winning,2014,Western Michigan,5,1,6,0.8333333333333334
vs. BCS AQ,2014,Western Michigan,0,2,2,0.0
vs. BCS non-AQ,2014,Western Michigan,7,3,10,0.7
vs. FBS Power 5,2014,Western Michigan,0,2,2,0.0
vs. FBS non-Power 5,2014,Western Michigan,7,3,10,0.7
in August/September,2014,Western Michigan,2,2,4,0.5
in October,2014,Western Michigan,3,1,4,0.75
in November,2014,Western Michigan,3,1,4,0.75
in December/January,2014,Western Michigan,0,1,1,0.0
All Games,2015,Western Michigan,8,5,13,0.6153846153846154
at Home,2015,Western Michigan,4,2,6,0.6666666666666666
on Road/Neutral Site,2015,Western Michigan,4,3,7,0.5714285714285714
vs. Conference,2015,Western Michigan,6,2,8,0.75
vs. Non-Conference,2015,Western Michigan,2,3,5,0.4
vs. Ranked (AP),2015,Western Michigan,0,2,2,0.0
vs. Unranked (AP),2015,Western Michigan,8,3,11,0.7272727272727273
vs. FBS (I-A),2015,Western Michigan,7,5,12,0.5833333333333334
vs. FCS (I-AA),2015,Western Michigan,1,0,1,1.0
vs. FBS Winning,2015,Western Michigan,4,5,9,0.4444444444444444
vs. FBS Non-Winning,2015,Western Michigan,3,0,3,1.0
vs. BCS AQ,2015,Western Michigan,0,2,2,0.0
vs. BCS non-AQ,2015,Western Michigan,7,3,10,0.7
vs. FBS Power 5,2015,Western Michigan,0,2,2,0.0
vs. FBS non-Power 5,2015,Western Michigan,7,3,10,0.7
in August/September,2015,Western Michigan,1,3,4,0.25
in October,2015,Western Michigan,4,0,4,1.0
in November,2015,Western Michigan,2,2,4,0.5
in December/January,2015,Western Michigan,1,0,1,1.0
All Games,2016,Western Michigan,13,1,14,0.9285714285714286
at Home,2016,Western Michigan,6,0,6,1.0
on Road/Neutral Site,2016,Western Michigan,7,1,8,0.875
vs. Conference,2016,Western Michigan,9,0,9,1.0
vs. Non-Conference,2016,Western Michigan,4,1,5,0.8
vs. Ranked (AP),2016,Western Michigan,0,1,1,0.0
vs. Unranked (AP),2016,Western Michigan,13,0,13,1.0
vs. FBS (I-A),2016,Western Michigan,12,1,13,0.9230769230769231
vs. FCS (I-AA),2016,Western Michigan,1,0,1,1.0
vs. FBS Winning,2016,Western Michigan,4,1,5,0.8
vs. FBS Non-Winning,2016,Western Michigan,8,0,8,1.0
vs. BCS AQ,2016,Western Michigan,2,1,3,0.6666666666666666
vs. BCS non-AQ,2016,Western Michigan,10,0,10,1.0
vs. FBS Power 5,2016,Western Michigan,2,1,3,0.6666666666666666
vs. FBS non-Power 5,2016,Western Michigan,10,0,10,1.0
in August/September,2016,Western Michigan,4,0,4,1.0
in October,2016,Western Michigan,4,0,4,1.0
in November,2016,Western Michigan,4,0,4,1.0
in December/January,2016,Western Michigan,1,1,2,0.5
All Games,2017,Western Michigan,6,6,12,0.5
at Home,2017,Western Michigan,4,2,6,0.6666666666666666
on Road/Neutral Site,2017,Western Michigan,2,4,6,0.3333333333333333
vs. Conference,2017,Western Michigan,4,4,8,0.5
vs. Non-Conference,2017,Western Michigan,2,2,4,0.5
vs. Ranked (AP),2017,Western Michigan,0,2,2,0.0
vs. Unranked (AP),2017,Western Michigan,6,4,10,0.6
vs. FBS (I-A),2017,Western Michigan,5,6,11,0.45454545454545453
vs. FCS (I-AA),2017,Western Michigan,1,0,1,1.0
vs. FBS Winning,2017,Western Michigan,0,5,5,0.0
vs. FBS Non-Winning,2017,Western Michigan,5,1,6,0.8333333333333334
vs. BCS AQ,2017,Western Michigan,0,2,2,0.0
vs. BCS non-AQ,2017,Western Michigan,5,4,9,0.5555555555555556
vs. FBS Power 5,2017,Western Michigan,0,2,2,0.0
vs. FBS non-Power 5,2017,Western Michigan,5,4,9,0.5555555555555556
in August/September,2017,Western Michigan,3,2,5,0.6
in October,2017,Western Michigan,2,1,3,0.6666666666666666
in November,2017,Western Michigan,1,3,4,0.25
in December/January,2017,Western Michigan,0,0,0,
All Games,2018,Western Michigan,7,6,13,0.5384615384615384
at Home,2018,Western Michigan,3,3,6,0.5
on Road/Neutral Site,2018,Western Michigan,4,3,7,0.5714285714285714
vs. Conference,2018,Western Michigan,5,3,8,0.625
vs. Non-Conference,2018,Western Michigan,2,3,5,0.4
vs. Ranked (AP),2018,Western Michigan,0,2,2,0.0
vs. Unranked (AP),2018,Western Michigan,7,4,11,0.6363636363636364
vs. FBS (I-A),2018,Western Michigan,6,6,12,0.5
vs. FCS (I-AA),2018,Western Michigan,1,0,1,1.0
vs. FBS Winning,2018,Western Michigan,2,5,7,0.2857142857142857
vs. FBS Non-Winning,2018,Western Michigan,4,1,5,0.8
vs. BCS AQ,2018,Western Michigan,0,2,2,0.0
vs. BCS non-AQ,2018,Western Michigan,6,4,10,0.6
vs. FBS Power 5,2018,Western Michigan,0,2,2,0.0
vs. FBS non-Power 5,2018,Western Michigan,6,4,10,0.6
in August/September,2018,Western Michigan,3,2,5,0.6
in October,2018,Western Michigan,3,1,4,0.75
in November,2018,Western Michigan,1,2,3,0.3333333333333333
in December/January,2018,Western Michigan,0,1,1,0.0
All Games,2019,Western Michigan,7,6,13,0.5384615384615384
at Home,2019,Western Michigan,6,0,6,1.0
on Road/Neutral Site,2019,Western Michigan,1,6,7,0.14285714285714285
vs. Conference,2019,Western Michigan,5,3,8,0.625
vs. Non-Conference,2019,Western Michigan,2,3,5,0.4
vs. Ranked (AP),2019,Western Michigan,0,0,0,
vs. Unranked (AP),2019,Western Michigan,7,6,13,0.5384615384615384
vs. FBS (I-A),2019,Western Michigan,6,6,12,0.5
vs. FCS (I-AA),2019,Western Michigan,1,0,1,1.0
vs. FBS Winning,2019,Western Michigan,4,2,6,0.6666666666666666
vs. FBS Non-Winning,2019,Western Michigan,2,4,6,0.3333333333333333
vs. BCS AQ,2019,Western Michigan,0,2,2,0.0
vs. BCS non-AQ,2019,Western Michigan,6,4,10,0.6
vs. FBS Power 5,2019,Western Michigan,0,2,2,0.0
vs. FBS non-Power 5,2019,Western Michigan,6,4,10,0.6
in August/September,2019,Western Michigan,3,2,5,0.6
in October,2019,Western Michigan,2,2,4,0.5
in November,2019,Western Michigan,2,1,3,0.6666666666666666
in December/January,2019,Western Michigan,0,1,1,0.0
All Games,2020,Western Michigan,4,2,6,0.6666666666666666
at Home,2020,Western Michigan,2,1,3,0.6666666666666666
on Road/Neutral Site,2020,Western Michigan,2,1,3,0.6666666666666666
vs. Conference,2020,Western Michigan,4,2,6,0.6666666666666666
vs. Non-Conference,2020,Western Michigan,0,0,0,
vs. Ranked (AP),2020,Western Michigan,0,0,0,
vs. Unranked (AP),2020,Western Michigan,4,2,6,0.6666666666666666
vs. FBS (I-A),2020,Western Michigan,4,2,6,0.6666666666666666
vs. FCS (I-AA),2020,Western Michigan,0,0,0,
vs. FBS Winning,2020,Western Michigan,1,1,2,0.5
vs. FBS Non-Winning,2020,Western Michigan,3,1,4,0.75
vs. BCS AQ,2020,Western Michigan,0,0,0,
vs. BCS non-AQ,2020,Western Michigan,4,2,6,0.6666666666666666
vs. FBS Power 5,2020,Western Michigan,0,0,0,
vs. FBS non-Power 5,2020,Western Michigan,4,2,6,0.6666666666666666
in August/September,2020,Western Michigan,0,0,0,
in October,2020,Western Michigan,0,0,0,
in November,2020,Western Michigan,4,0,4,1.0
in December/January,2020,Western Michigan,0,2,2,0.0
All Games,2021,Western Michigan,8,5,13,0.6153846153846154
at Home,2021,Western Michigan,4,2,6,0.6666666666666666
on Road/Neutral Site,2021,Western Michigan,4,3,7,0.5714285714285714
vs. Conference,2021,Western Michigan,4,4,8,0.5
vs. Non-Conference,2021,Western Michigan,4,1,5,0.8
vs. Ranked (AP),2021,Western Michigan,1,1,2,0.5
vs. Unranked (AP),2021,Western Michigan,7,4,11,0.6363636363636364
vs. FBS (I-A),2021,Western Michigan,7,5,12,0.5833333333333334
vs. FCS (I-AA),2021,Western Michigan,1,0,1,1.0
vs. FBS Winning,2021,Western Michigan,3,4,7,0.42857142857142855
vs. FBS Non-Winning,2021,Western Michigan,4,1,5,0.8
vs. BCS AQ,2021,Western Michigan,1,1,2,0.5
vs. BCS non-AQ,2021,Western Michigan,6,4,10,0.6
vs. FBS Power 5,2021,Western Michigan,1,1,2,0.5
vs. FBS non-Power 5,2021,Western Michigan,6,4,10,0.6
in August/September,2021,Western Michigan,3,1,4,0.75
in October,2021,Western Michigan,2,2,4,0.5
in November,2021,Western Michigan,2,2,4,0.5
in December/January,2021,Western Michigan,1,0,1,1.0
All Games,2022,Western Michigan,5,7,12,0.4166666666666667
at Home,2022,Western Michigan,2,4,6,0.3333333333333333
on Road/Neutral Site,2022,Western Michigan,3,3,6,0.5
vs. Conference,2022,Western Michigan,4,4,8,0.5
vs. Non-Conference,2022,Western Michigan,1,3,4,0.25
vs. Ranked (AP),2022,Western Michigan,0,1,1,0.0
vs. Unranked (AP),2022,Western Michigan,5,6,11,0.45454545454545453
vs. FBS (I-A),2022,Western Michigan,4,7,11,0.36363636363636365
vs. FCS (I-AA),2022,Western Michigan,1,0,1,1.0
vs. FBS Winning,2022,Western Michigan,1,4,5,0.2
vs. FBS Non-Winning,2022,Western Michigan,3,3,6,0.5
vs. BCS AQ,2022,Western Michigan,0,2,2,0.0
vs. BCS non-AQ,2022,Western Michigan,4,5,9,0.4444444444444444
vs. FBS Power 5,2022,Western Michigan,0,2,2,0.0
vs. FBS non-Power 5,2022,Western Michigan,4,5,9,0.4444444444444444
in August/September,2022,Western Michigan,1,3,4,0.25
in October,2022,Western Michigan,2,2,4,0.5
in November,2022,Western Michigan,2,2,4,0.5
in December/January,2022,Western Michigan,0,0,0,
All Games,2009,Wisconsin,10,3,13,0.7692307692307693
at Home,2009,Wisconsin,6,1,7,0.8571428571428571
on Road/Neutral Site,2009,Wisconsin,4,2,6,0.6666666666666666
vs. Conference,2009,Wisconsin,5,3,8,0.625
vs. Non-Conference,2009,Wisconsin,5,0,5,1.0
vs. Ranked (AP),2009,Wisconsin,1,2,3,0.3333333333333333
vs. Unranked (AP),2009,Wisconsin,9,1,10,0.9
vs. FBS (I-A),2009,Wisconsin,9,3,12,0.75
vs. FCS (I-AA),2009,Wisconsin,1,0,1,1.0
vs. FBS Winning,2009,Wisconsin,3,3,6,0.5
vs. FBS Non-Winning,2009,Wisconsin,6,0,6,1.0
vs. BCS AQ,2009,Wisconsin,6,3,9,0.6666666666666666
vs. BCS non-AQ,2009,Wisconsin,3,0,3,1.0
vs. FBS Power 5,2009,Wisconsin,6,3,9,0.6666666666666666
vs. FBS non-Power 5,2009,Wisconsin,3,0,3,1.0
in August/September,2009,Wisconsin,4,0,4,1.0
in October,2009,Wisconsin,2,2,4,0.5
in November,2009,Wisconsin,2,1,3,0.6666666666666666
in December/January,2009,Wisconsin,2,0,2,1.0
All Games,2010,Wisconsin,11,2,13,0.8461538461538461
at Home,2010,Wisconsin,7,0,7,1.0
on Road/Neutral Site,2010,Wisconsin,4,2,6,0.6666666666666666
vs. Conference,2010,Wisconsin,7,1,8,0.875
vs. Non-Conference,2010,Wisconsin,4,1,5,0.8
vs. Ranked (AP),2010,Wisconsin,1,2,3,0.3333333333333333
vs. Unranked (AP),2010,Wisconsin,10,0,10,1.0
vs. FBS (I-A),2010,Wisconsin,10,2,12,0.8333333333333334
vs. FCS (I-AA),2010,Wisconsin,1,0,1,1.0
vs. FBS Winning,2010,Wisconsin,4,2,6,0.6666666666666666
vs. FBS Non-Winning,2010,Wisconsin,6,0,6,1.0
vs. BCS AQ,2010,Wisconsin,8,1,9,0.8888888888888888
vs. BCS non-AQ,2010,Wisconsin,2,1,3,0.6666666666666666
vs. FBS Power 5,2010,Wisconsin,8,1,9,0.8888888888888888
vs. FBS non-Power 5,2010,Wisconsin,2,1,3,0.6666666666666666
in August/September,2010,Wisconsin,4,0,4,1.0
in October,2010,Wisconsin,3,1,4,0.75
in November,2010,Wisconsin,4,0,4,1.0
in December/January,2010,Wisconsin,0,1,1,0.0
All Games,2011,Wisconsin,11,3,14,0.7857142857142857
at Home,2011,Wisconsin,7,0,7,1.0
on Road/Neutral Site,2011,Wisconsin,4,3,7,0.5714285714285714
vs. Conference,2011,Wisconsin,7,2,9,0.7777777777777778
vs. Non-Conference,2011,Wisconsin,4,1,5,0.8
vs. Ranked (AP),2011,Wisconsin,2,2,4,0.5
vs. Unranked (AP),2011,Wisconsin,9,1,10,0.9
vs. FBS (I-A),2011,Wisconsin,10,3,13,0.7692307692307693
vs. FCS (I-AA),2011,Wisconsin,1,0,1,1.0
vs. FBS Winning,2011,Wisconsin,6,2,8,0.75
vs. FBS Non-Winning,2011,Wisconsin,4,1,5,0.8
vs. BCS AQ,2011,Wisconsin,8,3,11,0.7272727272727273
vs. BCS non-AQ,2011,Wisconsin,2,0,2,1.0
vs. FBS Power 5,2011,Wisconsin,8,3,11,0.7272727272727273
vs. FBS non-Power 5,2011,Wisconsin,2,0,2,1.0
in August/September,2011,Wisconsin,4,0,4,1.0
in October,2011,Wisconsin,2,2,4,0.5
in November,2011,Wisconsin,4,0,4,1.0
in December/January,2011,Wisconsin,1,1,2,0.5
All Games,2012,Wisconsin,8,6,14,0.5714285714285714
at Home,2012,Wisconsin,5,2,7,0.7142857142857143
on Road/Neutral Site,2012,Wisconsin,3,4,7,0.42857142857142855
vs. Conference,2012,Wisconsin,5,4,9,0.5555555555555556
vs. Non-Conference,2012,Wisconsin,3,2,5,0.6
vs. Ranked (AP),2012,Wisconsin,2,4,6,0.3333333333333333
vs. Unranked (AP),2012,Wisconsin,6,2,8,0.75
vs. FBS (I-A),2012,Wisconsin,7,6,13,0.5384615384615384
vs. FCS (I-AA),2012,Wisconsin,1,0,1,1.0
vs. FBS Winning,2012,Wisconsin,2,6,8,0.25
vs. FBS Non-Winning,2012,Wisconsin,5,0,5,1.0
vs. BCS AQ,2012,Wisconsin,5,6,11,0.45454545454545453
vs. BCS non-AQ,2012,Wisconsin,2,0,2,1.0
vs. FBS Power 5,2012,Wisconsin,5,6,11,0.45454545454545453
vs. FBS non-Power 5,2012,Wisconsin,2,0,2,1.0
in August/September,2012,Wisconsin,3,2,5,0.6
in October,2012,Wisconsin,3,1,4,0.75
in November,2012,Wisconsin,1,2,3,0.3333333333333333
in December/January,2012,Wisconsin,1,1,2,0.5
All Games,2013,Wisconsin,9,4,13,0.6923076923076923
at Home,2013,Wisconsin,6,1,7,0.8571428571428571
on Road/Neutral Site,2013,Wisconsin,3,3,6,0.5
vs. Conference,2013,Wisconsin,6,2,8,0.75
vs. Non-Conference,2013,Wisconsin,3,2,5,0.6
vs. Ranked (AP),2013,Wisconsin,0,3,3,0.0
vs. Unranked (AP),2013,Wisconsin,9,1,10,0.9
vs. FBS (I-A),2013,Wisconsin,8,4,12,0.6666666666666666
vs. FCS (I-AA),2013,Wisconsin,1,0,1,1.0
vs. FBS Winning,2013,Wisconsin,3,4,7,0.42857142857142855
vs. FBS Non-Winning,2013,Wisconsin,5,0,5,1.0
vs. BCS AQ,2013,Wisconsin,6,4,10,0.6
vs. BCS non-AQ,2013,Wisconsin,2,0,2,1.0
vs. FBS Power 5,2013,Wisconsin,6,4,10,0.6
vs. FBS non-Power 5,2013,Wisconsin,2,0,2,1.0
in August/September,2013,Wisconsin,3,2,5,0.6
in October,2013,Wisconsin,2,0,2,1.0
in November,2013,Wisconsin,4,1,5,0.8
in December/January,2013,Wisconsin,0,1,1,0.0
All Games,2014,Wisconsin,11,3,14,0.7857142857142857
at Home,2014,Wisconsin,7,0,7,1.0
on Road/Neutral Site,2014,Wisconsin,4,3,7,0.5714285714285714
vs. Conference,2014,Wisconsin,7,2,9,0.7777777777777778
vs. Non-Conference,2014,Wisconsin,4,1,5,0.8
vs. Ranked (AP),2014,Wisconsin,1,1,2,0.5
vs. Unranked (AP),2014,Wisconsin,10,2,12,0.8333333333333334
vs. FBS (I-A),2014,Wisconsin,10,3,13,0.7692307692307693
vs. FCS (I-AA),2014,Wisconsin,1,0,1,1.0
vs. FBS Winning,2014,Wisconsin,7,2,9,0.7777777777777778
vs. FBS Non-Winning,2014,Wisconsin,3,1,4,0.75
vs. BCS AQ,2014,Wisconsin,9,3,12,0.75
vs. BCS non-AQ,2014,Wisconsin,1,0,1,1.0
vs. FBS Power 5,2014,Wisconsin,8,3,11,0.7272727272727273
vs. FBS non-Power 5,2014,Wisconsin,2,0,2,1.0
in August/September,2014,Wisconsin,3,1,4,0.75
in October,2014,Wisconsin,2,1,3,0.6666666666666666
in November,2014,Wisconsin,5,0,5,1.0
in December/January,2014,Wisconsin,1,1,2,0.5
All Games,2015,Wisconsin,10,3,13,0.7692307692307693
at Home,2015,Wisconsin,5,2,7,0.7142857142857143
on Road/Neutral Site,2015,Wisconsin,5,1,6,0.8333333333333334
vs. Conference,2015,Wisconsin,6,2,8,0.75
vs. Non-Conference,2015,Wisconsin,4,1,5,0.8
vs. Ranked (AP),2015,Wisconsin,0,3,3,0.0
vs. Unranked (AP),2015,Wisconsin,10,0,10,1.0
vs. FBS (I-A),2015,Wisconsin,10,3,13,0.7692307692307693
vs. FCS (I-AA),2015,Wisconsin,0,0,0,
vs. FBS Winning,2015,Wisconsin,1,3,4,0.25
vs. FBS Non-Winning,2015,Wisconsin,9,0,9,1.0
vs. BCS AQ,2015,Wisconsin,7,3,10,0.7
vs. BCS non-AQ,2015,Wisconsin,3,0,3,1.0
vs. FBS Power 5,2015,Wisconsin,7,3,10,0.7
vs. FBS non-Power 5,2015,Wisconsin,3,0,3,1.0
in August/September,2015,Wisconsin,3,1,4,0.75
in October,2015,Wisconsin,4,1,5,0.8
in November,2015,Wisconsin,2,1,3,0.6666666666666666
in December/January,2015,Wisconsin,1,0,1,1.0
All Games,2016,Wisconsin,11,3,14,0.7857142857142857
at Home,2016,Wisconsin,5,1,6,0.8333333333333334
on Road/Neutral Site,2016,Wisconsin,6,2,8,0.75
vs. Conference,2016,Wisconsin,7,3,10,0.7
vs. Non-Conference,2016,Wisconsin,4,0,4,1.0
vs. Ranked (AP),2016,Wisconsin,4,3,7,0.5714285714285714
vs. Unranked (AP),2016,Wisconsin,7,0,7,1.0
vs. FBS (I-A),2016,Wisconsin,11,3,14,0.7857142857142857
vs. FCS (I-AA),2016,Wisconsin,0,0,0,
vs. FBS Winning,2016,Wisconsin,6,3,9,0.6666666666666666
vs. FBS Non-Winning,2016,Wisconsin,5,0,5,1.0
vs. BCS AQ,2016,Wisconsin,8,3,11,0.7272727272727273
vs. BCS non-AQ,2016,Wisconsin,3,0,3,1.0
vs. FBS Power 5,2016,Wisconsin,8,3,11,0.7272727272727273
vs. FBS non-Power 5,2016,Wisconsin,3,0,3,1.0
in August/September,2016,Wisconsin,4,0,4,1.0
in October,2016,Wisconsin,2,2,4,0.5
in November,2016,Wisconsin,4,0,4,1.0
in December/January,2016,Wisconsin,1,1,2,0.5
All Games,2017,Wisconsin,13,1,14,0.9285714285714286
at Home,2017,Wisconsin,7,0,7,1.0
on Road/Neutral Site,2017,Wisconsin,6,1,7,0.8571428571428571
vs. Conference,2017,Wisconsin,9,1,10,0.9
vs. Non-Conference,2017,Wisconsin,4,0,4,1.0
vs. Ranked (AP),2017,Wisconsin,2,1,3,0.6666666666666666
vs. Unranked (AP),2017,Wisconsin,11,0,11,1.0
vs. FBS (I-A),2017,Wisconsin,13,1,14,0.9285714285714286
vs. FCS (I-AA),2017,Wisconsin,0,0,0,
vs. FBS Winning,2017,Wisconsin,6,1,7,0.8571428571428571
vs. FBS Non-Winning,2017,Wisconsin,7,0,7,1.0
vs. BCS AQ,2017,Wisconsin,10,1,11,0.9090909090909091
vs. BCS non-AQ,2017,Wisconsin,3,0,3,1.0
vs. FBS Power 5,2017,Wisconsin,10,1,11,0.9090909090909091
vs. FBS non-Power 5,2017,Wisconsin,3,0,3,1.0
in August/September,2017,Wisconsin,4,0,4,1.0
in October,2017,Wisconsin,4,0,4,1.0
in November,2017,Wisconsin,4,0,4,1.0
in December/January,2017,Wisconsin,1,1,2,0.5
All Games,2018,Wisconsin,8,5,13,0.6153846153846154
at Home,2018,Wisconsin,5,2,7,0.7142857142857143
on Road/Neutral Site,2018,Wisconsin,3,3,6,0.5
vs. Conference,2018,Wisconsin,5,4,9,0.5555555555555556
vs. Non-Conference,2018,Wisconsin,3,1,4,0.75
vs. Ranked (AP),2018,Wisconsin,1,3,4,0.25
vs. Unranked (AP),2018,Wisconsin,7,2,9,0.7777777777777778
vs. FBS (I-A),2018,Wisconsin,8,5,13,0.6153846153846154
vs. FCS (I-AA),2018,Wisconsin,0,0,0,
vs. FBS Winning,2018,Wisconsin,2,5,7,0.2857142857142857
vs. FBS Non-Winning,2018,Wisconsin,6,0,6,1.0
vs. BCS AQ,2018,Wisconsin,6,4,10,0.6
vs. BCS non-AQ,2018,Wisconsin,2,1,3,0.6666666666666666
vs. FBS Power 5,2018,Wisconsin,6,4,10,0.6
vs. FBS non-Power 5,2018,Wisconsin,2,1,3,0.6666666666666666
in August/September,2018,Wisconsin,3,1,4,0.75
in October,2018,Wisconsin,2,2,4,0.5
in November,2018,Wisconsin,2,2,4,0.5
in December/January,2018,Wisconsin,1,0,1,1.0
All Games,2019,Wisconsin,10,4,14,0.7142857142857143
at Home,2019,Wisconsin,7,0,7,1.0
on Road/Neutral Site,2019,Wisconsin,3,4,7,0.42857142857142855
vs. Conference,2019,Wisconsin,7,3,10,0.7
vs. Non-Conference,2019,Wisconsin,3,1,4,0.75
vs. Ranked (AP),2019,Wisconsin,3,3,6,0.5
vs. Unranked (AP),2019,Wisconsin,7,1,8,0.875
vs. FBS (I-A),2019,Wisconsin,10,4,14,0.7142857142857143
vs. FCS (I-AA),2019,Wisconsin,0,0,0,
vs. FBS Winning,2019,Wisconsin,6,3,9,0.6666666666666666
vs. FBS Non-Winning,2019,Wisconsin,4,1,5,0.8
vs. BCS AQ,2019,Wisconsin,8,4,12,0.6666666666666666
vs. BCS non-AQ,2019,Wisconsin,2,0,2,1.0
vs. FBS Power 5,2019,Wisconsin,7,4,11,0.6363636363636364
vs. FBS non-Power 5,2019,Wisconsin,3,0,3,1.0
in August/September,2019,Wisconsin,4,0,4,1.0
in October,2019,Wisconsin,2,2,4,0.5
in November,2019,Wisconsin,4,0,4,1.0
in December/January,2019,Wisconsin,0,2,2,0.0
All Games,2020,Wisconsin,4,3,7,0.5714285714285714
at Home,2020,Wisconsin,2,1,3,0.6666666666666666
on Road/Neutral Site,2020,Wisconsin,2,2,4,0.5
vs. Conference,2020,Wisconsin,3,3,6,0.5
vs. Non-Conference,2020,Wisconsin,1,0,1,1.0
vs. Ranked (AP),2020,Wisconsin,0,3,3,0.0
vs. Unranked (AP),2020,Wisconsin,4,0,4,1.0
vs. FBS (I-A),2020,Wisconsin,4,3,7,0.5714285714285714
vs. FCS (I-AA),2020,Wisconsin,0,0,0,
vs. FBS Winning,2020,Wisconsin,0,3,3,0.0
vs. FBS Non-Winning,2020,Wisconsin,4,0,4,1.0
vs. BCS AQ,2020,Wisconsin,4,3,7,0.5714285714285714
vs. BCS non-AQ,2020,Wisconsin,0,0,0,
vs. FBS Power 5,2020,Wisconsin,4,3,7,0.5714285714285714
vs. FBS non-Power 5,2020,Wisconsin,0,0,0,
in August/September,2020,Wisconsin,0,0,0,
in October,2020,Wisconsin,1,0,1,1.0
in November,2020,Wisconsin,1,1,2,0.5
in December/January,2020,Wisconsin,2,2,4,0.5
All Games,2021,Wisconsin,9,4,13,0.6923076923076923
at Home,2021,Wisconsin,5,2,7,0.7142857142857143
on Road/Neutral Site,2021,Wisconsin,4,2,6,0.6666666666666666
vs. Conference,2021,Wisconsin,6,3,9,0.6666666666666666
vs. Non-Conference,2021,Wisconsin,3,1,4,0.75
vs. Ranked (AP),2021,Wisconsin,1,2,3,0.3333333333333333
vs. Unranked (AP),2021,Wisconsin,8,2,10,0.8
vs. FBS (I-A),2021,Wisconsin,9,4,13,0.6923076923076923
vs. FCS (I-AA),2021,Wisconsin,0,0,0,
vs. FBS Winning,2021,Wisconsin,5,4,9,0.5555555555555556
vs. FBS Non-Winning,2021,Wisconsin,4,0,4,1.0
vs. BCS AQ,2021,Wisconsin,7,4,11,0.6363636363636364
vs. BCS non-AQ,2021,Wisconsin,2,0,2,1.0
vs. FBS Power 5,2021,Wisconsin,7,3,10,0.7
vs. FBS non-Power 5,2021,Wisconsin,2,1,3,0.6666666666666666
in August/September,2021,Wisconsin,1,2,3,0.3333333333333333
in October,2021,Wisconsin,4,1,5,0.8
in November,2021,Wisconsin,3,1,4,0.75
in December/January,2021,Wisconsin,1,0,1,1.0
All Games,2022,Wisconsin,7,6,13,0.5384615384615384
at Home,2022,Wisconsin,4,3,7,0.5714285714285714
on Road/Neutral Site,2022,Wisconsin,3,3,6,0.5
vs. Conference,2022,Wisconsin,4,5,9,0.4444444444444444
vs. Non-Conference,2022,Wisconsin,3,1,4,0.75
vs. Ranked (AP),2022,Wisconsin,0,1,1,0.0
vs. Unranked (AP),2022,Wisconsin,7,5,12,0.5833333333333334
vs. FBS (I-A),2022,Wisconsin,6,6,12,0.5
vs. FCS (I-AA),2022,Wisconsin,1,0,1,1.0
vs. FBS Winning,2022,Wisconsin,4,5,9,0.4444444444444444
vs. FBS Non-Winning,2022,Wisconsin,2,1,3,0.6666666666666666
vs. BCS AQ,2022,Wisconsin,5,6,11,0.45454545454545453
vs. BCS non-AQ,2022,Wisconsin,1,0,1,1.0
vs. FBS Power 5,2022,Wisconsin,5,6,11,0.45454545454545453
vs. FBS non-Power 5,2022,Wisconsin,1,0,1,1.0
in August/September,2022,Wisconsin,2,2,4,0.5
in October,2022,Wisconsin,2,2,4,0.5
in November,2022,Wisconsin,2,2,4,0.5
in December/January,2022,Wisconsin,1,0,1,1.0
All Games,2009,Wyoming,7,6,13,0.5384615384615384
at Home,2009,Wyoming,3,3,6,0.5
on Road/Neutral Site,2009,Wyoming,4,3,7,0.5714285714285714
vs. Conference,2009,Wyoming,4,4,8,0.5
vs. Non-Conference,2009,Wyoming,3,2,5,0.6
vs. Ranked (AP),2009,Wyoming,0,4,4,0.0
vs. Unranked (AP),2009,Wyoming,7,2,9,0.7777777777777778
vs. FBS (I-A),2009,Wyoming,6,6,12,0.5
vs. FCS (I-AA),2009,Wyoming,1,0,1,1.0
vs. FBS Winning,2009,Wyoming,1,5,6,0.16666666666666666
vs. FBS Non-Winning,2009,Wyoming,5,1,6,0.8333333333333334
vs. BCS AQ,2009,Wyoming,0,2,2,0.0
vs. BCS non-AQ,2009,Wyoming,6,4,10,0.6
vs. FBS Power 5,2009,Wyoming,0,2,2,0.0
vs. FBS non-Power 5,2009,Wyoming,6,4,10,0.6
in August/September,2009,Wyoming,2,2,4,0.5
in October,2009,Wyoming,2,2,4,0.5
in November,2009,Wyoming,2,2,4,0.5
in December/January,2009,Wyoming,1,0,1,1.0
All Games,2010,Wyoming,3,9,12,0.25
at Home,2010,Wyoming,2,4,6,0.3333333333333333
on Road/Neutral Site,2010,Wyoming,1,5,6,0.16666666666666666
vs. Conference,2010,Wyoming,1,7,8,0.125
vs. Non-Conference,2010,Wyoming,2,2,4,0.5
vs. Ranked (AP),2010,Wyoming,0,2,2,0.0
vs. Unranked (AP),2010,Wyoming,3,7,10,0.3
vs. FBS (I-A),2010,Wyoming,2,9,11,0.18181818181818182
vs. FCS (I-AA),2010,Wyoming,1,0,1,1.0
vs. FBS Winning,2010,Wyoming,1,6,7,0.14285714285714285
vs. FBS Non-Winning,2010,Wyoming,1,3,4,0.25
vs. BCS AQ,2010,Wyoming,0,1,1,0.0
vs. BCS non-AQ,2010,Wyoming,2,8,10,0.2
vs. FBS Power 5,2010,Wyoming,0,1,1,0.0
vs. FBS non-Power 5,2010,Wyoming,2,8,10,0.2
in August/September,2010,Wyoming,1,3,4,0.25
in October,2010,Wyoming,1,4,5,0.2
in November,2010,Wyoming,1,2,3,0.3333333333333333
in December/January,2010,Wyoming,0,0,0,
All Games,2011,Wyoming,8,5,13,0.6153846153846154
at Home,2011,Wyoming,4,2,6,0.6666666666666666
on Road/Neutral Site,2011,Wyoming,4,3,7,0.5714285714285714
vs. Conference,2011,Wyoming,5,2,7,0.7142857142857143
vs. Non-Conference,2011,Wyoming,3,3,6,0.5
vs. Ranked (AP),2011,Wyoming,0,3,3,0.0
vs. Unranked (AP),2011,Wyoming,8,2,10,0.8
vs. FBS (I-A),2011,Wyoming,6,5,11,0.5454545454545454
vs. FCS (I-AA),2011,Wyoming,2,0,2,1.0
vs. FBS Winning,2011,Wyoming,2,5,7,0.2857142857142857
vs. FBS Non-Winning,2011,Wyoming,4,0,4,1.0
vs. BCS AQ,2011,Wyoming,0,1,1,0.0
vs. BCS non-AQ,2011,Wyoming,6,4,10,0.6
vs. FBS Power 5,2011,Wyoming,0,1,1,0.0
vs. FBS non-Power 5,2011,Wyoming,6,4,10,0.6
in August/September,2011,Wyoming,3,1,4,0.75
in October,2011,Wyoming,2,1,3,0.6666666666666666
in November,2011,Wyoming,2,2,4,0.5
in December/January,2011,Wyoming,1,1,2,0.5
All Games,2012,Wyoming,4,8,12,0.3333333333333333
at Home,2012,Wyoming,1,5,6,0.16666666666666666
on Road/Neutral Site,2012,Wyoming,3,3,6,0.5
vs. Conference,2012,Wyoming,3,5,8,0.375
vs. Non-Conference,2012,Wyoming,1,3,4,0.25
vs. Ranked (AP),2012,Wyoming,0,2,2,0.0
vs. Unranked (AP),2012,Wyoming,4,6,10,0.4
vs. FBS (I-A),2012,Wyoming,4,7,11,0.36363636363636365
vs. FCS (I-AA),2012,Wyoming,0,1,1,0.0
vs. FBS Winning,2012,Wyoming,0,6,6,0.0
vs. FBS Non-Winning,2012,Wyoming,4,1,5,0.8
vs. BCS AQ,2012,Wyoming,0,1,1,0.0
vs. BCS non-AQ,2012,Wyoming,4,6,10,0.4
vs. FBS Power 5,2012,Wyoming,0,1,1,0.0
vs. FBS non-Power 5,2012,Wyoming,4,6,10,0.4
in August/September,2012,Wyoming,1,3,4,0.25
in October,2012,Wyoming,0,4,4,0.0
in November,2012,Wyoming,3,1,4,0.75
in December/January,2012,Wyoming,0,0,0,
All Games,2013,Wyoming,5,7,12,0.4166666666666667
at Home,2013,Wyoming,4,2,6,0.6666666666666666
on Road/Neutral Site,2013,Wyoming,1,5,6,0.16666666666666666
vs. Conference,2013,Wyoming,3,5,8,0.375
vs. Non-Conference,2013,Wyoming,2,2,4,0.5
vs. Ranked (AP),2013,Wyoming,0,0,0,
vs. Unranked (AP),2013,Wyoming,5,7,12,0.4166666666666667
vs. FBS (I-A),2013,Wyoming,4,7,11,0.36363636363636365
vs. FCS (I-AA),2013,Wyoming,1,0,1,1.0
vs. FBS Winning,2013,Wyoming,0,5,5,0.0
vs. FBS Non-Winning,2013,Wyoming,4,2,6,0.6666666666666666
vs. BCS AQ,2013,Wyoming,0,1,1,0.0
vs. BCS non-AQ,2013,Wyoming,4,6,10,0.4
vs. FBS Power 5,2013,Wyoming,0,1,1,0.0
vs. FBS non-Power 5,2013,Wyoming,4,6,10,0.4
in August/September,2013,Wyoming,3,2,5,0.6
in October,2013,Wyoming,1,2,3,0.3333333333333333
in November,2013,Wyoming,1,3,4,0.25
in December/January,2013,Wyoming,0,0,0,
All Games,2014,Wyoming,4,8,12,0.3333333333333333
at Home,2014,Wyoming,3,3,6,0.5
on Road/Neutral Site,2014,Wyoming,1,5,6,0.16666666666666666
vs. Conference,2014,Wyoming,2,6,8,0.25
vs. Non-Conference,2014,Wyoming,2,2,4,0.5
vs. Ranked (AP),2014,Wyoming,0,3,3,0.0
vs. Unranked (AP),2014,Wyoming,4,5,9,0.4444444444444444
vs. FBS (I-A),2014,Wyoming,3,8,11,0.2727272727272727
vs. FCS (I-AA),2014,Wyoming,1,0,1,1.0
vs. FBS Winning,2014,Wyoming,1,5,6,0.16666666666666666
vs. FBS Non-Winning,2014,Wyoming,2,3,5,0.4
vs. BCS AQ,2014,Wyoming,0,2,2,0.0
vs. BCS non-AQ,2014,Wyoming,3,6,9,0.3333333333333333
vs. FBS Power 5,2014,Wyoming,0,2,2,0.0
vs. FBS non-Power 5,2014,Wyoming,3,6,9,0.3333333333333333
in August/September,2014,Wyoming,3,2,5,0.6
in October,2014,Wyoming,0,3,3,0.0
in November,2014,Wyoming,1,3,4,0.25
in December/January,2014,Wyoming,0,0,0,
All Games,2015,Wyoming,2,10,12,0.16666666666666666
at Home,2015,Wyoming,2,4,6,0.3333333333333333
on Road/Neutral Site,2015,Wyoming,0,6,6,0.0
vs. Conference,2015,Wyoming,2,6,8,0.25
vs. Non-Conference,2015,Wyoming,0,4,4,0.0
vs. Ranked (AP),2015,Wyoming,0,0,0,
vs. Unranked (AP),2015,Wyoming,2,10,12,0.16666666666666666
vs. FBS (I-A),2015,Wyoming,2,9,11,0.18181818181818182
vs. FCS (I-AA),2015,Wyoming,0,1,1,0.0
vs. FBS Winning,2015,Wyoming,1,7,8,0.125
vs. FBS Non-Winning,2015,Wyoming,1,2,3,0.3333333333333333
vs. BCS AQ,2015,Wyoming,0,1,1,0.0
vs. BCS non-AQ,2015,Wyoming,2,8,10,0.2
vs. FBS Power 5,2015,Wyoming,0,1,1,0.0
vs. FBS non-Power 5,2015,Wyoming,2,8,10,0.2
in August/September,2015,Wyoming,0,4,4,0.0
in October,2015,Wyoming,1,4,5,0.2
in November,2015,Wyoming,1,2,3,0.3333333333333333
in December/January,2015,Wyoming,0,0,0,
All Games,2016,Wyoming,8,6,14,0.5714285714285714
at Home,2016,Wyoming,6,1,7,0.8571428571428571
on Road/Neutral Site,2016,Wyoming,2,5,7,0.2857142857142857
vs. Conference,2016,Wyoming,6,3,9,0.6666666666666666
vs. Non-Conference,2016,Wyoming,2,3,5,0.4
vs. Ranked (AP),2016,Wyoming,0,1,1,0.0
vs. Unranked (AP),2016,Wyoming,8,5,13,0.6153846153846154
vs. FBS (I-A),2016,Wyoming,7,6,13,0.5384615384615384
vs. FCS (I-AA),2016,Wyoming,1,0,1,1.0
vs. FBS Winning,2016,Wyoming,4,5,9,0.4444444444444444
vs. FBS Non-Winning,2016,Wyoming,3,1,4,0.75
vs. BCS AQ,2016,Wyoming,0,1,1,0.0
vs. BCS non-AQ,2016,Wyoming,7,5,12,0.5833333333333334
vs. FBS Power 5,2016,Wyoming,0,1,1,0.0
vs. FBS non-Power 5,2016,Wyoming,7,5,12,0.5833333333333334
in August/September,2016,Wyoming,2,2,4,0.5
in October,2016,Wyoming,4,0,4,1.0
in November,2016,Wyoming,2,2,4,0.5
in December/January,2016,Wyoming,0,2,2,0.0
All Games,2017,Wyoming,8,5,13,0.6153846153846154
at Home,2017,Wyoming,5,2,7,0.7142857142857143
on Road/Neutral Site,2017,Wyoming,3,3,6,0.5
vs. Conference,2017,Wyoming,5,3,8,0.625
vs. Non-Conference,2017,Wyoming,3,2,5,0.6
vs. Ranked (AP),2017,Wyoming,0,1,1,0.0
vs. Unranked (AP),2017,Wyoming,8,4,12,0.6666666666666666
vs. FBS (I-A),2017,Wyoming,7,5,12,0.5833333333333334
vs. FCS (I-AA),2017,Wyoming,1,0,1,1.0
vs. FBS Winning,2017,Wyoming,2,4,6,0.3333333333333333
vs. FBS Non-Winning,2017,Wyoming,5,1,6,0.8333333333333334
vs. BCS AQ,2017,Wyoming,0,2,2,0.0
vs. BCS non-AQ,2017,Wyoming,7,3,10,0.7
vs. FBS Power 5,2017,Wyoming,0,2,2,0.0
vs. FBS non-Power 5,2017,Wyoming,7,3,10,0.7
in August/September,2017,Wyoming,3,2,5,0.6
in October,2017,Wyoming,2,1,3,0.6666666666666666
in November,2017,Wyoming,2,2,4,0.5
in December/January,2017,Wyoming,1,0,1,1.0
All Games,2018,Wyoming,6,6,12,0.5
at Home,2018,Wyoming,3,3,6,0.5
on Road/Neutral Site,2018,Wyoming,3,3,6,0.5
vs. Conference,2018,Wyoming,4,4,8,0.5
vs. Non-Conference,2018,Wyoming,2,2,4,0.5
vs. Ranked (AP),2018,Wyoming,0,4,4,0.0
vs. Unranked (AP),2018,Wyoming,6,2,8,0.75
vs. FBS (I-A),2018,Wyoming,5,6,11,0.45454545454545453
vs. FCS (I-AA),2018,Wyoming,1,0,1,1.0
vs. FBS Winning,2018,Wyoming,0,6,6,0.0
vs. FBS Non-Winning,2018,Wyoming,5,0,5,1.0
vs. BCS AQ,2018,Wyoming,0,2,2,0.0
vs. BCS non-AQ,2018,Wyoming,5,4,9,0.5555555555555556
vs. FBS Power 5,2018,Wyoming,0,2,2,0.0
vs. FBS non-Power 5,2018,Wyoming,5,4,9,0.5555555555555556
in August/September,2018,Wyoming,2,3,5,0.4
in October,2018,Wyoming,1,3,4,0.25
in November,2018,Wyoming,3,0,3,1.0
in December/January,2018,Wyoming,0,0,0,
All Games,2019,Wyoming,8,5,13,0.6153846153846154
at Home,2019,Wyoming,6,0,6,1.0
on Road/Neutral Site,2019,Wyoming,2,5,7,0.2857142857142857
vs. Conference,2019,Wyoming,4,4,8,0.5
vs. Non-Conference,2019,Wyoming,4,1,5,0.8
vs. Ranked (AP),2019,Wyoming,0,2,2,0.0
vs. Unranked (AP),2019,Wyoming,8,3,11,0.7272727272727273
vs. FBS (I-A),2019,Wyoming,7,5,12,0.5833333333333334
vs. FCS (I-AA),2019,Wyoming,1,0,1,1.0
vs. FBS Winning,2019,Wyoming,2,4,6,0.3333333333333333
vs. FBS Non-Winning,2019,Wyoming,5,1,6,0.8333333333333334
vs. BCS AQ,2019,Wyoming,1,1,2,0.5
vs. BCS non-AQ,2019,Wyoming,6,4,10,0.6
vs. FBS Power 5,2019,Wyoming,1,0,1,1.0
vs. FBS non-Power 5,2019,Wyoming,6,5,11,0.5454545454545454
in August/September,2019,Wyoming,4,1,5,0.8
in October,2019,Wyoming,2,1,3,0.6666666666666666
in November,2019,Wyoming,1,3,4,0.25
in December/January,2019,Wyoming,1,0,1,1.0
All Games,2020,Wyoming,2,4,6,0.3333333333333333
at Home,2020,Wyoming,1,1,2,0.5
on Road/Neutral Site,2020,Wyoming,1,3,4,0.25
vs. Conference,2020,Wyoming,2,4,6,0.3333333333333333
vs. Non-Conference,2020,Wyoming,0,0,0,
vs. Ranked (AP),2020,Wyoming,0,0,0,
vs. Unranked (AP),2020,Wyoming,2,4,6,0.3333333333333333
vs. FBS (I-A),2020,Wyoming,2,4,6,0.3333333333333333
vs. FCS (I-AA),2020,Wyoming,0,0,0,
vs. FBS Winning,2020,Wyoming,1,2,3,0.3333333333333333
vs. FBS Non-Winning,2020,Wyoming,1,2,3,0.3333333333333333
vs. BCS AQ,2020,Wyoming,0,0,0,
vs. BCS non-AQ,2020,Wyoming,2,4,6,0.3333333333333333
vs. FBS Power 5,2020,Wyoming,0,0,0,
vs. FBS non-Power 5,2020,Wyoming,2,4,6,0.3333333333333333
in August/September,2020,Wyoming,0,0,0,
in October,2020,Wyoming,1,1,2,0.5
in November,2020,Wyoming,1,1,2,0.5
in December/January,2020,Wyoming,0,2,2,0.0
All Games,2021,Wyoming,7,6,13,0.5384615384615384
at Home,2021,Wyoming,3,3,6,0.5
on Road/Neutral Site,2021,Wyoming,4,3,7,0.5714285714285714
vs. Conference,2021,Wyoming,2,6,8,0.25
vs. Non-Conference,2021,Wyoming,5,0,5,1.0
vs. Ranked (AP),2021,Wyoming,1,0,1,1.0
vs. Unranked (AP),2021,Wyoming,6,6,12,0.5
vs. FBS (I-A),2021,Wyoming,6,6,12,0.5
vs. FCS (I-AA),2021,Wyoming,1,0,1,1.0
vs. FBS Winning,2021,Wyoming,2,3,5,0.4
vs. FBS Non-Winning,2021,Wyoming,4,3,7,0.5714285714285714
vs. BCS AQ,2021,Wyoming,0,0,0,
vs. BCS non-AQ,2021,Wyoming,6,6,12,0.5
vs. FBS Power 5,2021,Wyoming,0,0,0,
vs. FBS non-Power 5,2021,Wyoming,6,6,12,0.5
in August/September,2021,Wyoming,4,0,4,1.0
in October,2021,Wyoming,0,4,4,0.0
in November,2021,Wyoming,2,2,4,0.5
in December/January,2021,Wyoming,1,0,1,1.0
All Games,2022,Wyoming,7,6,13,0.5384615384615384
at Home,2022,Wyoming,4,2,6,0.6666666666666666
on Road/Neutral Site,2022,Wyoming,3,4,7,0.42857142857142855
vs. Conference,2022,Wyoming,5,3,8,0.625
vs. Non-Conference,2022,Wyoming,2,3,5,0.4
vs. Ranked (AP),2022,Wyoming,0,1,1,0.0
vs. Unranked (AP),2022,Wyoming,7,5,12,0.5833333333333334
vs. FBS (I-A),2022,Wyoming,6,6,12,0.5
vs. FCS (I-AA),2022,Wyoming,1,0,1,1.0
vs. FBS Winning,2022,Wyoming,1,6,7,0.14285714285714285
vs. FBS Non-Winning,2022,Wyoming,5,0,5,1.0
vs. BCS AQ,2022,Wyoming,1,1,2,0.5
vs. BCS non-AQ,2022,Wyoming,5,5,10,0.5
vs. FBS Power 5,2022,Wyoming,0,1,1,0.0
vs. FBS non-Power 5,2022,Wyoming,6,5,11,0.5454545454545454
in August/September,2022,Wyoming,3,2,5,0.6
in October,2022,Wyoming,3,1,4,0.75
in November,2022,Wyoming,1,2,3,0.3333333333333333
in December/January,2022,Wyoming,0,1,1,0.0
